ID;StatusVanBewoning;RegioS;Perioden;TotaleWoningvoorraad_1;Koopwoningen_2;TotaalHuurwoningen_3;EigendomWoningcorporatie_4;EigendomOverigeVerhuurders_5;EigendomOnbekend_6
0;T001235;NL01  ;2012; 7386743; 4182889; 3121980; 2269883;  852097;   81874
1;T001235;NL01  ;2013; 7449298; 4216760; 3171057; 2277246;  893811;   61481
2;T001235;NL01  ;2014; 7535315; 4238259; 3217156; 2275389;  941767;   79900
3;T001235;NL01  ;2015; 7587964; 4266966; 3244238; 2304505;  939733;   76760
4;T001235;NL01  ;2016; 7641323; 4300406; 3256930; 2281742;  975188;   83987
5;T001235;NL01  ;2017; 7686178; 4321868; 3283957; 2273731; 1010226;   80353
6;T001235;NL01  ;2018; 7740984; 4386769; 3275965; 2268383; 1007582;   78250
7;T001235;NL01  ;2019; 7814912; 4487894; 3299639; 2295414; 1004225;   27379
8;T001235;NL01  ;2020; 7891786; 4517921; 3342018; 2294219; 1047799;   31847
9;T001235;LD01  ;2012;  772104;  467487;  295066;  217783;   77283;    9551
10;T001235;LD01  ;2013;  771736;  468377;  297659;  217751;   79908;    5700
11;T001235;LD01  ;2014;  781292;  469039;  304212;  218235;   85977;    8041
12;T001235;LD01  ;2015;  785326;  469965;  307365;  221912;   85453;    7996
13;T001235;LD01  ;2016;  788884;  471834;  307995;  219884;   88111;    9055
14;T001235;LD01  ;2017;  792431;  473157;  310188;  218985;   91203;    9086
15;T001235;LD01  ;2018;  796356;  479145;  307616;  217401;   90215;    9595
16;T001235;LD01  ;2019;  802097;  488171;  311040;  221297;   89743;    2886
17;T001235;LD01  ;2020;  807876;  489742;  314617;  220239;   94378;    3517
18;T001235;LD02  ;2012; 1485826;  898227;  568075;  419795;  148280;   19524
19;T001235;LD02  ;2013; 1504734;  906030;  582264;  422947;  159317;   16440
20;T001235;LD02  ;2014; 1518499;  910085;  589794;  420641;  169153;   18620
21;T001235;LD02  ;2015; 1530620;  916876;  596400;  430500;  165900;   17344
22;T001235;LD02  ;2016; 1542354;  924931;  599250;  428426;  170824;   18173
23;T001235;LD02  ;2017; 1549652;  928406;  603720;  425990;  177730;   17526
24;T001235;LD02  ;2018; 1560427;  946868;  598088;  426760;  171328;   15471
25;T001235;LD02  ;2019; 1577836;  969307;  603393;  433964;  169429;    5136
26;T001235;LD02  ;2020; 1594895;  978972;  610380;  434394;  175986;    5543
27;T001235;LD03  ;2012; 3568335; 1862562; 1665761; 1191764;  473997;   40012
28;T001235;LD03  ;2013; 3596393; 1880117; 1685968; 1191721;  494247;   30308
29;T001235;LD03  ;2014; 3636076; 1891425; 1706042; 1187040;  519002;   38609
30;T001235;LD03  ;2015; 3661234; 1908972; 1715297; 1200341;  514956;   36965
31;T001235;LD03  ;2016; 3689053; 1927257; 1722100; 1184671;  537429;   39696
32;T001235;LD03  ;2017; 3712702; 1940464; 1734706; 1180666;  554040;   37532
33;T001235;LD03  ;2018; 3738798; 1965632; 1735979; 1177296;  558683;   37187
34;T001235;LD03  ;2019; 3775050; 2016042; 1744648; 1186442;  558206;   14360
35;T001235;LD03  ;2020; 3815173; 2028824; 1769131; 1185388;  583743;   17218
36;T001235;LD04  ;2012; 1560443;  954604;  593063;  440541;  152522;   12776
37;T001235;LD04  ;2013; 1576411;  962230;  605154;  444827;  160327;    9027
38;T001235;LD04  ;2014; 1599446;  967709;  617107;  449473;  167634;   14630
39;T001235;LD04  ;2015; 1610784;  971153;  625176;  451752;  173424;   14455
40;T001235;LD04  ;2016; 1621032;  976384;  627585;  448761;  178824;   17063
41;T001235;LD04  ;2017; 1631393;  979841;  635343;  448090;  187253;   16209
42;T001235;LD04  ;2018; 1645403;  995124;  634282;  446926;  187356;   15997
43;T001235;LD04  ;2019; 1659929; 1014374;  640558;  453711;  186847;    4997
44;T001235;LD04  ;2020; 1673842; 1020383;  647890;  454198;  193692;    5569
45;T001235;PV20  ;2012;  265332;  148239;  113659;   80729;   32930;    3434
46;T001235;PV20  ;2013;  267466;  148656;  116356;   81662;   34694;    2454
47;T001235;PV20  ;2014;  271087;  148758;  119653;   82403;   37250;    2676
48;T001235;PV20  ;2015;  272774;  148949;  121738;   85546;   36192;    2087
49;T001235;PV20  ;2016;  274719;  149548;  122718;   84886;   37832;    2453
50;T001235;PV20  ;2017;  276728;  150040;  124247;   84418;   39829;    2441
51;T001235;PV20  ;2018;  277113;  151975;  122368;   82673;   39695;    2770
52;T001235;PV20  ;2019;  279662;  154284;  124154;   83606;   40548;    1224
53;T001235;PV20  ;2020;  282047;  154584;  125772;   83181;   42591;    1691
54;T001235;Friesland (PV)  ;2012;  287340;  177956;  107223;   81989;   25234;    2161
55;T001235;Friesland (PV)  ;2013;  289380;  179362;  108550;   82117;   26433;    1468
56;T001235;Friesland (PV)  ;2014;  292180;  179270;  110097;   81917;   28180;    2813
57;T001235;Friesland (PV)  ;2015;  294169;  179774;  110938;   82448;   28490;    3457
58;T001235;Friesland (PV)  ;2016;  295540;  180232;  111384;   81158;   30226;    3924
59;T001235;Friesland (PV)  ;2017;  296463;  180920;  111652;   80717;   30935;    3891
60;T001235;Friesland (PV)  ;2018;  298425;  183424;  110940;   80727;   30213;    4061
61;T001235;Friesland (PV)  ;2019;  300238;  187147;  112051;   82033;   30018;    1040
62;T001235;Friesland (PV)  ;2020;  302578;  187891;  113618;   81764;   31854;    1069
63;T001235;Drenthe (PV)  ;2012;  219432;  141292;   74184;   55065;   19119;    3956
64;T001235;Drenthe (PV)  ;2013;  214890;  140359;   72753;   53972;   18781;    1778
65;T001235;Drenthe (PV)  ;2014;  218025;  141011;   74462;   53915;   20547;    2552
66;T001235;Drenthe (PV)  ;2015;  218383;  141242;   74689;   53918;   20771;    2452
67;T001235;Drenthe (PV)  ;2016;  218625;  142054;   73893;   53840;   20053;    2678
68;T001235;Drenthe (PV)  ;2017;  219240;  142197;   74289;   53850;   20439;    2754
69;T001235;Drenthe (PV)  ;2018;  220818;  143746;   74308;   54001;   20307;    2764
70;T001235;Drenthe (PV)  ;2019;  222197;  146740;   74835;   55658;   19177;     622
71;T001235;Drenthe (PV)  ;2020;  223251;  147267;   75227;   55294;   19933;     757
72;T001235;Overijssel (PV)  ;2012;  482572;  289489;  188045;  139728;   48317;    5038
73;T001235;Overijssel (PV)  ;2013;  485391;  291336;  190267;  139803;   50464;    3788
74;T001235;Overijssel (PV)  ;2014;  487577;  291816;  190849;  138616;   52233;    4912
75;T001235;Overijssel (PV)  ;2015;  490227;  293657;  191563;  141475;   50088;    5007
76;T001235;Overijssel (PV)  ;2016;  493757;  295204;  193294;  139384;   53910;    5259
77;T001235;Overijssel (PV)  ;2017;  497361;  295865;  196326;  140491;   55835;    5170
78;T001235;Overijssel (PV)  ;2018;  499951;  302439;  192810;  139420;   53390;    4702
79;T001235;Overijssel (PV)  ;2019;  505343;  308443;  195612;  140656;   54956;    1288
80;T001235;Overijssel (PV)  ;2020;  510296;  310844;  197881;  140815;   57066;    1571
81;T001235;Flevoland (PV)  ;2012;  158061;  101537;   55003;   43040;   11963;    1521
82;T001235;Flevoland (PV)  ;2013;  159496;  102522;   56134;   42861;   13273;     840
83;T001235;Flevoland (PV)  ;2014;  161512;  103306;   57343;   43016;   14327;     863
84;T001235;Flevoland (PV)  ;2015;  162731;  104143;   57660;   43158;   14502;     928
85;T001235;Flevoland (PV)  ;2016;  162918;  104778;   57357;   43306;   14051;     783
86;T001235;Flevoland (PV)  ;2017;  164229;  105313;   58212;   43218;   14994;     704
87;T001235;Flevoland (PV)  ;2018;  166487;  106430;   59225;   43262;   15963;     832
88;T001235;Flevoland (PV)  ;2019;  169237;  110598;   58364;   44594;   13770;     275
89;T001235;Flevoland (PV)  ;2020;  172227;  112198;   59731;   45006;   14725;     298
90;T001235;Gelderland (PV)  ;2012;  845193;  507201;  325027;  237027;   88000;   12965
91;T001235;Gelderland (PV)  ;2013;  859847;  512172;  335863;  240283;   95580;   11812
92;T001235;Gelderland (PV)  ;2014;  869410;  514963;  341602;  239009;  102593;   12845
93;T001235;Gelderland (PV)  ;2015;  877662;  519076;  347177;  245867;  101310;   11409
94;T001235;Gelderland (PV)  ;2016;  885679;  524949;  348599;  245736;  102863;   12131
95;T001235;Gelderland (PV)  ;2017;  888062;  527228;  349182;  242281;  106901;   11652
96;T001235;Gelderland (PV)  ;2018;  893989;  537999;  346053;  244078;  101975;    9937
97;T001235;Gelderland (PV)  ;2019;  903256;  550266;  349417;  248714;  100703;    3573
98;T001235;Gelderland (PV)  ;2020;  912372;  555930;  352768;  248573;  104195;    3674
99;T001235;Utrecht (PV)  ;2012;  528124;  303721;  215302;  153353;   61949;    9101
100;T001235;Utrecht (PV)  ;2013;  534592;  307541;  221205;  154208;   66997;    5846
101;T001235;Utrecht (PV)  ;2014;  539078;  308395;  224440;  153103;   71337;    6243
102;T001235;Utrecht (PV)  ;2015;  543473;  310707;  225860;  155523;   70337;    6906
103;T001235;Utrecht (PV)  ;2016;  548114;  313875;  227499;  153959;   73540;    6740
104;T001235;Utrecht (PV)  ;2017;  554305;  316916;  230281;  153801;   76480;    7108
105;T001235;Utrecht (PV)  ;2018;  557564;  319764;  231170;  153840;   77330;    6630
106;T001235;Utrecht (PV)  ;2019;  578906;  339464;  237872;  160241;   77631;    1570
107;T001235;Utrecht (PV)  ;2020;  585924;  342060;  241833;  160618;   81215;    2031
108;T001235;Noord-Holland (PV)  ;2012; 1253521;  620197;  619294;  432874;  186420;   14030
109;T001235;Noord-Holland (PV)  ;2013; 1262787;  627582;  624358;  431082;  193276;   10847
110;T001235;Noord-Holland (PV)  ;2014; 1278533;  632826;  632575;  429679;  202896;   13132
111;T001235;Noord-Holland (PV)  ;2015; 1287671;  640136;  637529;  435314;  202215;   10006
112;T001235;Noord-Holland (PV)  ;2016; 1300094;  647361;  640877;  429352;  211525;   11856
113;T001235;Noord-Holland (PV)  ;2017; 1307353;  651685;  644568;  426362;  218206;   11100
114;T001235;Noord-Holland (PV)  ;2018; 1318336;  663831;  643922;  425818;  218104;   10583
115;T001235;Noord-Holland (PV)  ;2019; 1334099;  677299;  653156;  428968;  224188;    3644
116;T001235;Noord-Holland (PV)  ;2020; 1348750;  680718;  663015;  427053;  235962;    5017
117;T001235;Zuid-Holland (PV)  ;2012; 1605446;  820320;  769570;  562432;  207138;   15556
118;T001235;Zuid-Holland (PV)  ;2013; 1618645;  827244;  778693;  563067;  215626;   12708
119;T001235;Zuid-Holland (PV)  ;2014; 1636097;  832573;  786333;  561068;  225265;   17191
120;T001235;Zuid-Holland (PV)  ;2015; 1647422;  839841;  789375;  566308;  223067;   18206
121;T001235;Zuid-Holland (PV)  ;2016; 1657234;  847024;  791373;  558331;  233042;   18837
122;T001235;Zuid-Holland (PV)  ;2017; 1666690;  852835;  796788;  557643;  239145;   17067
123;T001235;Zuid-Holland (PV)  ;2018; 1677634;  861111;  798824;  554990;  243834;   17699
124;T001235;Zuid-Holland (PV)  ;2019; 1675517;  875435;  793487;  554827;  238660;    6595
125;T001235;Zuid-Holland (PV)  ;2020; 1692888;  881914;  804036;  555516;  248520;    6938
126;T001235;Zeeland (PV)  ;2012;  181244;  118324;   61595;   43105;   18490;    1325
127;T001235;Zeeland (PV)  ;2013;  180369;  117750;   61712;   43364;   18348;     907
128;T001235;Zeeland (PV)  ;2014;  182368;  117631;   62694;   43190;   19504;    2043
129;T001235;Zeeland (PV)  ;2015;  182668;  118288;   62533;   43196;   19337;    1847
130;T001235;Zeeland (PV)  ;2016;  183611;  118997;   62351;   43029;   19322;    2263
131;T001235;Zeeland (PV)  ;2017;  184354;  119028;   63069;   42860;   20209;    2257
132;T001235;Zeeland (PV)  ;2018;  185264;  120926;   62063;   42648;   19415;    2275
133;T001235;Zeeland (PV)  ;2019;  186528;  123844;   60133;   42406;   17727;    2551
134;T001235;Zeeland (PV)  ;2020;  187611;  124132;   60247;   42201;   18046;    3232
135;T001235;Noord-Brabant (PV)  ;2012; 1050418;  646933;  395889;  302093;   93796;    7596
136;T001235;Noord-Brabant (PV)  ;2013; 1062383;  653545;  403608;  305423;   98185;    5230
137;T001235;Noord-Brabant (PV)  ;2014; 1078782;  656849;  413771;  308949;  104822;    8162
138;T001235;Noord-Brabant (PV)  ;2015; 1087416;  660865;  418506;  310421;  108085;    8045
139;T001235;Noord-Brabant (PV)  ;2016; 1096399;  665758;  420089;  308258;  111831;   10552
140;T001235;Noord-Brabant (PV)  ;2017; 1104296;  668710;  425705;  307776;  117929;    9881
141;T001235;Noord-Brabant (PV)  ;2018; 1116102;  679262;  427240;  308532;  118708;    9600
142;T001235;Noord-Brabant (PV)  ;2019; 1128847;  693058;  433115;  313769;  119346;    2674
143;T001235;Noord-Brabant (PV)  ;2020; 1140611;  698249;  439242;  314500;  124742;    3120
144;T001235;Limburg (PV)  ;2012;  510025;  307671;  197174;  138448;   58726;    5180
145;T001235;Limburg (PV)  ;2013;  514028;  308685;  201546;  139404;   62142;    3797
146;T001235;Limburg (PV)  ;2014;  520664;  310860;  203336;  140524;   62812;    6468
147;T001235;Limburg (PV)  ;2015;  523368;  310288;  206670;  141331;   65339;    6410
148;T001235;Limburg (PV)  ;2016;  524633;  310626;  207496;  140503;   66993;    6511
149;T001235;Limburg (PV)  ;2017;  527097;  311131;  209638;  140314;   69324;    6328
150;T001235;Limburg (PV)  ;2018;  529301;  315862;  207042;  138394;   68648;    6397
151;T001235;Limburg (PV)  ;2019;  531082;  321316;  207443;  139942;   67501;    2323
152;T001235;Limburg (PV)  ;2020;  533231;  322134;  208648;  139698;   68950;    2449
153;T001235;CR01  ;2012;   68173;   43798;   23830;   18383;    5447;     545
154;T001235;CR01  ;2013;   68205;   43860;   24013;   18383;    5630;     332
155;T001235;CR01  ;2014;   68883;   43690;   24441;   18465;    5976;     752
156;T001235;CR01  ;2015;   69232;   43691;   24714;   18714;    6000;     827
157;T001235;CR01  ;2016;   69426;   43543;   24951;   18535;    6416;     932
158;T001235;CR01  ;2017;   69570;   43424;   25080;   18455;    6625;    1066
159;T001235;CR01  ;2018;   64154;   40320;   22797;   16903;    5894;    1037
160;T001235;CR01  ;2019;   64267;   40975;   22732;   17224;    5508;     560
161;T001235;CR01  ;2020;   64431;   40937;   22905;   17213;    5692;     589
162;T001235;CR02  ;2012;   22192;   13309;    8802;    7068;    1734;      81
163;T001235;CR02  ;2013;   22320;   13337;    8905;    7162;    1743;      78
164;T001235;CR02  ;2014;   22690;   13305;    9353;    7420;    1933;      32
165;T001235;CR02  ;2015;   22739;   13270;    9432;    7442;    1990;      37
166;T001235;CR02  ;2016;   22802;   13498;    9102;    7384;    1718;     202
167;T001235;CR02  ;2017;   22763;   13442;    9119;    7325;    1794;     202
168;T001235;CR02  ;2018;   22853;   13437;    9283;    7338;    1945;     133
169;T001235;CR02  ;2019;   22912;   13467;    9404;    7375;    2029;      41
170;T001235;CR02  ;2020;   22952;   13415;    9513;    7374;    2139;      24
171;T001235;CR03  ;2012;  174967;   91132;   81027;   55278;   25749;    2808
172;T001235;CR03  ;2013;  176941;   91459;   83438;   56117;   27321;    2044
173;T001235;CR03  ;2014;  179514;   91763;   85859;   56518;   29341;    1892
174;T001235;CR03  ;2015;  180803;   91988;   87592;   59390;   28202;    1223
175;T001235;CR03  ;2016;  182491;   92507;   88665;   58967;   29698;    1319
176;T001235;CR03  ;2017;  184395;   93174;   90048;   58638;   31410;    1173
177;T001235;CR03  ;2018;  190106;   98218;   90288;   58432;   31856;    1600
178;T001235;CR03  ;2019;  192483;   99842;   92018;   59007;   33011;     623
179;T001235;CR03  ;2020;  194664;  100232;   93354;   58594;   34760;    1078
180;T001235;CR04  ;2012;  148548;   90461;   56881;   42074;   14807;    1206
181;T001235;CR04  ;2013;  149433;   90829;   57793;   42179;   15614;     811
182;T001235;CR04  ;2014;  147779;   88671;   57634;   41023;   16611;    1474
183;T001235;CR04  ;2015;  148836;   88769;   58423;   41446;   16977;    1644
184;T001235;CR04  ;2016;  149548;   88937;   58811;   40632;   18179;    1800
185;T001235;CR04  ;2017;  150168;   89178;   59211;   40579;   18632;    1779
186;T001235;CR04  ;2018;  149067;   88509;   58711;   40482;   18229;    1847
187;T001235;CR04  ;2019;  149997;   90286;   59146;   41272;   17874;     565
188;T001235;CR04  ;2020;  151788;   90518;   60655;   41135;   19520;     615
189;T001235;CR05  ;2012;   47812;   30687;   16828;   13135;    3693;     297
190;T001235;CR05  ;2013;   48780;   31318;   17176;   13269;    3907;     286
191;T001235;CR05  ;2014;   61139;   39490;   21208;   16252;    4956;     441
192;T001235;CR05  ;2015;   61663;   39689;   21097;   16266;    4831;     877
193;T001235;CR05  ;2016;   61831;   39789;   21119;   16149;    4970;     923
194;T001235;CR05  ;2017;   62004;   39997;   21055;   15927;    5128;     952
195;T001235;CR05  ;2018;   64682;   42497;   21215;   16309;    4906;     970
196;T001235;CR05  ;2019;   65124;   43327;   21582;   16756;    4826;     215
197;T001235;CR05  ;2020;   65466;   43566;   21687;   16706;    4981;     213
198;T001235;CR06  ;2012;   90980;   56808;   33514;   26780;    6734;     658
199;T001235;CR06  ;2013;   91167;   57215;   33581;   26669;    6912;     371
200;T001235;CR06  ;2014;   83262;   51109;   31255;   24642;    6613;     898
201;T001235;CR06  ;2015;   83670;   51316;   31418;   24736;    6682;     936
202;T001235;CR06  ;2016;   84161;   51506;   31454;   24377;    7077;    1201
203;T001235;CR06  ;2017;   84291;   51745;   31386;   24211;    7175;    1160
204;T001235;CR06  ;2018;   84676;   52418;   31014;   23936;    7078;    1244
205;T001235;CR06  ;2019;   85117;   53534;   31323;   24005;    7318;     260
206;T001235;CR06  ;2020;   85324;   53807;   31276;   23923;    7353;     241
207;T001235;CR07  ;2012;   84431;   55671;   26996;   19242;    7754;    1764
208;T001235;CR07  ;2013;   83576;   55602;   27180;   19348;    7832;     794
209;T001235;CR07  ;2014;   84187;   55767;   27840;   19357;    8483;     580
210;T001235;CR07  ;2015;   84347;   55934;   27636;   19370;    8266;     777
211;T001235;CR07  ;2016;   84365;   56152;   27365;   19336;    8029;     848
212;T001235;CR07  ;2017;   85045;   56337;   27712;   19392;    8320;     996
213;T001235;CR07  ;2018;   85753;   57178;   27530;   19269;    8261;    1045
214;T001235;CR07  ;2019;   86259;   58542;   27340;   19476;    7864;     377
215;T001235;CR07  ;2020;   87028;   58847;   27770;   19585;    8185;     411
216;T001235;CR08  ;2012;   79710;   49795;   27919;   20844;    7075;    1996
217;T001235;CR08  ;2013;   75396;   48528;   26121;   19716;    6405;     747
218;T001235;CR08  ;2014;   76304;   48685;   26484;   19593;    6891;    1135
219;T001235;CR08  ;2015;   76242;   48681;   26612;   19627;    6985;     949
220;T001235;CR08  ;2016;   76174;   49015;   26329;   19461;    6868;     830
221;T001235;CR08  ;2017;   75644;   48787;   26099;   19445;    6654;     758
222;T001235;CR08  ;2018;   76009;   48865;   26394;   19522;    6872;     750
223;T001235;CR08  ;2019;   76353;   49797;   26446;   20190;    6256;     110
224;T001235;CR08  ;2020;   76237;   49773;   26357;   20173;    6184;     107
225;T001235;CR09  ;2012;   55291;   35826;   19269;   14979;    4290;     196
226;T001235;CR09  ;2013;   55918;   36229;   19452;   14908;    4544;     237
227;T001235;CR09  ;2014;   57534;   36559;   20138;   14965;    5173;     837
228;T001235;CR09  ;2015;   57794;   36627;   20441;   14921;    5520;     726
229;T001235;CR09  ;2016;   58086;   36887;   20199;   15043;    5156;    1000
230;T001235;CR09  ;2017;   58551;   37073;   20478;   15013;    5465;    1000
231;T001235;CR09  ;2018;   59056;   37703;   20384;   15210;    5174;     969
232;T001235;CR09  ;2019;   59585;   38401;   21049;   15992;    5057;     135
233;T001235;CR09  ;2020;   59986;   38647;   21100;   15536;    5564;     239
234;T001235;CR10  ;2012;  149694;   92364;   55842;   39581;   16261;    1488
235;T001235;CR10  ;2013;  150741;   93098;   56446;   39799;   16647;    1197
236;T001235;CR10  ;2014;  150491;   92933;   56383;   39734;   16649;    1175
237;T001235;CR10  ;2015;  151497;   93679;   56722;   40042;   16680;    1096
238;T001235;CR10  ;2016;  153151;   94247;   57755;   40003;   17752;    1149
239;T001235;CR10  ;2017;  154596;   95072;   58475;   40122;   18353;    1049
240;T001235;CR10  ;2018;  156175;   97110;   57983;   40465;   17518;    1082
241;T001235;CR10  ;2019;  158322;   99893;   57810;   41251;   16559;     619
242;T001235;CR10  ;2020;  160274;  100924;   58769;   41463;   17306;     581
243;T001235;CR11  ;2012;   64561;   38647;   25491;   18932;    6559;     423
244;T001235;CR11  ;2013;   64688;   38814;   25600;   18768;    6832;     274
245;T001235;CR11  ;2014;   64867;   39084;   25520;   18468;    7052;     263
246;T001235;CR11  ;2015;   65391;   39159;   25656;   18548;    7108;     576
247;T001235;CR11  ;2016;   66392;   39675;   26422;   18951;    7471;     295
248;T001235;CR11  ;2017;   67541;   39723;   27485;   19185;    8300;     333
249;T001235;CR11  ;2018;   67909;   40434;   27288;   19122;    8166;     187
250;T001235;CR11  ;2019;   68741;   41444;   27167;   19131;    8036;     130
251;T001235;CR11  ;2020;   69614;   41696;   27659;   19299;    8360;     259
252;T001235;CR12  ;2012;  268317;  158478;  106712;   81215;   25497;    3127
253;T001235;CR12  ;2013;  269962;  159424;  108221;   81236;   26985;    2317
254;T001235;CR12  ;2014;  272219;  159799;  108946;   80414;   28532;    3474
255;T001235;CR12  ;2015;  273339;  160819;  109185;   82885;   26300;    3335
256;T001235;CR12  ;2016;  274214;  161282;  109117;   80430;   28687;    3815
257;T001235;CR12  ;2017;  275224;  161070;  110366;   81184;   29182;    3788
258;T001235;CR12  ;2018;  275867;  164895;  107539;   79833;   27706;    3433
259;T001235;CR12  ;2019;  278280;  167106;  110635;   80274;   30361;     539
260;T001235;CR12  ;2020;  280408;  168224;  111453;   80053;   31400;     731
261;T001235;CR13  ;2012;  269671;  166919;   95578;   69569;   26009;    7174
262;T001235;CR13  ;2013;  275601;  168293;  101206;   70591;   30615;    6102
263;T001235;CR13  ;2014;  279092;  169451;  103764;   69943;   33821;    5877
264;T001235;CR13  ;2015;  281918;  171269;  104901;   72785;   32116;    5748
265;T001235;CR13  ;2016;  285281;  173654;  105563;   72391;   33172;    6064
266;T001235;CR13  ;2017;  285293;  174839;  105149;   71102;   34047;    5305
267;T001235;CR13  ;2018;  286046;  178300;  103715;   72165;   31550;    4031
268;T001235;CR13  ;2019;  289386;  182171;  106244;   74981;   31263;     971
269;T001235;CR13  ;2020;  293144;  184741;  107722;   75080;   32642;     681
270;T001235;CR14  ;2012;  170299;  110446;   58320;   41498;   16822;    1533
271;T001235;CR14  ;2013;  172556;  111684;   59536;   41752;   17784;    1336
272;T001235;CR14  ;2014;  174645;  112375;   60526;   41626;   18900;    1744
273;T001235;CR14  ;2015;  175576;  112965;   60944;   42207;   18737;    1667
274;T001235;CR14  ;2016;  176238;  113569;   60911;   42196;   18715;    1758
275;T001235;CR14  ;2017;  176997;  113977;   61349;   42203;   19146;    1671
276;T001235;CR14  ;2018;  177868;  116033;   60182;   42155;   18027;    1653
277;T001235;CR14  ;2019;  179045;  117791;   60936;   43154;   17782;     318
278;T001235;CR14  ;2020;  179906;  118460;   61172;   43028;   18144;     274
279;T001235;CR15  ;2012;  312086;  169630;  139178;  100854;   38324;    3278
280;T001235;CR15  ;2013;  317640;  171268;  142817;  102278;   40539;    3555
281;T001235;CR15  ;2014;  320661;  171573;  144729;  101967;   42762;    4359
282;T001235;CR15  ;2015;  324379;  172664;  148640;  105351;   43289;    3075
283;T001235;CR15  ;2016;  327245;  174276;  149677;  105648;   44029;    3292
284;T001235;CR15  ;2017;  328001;  174851;  149511;  103524;   45987;    3639
285;T001235;CR15  ;2018;  331348;  179242;  148800;  104263;   44537;    3306
286;T001235;CR15  ;2019;  334914;  183501;  149613;  104967;   44646;    1800
287;T001235;CR15  ;2020;  338181;  184905;  151034;  105071;   45963;    2242
288;T001235;CR16  ;2012;   93137;   60206;   31951;   25106;    6845;     980
289;T001235;CR16  ;2013;   94050;   60927;   32304;   25662;    6642;     819
290;T001235;CR16  ;2014;   95012;   61564;   32583;   25473;    7110;     865
291;T001235;CR16  ;2015;   95789;   62178;   32692;   25524;    7168;     919
292;T001235;CR16  ;2016;   96915;   63450;   32448;   25501;    6947;    1017
293;T001235;CR16  ;2017;   97771;   63561;   33173;   25452;    7721;    1037
294;T001235;CR16  ;2018;   98727;   64424;   33356;   25495;    7861;     947
295;T001235;CR16  ;2019;   99911;   66803;   32624;   25612;    7012;     484
296;T001235;CR16  ;2020;  101141;   67824;   32840;   25394;    7446;     477
297;T001235;CR17  ;2012;  528124;  303721;  215302;  153353;   61949;    9101
298;T001235;CR17  ;2013;  534592;  307541;  221205;  154208;   66997;    5846
299;T001235;CR17  ;2014;  539078;  308395;  224440;  153103;   71337;    6243
300;T001235;CR17  ;2015;  543473;  310707;  225860;  155523;   70337;    6906
301;T001235;CR17  ;2016;  548114;  313875;  227499;  153959;   73540;    6740
302;T001235;CR17  ;2017;  554305;  316916;  230281;  153801;   76480;    7108
303;T001235;CR17  ;2018;  557564;  319764;  231170;  153840;   77330;    6630
304;T001235;CR17  ;2019;  578906;  339464;  237872;  160241;   77631;    1570
305;T001235;CR17  ;2020;  585924;  342060;  241833;  160618;   81215;    2031
306;T001235;CR18  ;2012;  159262;  103067;   55456;   43493;   11963;     739
307;T001235;CR18  ;2013;  160576;  103728;   56169;   43497;   12672;     679
308;T001235;CR18  ;2014;  163383;  104263;   57495;   43075;   14420;    1625
309;T001235;CR18  ;2015;  164485;  105122;   57758;   43267;   14491;    1605
310;T001235;CR18  ;2016;  165276;  105915;   57925;   43025;   14900;    1436
311;T001235;CR18  ;2017;  166185;  106492;   58141;   42912;   15229;    1552
312;T001235;CR18  ;2018;  166967;  107884;   57571;   40795;   16776;    1512
313;T001235;CR18  ;2019;  167843;  110281;   56953;   43083;   13870;     609
314;T001235;CR18  ;2020;  168987;  110906;   57397;   42839;   14558;     684
315;T001235;CR19  ;2012;  102361;   66278;   35412;   25649;    9763;     671
316;T001235;CR19  ;2013;  103034;   66722;   35741;   25063;   10678;     571
317;T001235;CR19  ;2014;  105025;   67111;   36628;   26134;   10494;    1286
318;T001235;CR19  ;2015;  108564;   69281;   37802;   26604;   11198;    1481
319;T001235;CR19  ;2016;  109161;   69616;   38127;   26699;   11428;    1418
320;T001235;CR19  ;2017;  109926;   69837;   38710;   26722;   11988;    1379
321;T001235;CR19  ;2018;  111154;   71532;   38233;   26808;   11425;    1389
322;T001235;CR19  ;2019;  111888;   72988;   38778;   27293;   11485;     122
323;T001235;CR19  ;2020;  113021;   73410;   39449;   27422;   12027;     162
324;T001235;CR20  ;2012;   85161;   50523;   34157;   27371;    6786;     481
325;T001235;CR20  ;2013;   85749;   50816;   34617;   27473;    7144;     316
326;T001235;CR20  ;2014;   87217;   51035;   35807;   27262;    8545;     375
327;T001235;CR20  ;2015;   87579;   51368;   35850;   27361;    8489;     361
328;T001235;CR20  ;2016;   87913;   51711;   35827;   27125;    8702;     375
329;T001235;CR20  ;2017;   88711;   52201;   35958;   27238;    8720;     552
330;T001235;CR20  ;2018;   88758;   53559;   34829;   27115;    7714;     370
331;T001235;CR20  ;2019;   89300;   54447;   34547;   27898;    6649;     306
332;T001235;CR20  ;2020;   89976;   54996;   34722;   27739;    6983;     258
333;T001235;CR21  ;2012;  103767;   57689;   44677;   30830;   13847;    1401
334;T001235;CR21  ;2013;  104602;   58155;   45542;   30986;   14556;     905
335;T001235;CR21  ;2014;  105712;   58610;   46222;   30661;   15561;     880
336;T001235;CR21  ;2015;  106849;   59214;   46862;   30857;   16005;     773
337;T001235;CR21  ;2016;  107578;   59854;   46845;   30542;   16303;     879
338;T001235;CR21  ;2017;  108104;   60177;   47011;   30437;   16574;     916
339;T001235;CR21  ;2018;  109131;   61369;   46745;   30279;   16466;    1017
340;T001235;CR21  ;2019;  107769;   60650;   46475;   30456;   16019;     644
341;T001235;CR21  ;2020;  108806;   60890;   47230;   30343;   16887;     686
342;T001235;CR22  ;2012;   71619;   37950;   33545;   28730;    4815;     124
343;T001235;CR22  ;2013;   72622;   38562;   33934;   28745;    5189;     126
344;T001235;CR22  ;2014;   73249;   38920;   34111;   28436;    5675;     218
345;T001235;CR22  ;2015;   73245;   39270;   33888;   28112;    5776;      87
346;T001235;CR22  ;2016;   73645;   39739;   33663;   27895;    5768;     243
347;T001235;CR22  ;2017;   74240;   40121;   33886;   27818;    6068;     233
348;T001235;CR22  ;2018;   74828;   41253;   33300;   27765;    5535;     275
349;T001235;CR22  ;2019;   75364;   41886;   33357;   27950;    5407;     121
350;T001235;CR22  ;2020;   75918;   42164;   33626;   27842;    5784;     128
351;T001235;CR23  ;2012;  621572;  239789;  371586;  244873;  126713;   10197
352;T001235;CR23  ;2013;  624834;  244052;  373039;  243290;  129749;    7743
353;T001235;CR23  ;2014;  630576;  247190;  376165;  242458;  133707;    7221
354;T001235;CR23  ;2015;  632971;  249672;  379216;  247475;  131741;    4083
355;T001235;CR23  ;2016;  642104;  253738;  382410;  242686;  139724;    5956
356;T001235;CR23  ;2017;  644368;  255539;  384148;  239962;  144186;    4681
357;T001235;CR23  ;2018;  650678;  259769;  386646;  241834;  144812;    4263
358;T001235;CR23  ;2019;  664293;  266859;  395992;  240439;  155553;    1442
359;T001235;CR23  ;2020;  673400;  267744;  402927;  238769;  164158;    2729
360;T001235;CR24  ;2012;  109779;   64901;   44461;   31928;   12533;     417
361;T001235;CR24  ;2013;  111370;   65547;   45316;   32028;   13288;     507
362;T001235;CR24  ;2014;  113371;   65697;   46147;   31653;   14494;    1527
363;T001235;CR24  ;2015;  113978;   66209;   46153;   31638;   14515;    1616
364;T001235;CR24  ;2016;  114417;   66788;   46080;   31380;   14700;    1549
365;T001235;CR24  ;2017;  115819;   67318;   46714;   31273;   15441;    1787
366;T001235;CR24  ;2018;  116820;   68465;   46598;   31222;   15376;    1757
367;T001235;CR24  ;2019;  117642;   70188;   47054;   31849;   15205;     400
368;T001235;CR24  ;2020;  118642;   70608;   47664;   32099;   15565;     370
369;T001235;CR25  ;2012;  176485;  103101;   71530;   49942;   21588;    1854
370;T001235;CR25  ;2013;  178368;  103828;   73244;   50708;   22536;    1296
371;T001235;CR25  ;2014;  180355;  104154;   74288;   50716;   23572;    1913
372;T001235;CR25  ;2015;  181360;  105898;   73784;   51144;   22640;    1678
373;T001235;CR25  ;2016;  184115;  107132;   74975;   50896;   24079;    2008
374;T001235;CR25  ;2017;  186529;  108306;   75998;   51166;   24832;    2225
375;T001235;CR25  ;2018;  187979;  109089;   76776;   50915;   25861;    2114
376;T001235;CR25  ;2019;  190310;  111437;   77962;   51661;   26301;     911
377;T001235;CR25  ;2020;  192562;  112415;   79355;   51623;   27732;     792
378;T001235;CR26  ;2012;  386048;  185469;  196462;  125878;   70584;    4117
379;T001235;CR26  ;2013;  390701;  186407;  199488;  126732;   72756;    4806
380;T001235;CR26  ;2014;  397755;  187153;  203075;  126622;   76453;    7527
381;T001235;CR26  ;2015;  399821;  188139;  204559;  127332;   77227;    7123
382;T001235;CR26  ;2016;  402939;  189393;  206014;  125606;   80408;    7532
383;T001235;CR26  ;2017;  405971;  191412;  208702;  125422;   83280;    5857
384;T001235;CR26  ;2018;  408338;  192139;  210127;  124771;   85356;    6072
385;T001235;CR26  ;2019;  412235;  197102;  212528;  127140;   85388;    2605
386;T001235;CR26  ;2020;  416557;  197887;  215691;  127947;   87744;    2979
387;T001235;CR27  ;2012;   95991;   49787;   45231;   35380;    9851;     973
388;T001235;CR27  ;2013;   96795;   50497;   45637;   35216;   10421;     661
389;T001235;CR27  ;2014;   97579;   50811;   46104;   35275;   10829;     664
390;T001235;CR27  ;2015;   99116;   51691;   46757;   36693;   10064;     668
391;T001235;CR27  ;2016;   99898;   52440;   46662;   36548;   10114;     796
392;T001235;CR27  ;2017;  100752;   52581;   47448;   36548;   10900;     723
393;T001235;CR27  ;2018;  101327;   53162;   47508;   35016;   12492;     657
394;T001235;CR27  ;2019;  102934;   55365;   47021;   35256;   11765;     548
395;T001235;CR27  ;2020;  103871;   55985;   47411;   35154;   12257;     475
396;T001235;CR28  ;2012;  122399;   75908;   45805;   34269;   11536;     686
397;T001235;CR28  ;2013;  123787;   76702;   46562;   34654;   11908;     523
398;T001235;CR28  ;2014;  125372;   77441;   47196;   34912;   12284;     735
399;T001235;CR28  ;2015;  136298;   84440;   51004;   37929;   13075;     854
400;T001235;CR28  ;2016;  137258;   85498;   50900;   37726;   13174;     860
401;T001235;CR28  ;2017;  138937;   86472;   51493;   37910;   13583;     972
402;T001235;CR28  ;2018;  140730;   88029;   51780;   37884;   13896;     921
403;T001235;CR28  ;2019;  142405;   90427;   51804;   37809;   13995;     174
404;T001235;CR28  ;2020;  143879;   91318;   52370;   37878;   14492;     191
405;T001235;CR29  ;2012;  653552;  308021;  338935;  259519;   79416;    6596
406;T001235;CR29  ;2013;  657097;  311134;  341418;  257988;   83430;    4545
407;T001235;CR29  ;2014;  662068;  313504;  343208;  256358;   86850;    5356
408;T001235;CR29  ;2015;  657510;  309360;  341339;  256248;   85091;    6811
409;T001235;CR29  ;2016;  658458;  311255;  340705;  251042;   89663;    6498
410;T001235;CR29  ;2017;  659055;  312031;  340887;  250451;   90436;    6137
411;T001235;CR29  ;2018;  662978;  314720;  341542;  250595;   90947;    6716
412;T001235;CR29  ;2019;  665161;  323905;  339279;  251873;   87406;    1977
413;T001235;CR29  ;2020;  672375;  326262;  343927;  252321;   91606;    2186
414;T001235;CR30  ;2012;  170971;   98034;   71607;   57444;   14163;    1330
415;T001235;CR30  ;2013;  171897;   98676;   72344;   57769;   14575;     877
416;T001235;CR30  ;2014;  172968;   99510;   72462;   57185;   15277;     996
417;T001235;CR30  ;2015;  173317;  100313;   71932;   56962;   14970;    1072
418;T001235;CR30  ;2016;  174566;  101306;   72117;   56513;   15604;    1143
419;T001235;CR30  ;2017;  175446;  102033;   72260;   56146;   16114;    1153
420;T001235;CR30  ;2018;  176282;  103972;   71091;   55809;   15282;    1219
421;T001235;CR30  ;2019;  162472;   97199;   64893;   51088;   13805;     380
422;T001235;CR30  ;2020;  163644;   98047;   65282;   50593;   14689;     315
423;T001235;CR31  ;2012;   54770;   37843;   16716;   10411;    6305;     211
424;T001235;CR31  ;2013;   52759;   36635;   15981;   10419;    5562;     143
425;T001235;CR31  ;2014;   53376;   36316;   16582;   10409;    6173;     478
426;T001235;CR31  ;2015;   53523;   36537;   16529;   10376;    6153;     457
427;T001235;CR31  ;2016;   53998;   36633;   16591;   10369;    6222;     774
428;T001235;CR31  ;2017;   54029;   36472;   16857;   10345;    6512;     700
429;T001235;CR31  ;2018;   54156;   36932;   16516;   10315;    6201;     708
430;T001235;CR31  ;2019;   54610;   37783;   15426;   10173;    5253;    1401
431;T001235;CR31  ;2020;   54753;   37633;   15384;   10107;    5277;    1736
432;T001235;CR32  ;2012;  126474;   80481;   44879;   32694;   12185;    1114
433;T001235;CR32  ;2013;  127610;   81115;   45731;   32945;   12786;     764
434;T001235;CR32  ;2014;  128992;   81315;   46112;   32781;   13331;    1565
435;T001235;CR32  ;2015;  129145;   81751;   46004;   32820;   13184;    1390
436;T001235;CR32  ;2016;  129613;   82364;   45760;   32660;   13100;    1489
437;T001235;CR32  ;2017;  130325;   82556;   46212;   32515;   13697;    1557
438;T001235;CR32  ;2018;  131108;   83994;   45547;   32333;   13214;    1567
439;T001235;CR32  ;2019;  131918;   86061;   44707;   32233;   12474;    1150
440;T001235;CR32  ;2020;  132858;   86499;   44863;   32094;   12769;    1496
441;T001235;CR33  ;2012;  267545;  164410;  101702;   77598;   24104;    1433
442;T001235;CR33  ;2013;  270897;  166212;  103720;   78655;   25065;     965
443;T001235;CR33  ;2014;  274637;  166994;  106300;   80179;   26121;    1343
444;T001235;CR33  ;2015;  276436;  167757;  107453;   80613;   26840;    1226
445;T001235;CR33  ;2016;  277337;  168639;  107060;   79816;   27244;    1638
446;T001235;CR33  ;2017;  279474;  169063;  108795;   79606;   29189;    1616
447;T001235;CR33  ;2018;  281663;  170199;  109886;   79738;   30148;    1578
448;T001235;CR33  ;2019;  283901;  175231;  107811;   80558;   27253;     859
449;T001235;CR33  ;2020;  285958;  176185;  108945;   80379;   28566;     828
450;T001235;CR34  ;2012;  195277;  117142;   76872;   57844;   19028;    1263
451;T001235;CR34  ;2013;  197168;  118417;   78102;   58053;   20049;     649
452;T001235;CR34  ;2014;  201417;  119024;   81064;   59463;   21601;    1329
453;T001235;CR34  ;2015;  203368;  119774;   82313;   60009;   22304;    1281
454;T001235;CR34  ;2016;  204773;  120839;   82484;   58952;   23532;    1450
455;T001235;CR34  ;2017;  206036;  121294;   83446;   58940;   24506;    1296
456;T001235;CR34  ;2018;  208862;  123538;   83884;   59417;   24467;    1440
457;T001235;CR34  ;2019;  211478;  125909;   85006;   60151;   24855;     563
458;T001235;CR34  ;2020;  213716;  126766;   86049;   60165;   25884;     901
459;T001235;CR35  ;2012;  266435;  169866;   94365;   72740;   21625;    2204
460;T001235;CR35  ;2013;  269772;  171798;   96251;   73933;   22318;    1723
461;T001235;CR35  ;2014;  273780;  172759;   98020;   73508;   24512;    3001
462;T001235;CR35  ;2015;  276414;  173985;   99192;   73942;   25250;    3237
463;T001235;CR35  ;2016;  278874;  175687;   99690;   74173;   25517;    3497
464;T001235;CR35  ;2017;  280598;  176683;  100781;   73847;   26934;    3134
465;T001235;CR35  ;2018;  284100;  179899;  100630;   74584;   26046;    3571
466;T001235;CR35  ;2019;  287602;  182771;  104190;   75981;   28209;     641
467;T001235;CR35  ;2020;  291212;  184699;  105748;   76202;   29546;     765
468;T001235;CR36  ;2012;  321161;  195515;  122950;   93911;   29039;    2696
469;T001235;CR36  ;2013;  324546;  197118;  125535;   94782;   30753;    1893
470;T001235;CR36  ;2014;  328948;  198072;  128387;   95799;   32588;    2489
471;T001235;CR36  ;2015;  331198;  199349;  129548;   95857;   33691;    2301
472;T001235;CR36  ;2016;  335415;  200593;  130855;   95317;   35538;    3967
473;T001235;CR36  ;2017;  338188;  201670;  132683;   95383;   37300;    3835
474;T001235;CR36  ;2018;  341477;  205626;  132840;   94793;   38047;    3011
475;T001235;CR36  ;2019;  345866;  209147;  136108;   97079;   39029;     611
476;T001235;CR36  ;2020;  349725;  210599;  138500;   97754;   40746;     626
477;T001235;CR37  ;2012;  120046;   78255;   41032;   30255;   10777;     759
478;T001235;CR37  ;2013;  120910;   78531;   41821;   30320;   11501;     558
479;T001235;CR37  ;2014;  121927;   79166;   41886;   30442;   11444;     875
480;T001235;CR37  ;2015;  122612;   79299;   42429;   30585;   11844;     884
481;T001235;CR37  ;2016;  122881;   79605;   42491;   30412;   12079;     785
482;T001235;CR37  ;2017;  123594;   79784;   43112;   30528;   12584;     698
483;T001235;CR37  ;2018;  124132;   80880;   42573;   29872;   12701;     679
484;T001235;CR37  ;2019;  124820;   82335;   42193;   30347;   11846;     292
485;T001235;CR37  ;2020;  125553;   82731;   42491;   30320;   12171;     331
486;T001235;CR38  ;2012;  103335;   69623;   33084;   23330;    9754;     628
487;T001235;CR38  ;2013;  104255;   70044;   33745;   23523;   10222;     466
488;T001235;CR38  ;2014;  106057;   70877;   33754;   23582;   10172;    1426
489;T001235;CR38  ;2015;  106511;   70680;   34291;   23557;   10734;    1540
490;T001235;CR38  ;2016;  106954;   70634;   34808;   23505;   11303;    1512
491;T001235;CR38  ;2017;  107065;   70805;   34965;   23455;   11510;    1295
492;T001235;CR38  ;2018;  107643;   71770;   34579;   23016;   11563;    1294
493;T001235;CR38  ;2019;  108156;   72929;   34912;   23690;   11222;     315
494;T001235;CR38  ;2020;  108974;   73394;   35188;   23513;   11675;     392
495;T001235;CR39  ;2012;  286644;  159793;  123058;   84863;   38195;    3793
496;T001235;CR39  ;2013;  288863;  160110;  125980;   85561;   40419;    2773
497;T001235;CR39  ;2014;  292680;  160817;  127696;   86500;   41196;    4167
498;T001235;CR39  ;2015;  294245;  160309;  129950;   87189;   42761;    3986
499;T001235;CR39  ;2016;  294798;  160387;  130197;   86586;   43611;    4214
500;T001235;CR39  ;2017;  296438;  160542;  131561;   86331;   45230;    4335
501;T001235;CR39  ;2018;  297526;  163212;  129890;   85506;   44384;    4424
502;T001235;CR39  ;2019;  298106;  166052;  130338;   85905;   44433;    1716
503;T001235;CR39  ;2020;  298704;  166009;  130969;   85865;   45104;    1726
504;T001235;CR40  ;2012;  158061;  101537;   55003;   43040;   11963;    1521
505;T001235;CR40  ;2013;  159496;  102522;   56134;   42861;   13273;     840
506;T001235;CR40  ;2014;  161512;  103306;   57343;   43016;   14327;     863
507;T001235;CR40  ;2015;  162731;  104143;   57660;   43158;   14502;     928
508;T001235;CR40  ;2016;  162918;  104778;   57357;   43306;   14051;     783
509;T001235;CR40  ;2017;  164229;  105313;   58212;   43218;   14994;     704
510;T001235;CR40  ;2018;  166487;  106430;   59225;   43262;   15963;     832
511;T001235;CR40  ;2019;  169237;  110598;   58364;   44594;   13770;     275
512;T001235;CR40  ;2020;  172227;  112198;   59731;   45006;   14725;     298
513;T001235;GM1680;2012;   12414;    8334;    3204;    1971;    1233;     876
514;T001235;GM1680;2013;   11214;    7963;    3023;    1995;    1028;     228
515;T001235;GM1680;2014;   11173;    7896;    3110;    1948;    1162;     167
516;T001235;GM1680;2015;   11150;    7869;    3148;    2098;    1050;     133
517;T001235;GM1680;2016;   11131;    7916;    3045;    1967;    1078;     170
518;T001235;GM1680;2017;   11145;    7880;    3092;    1964;    1128;     173
519;T001235;GM1680;2018;   11165;    8157;    2839;    1969;     870;     169
520;T001235;GM1680;2019;   11257;    8342;    2898;    2224;     674;      17
521;T001235;GM1680;2020;   11179;    8338;    2833;    2218;     615;       8
522;T001235;GM0738;2012;    4769;    3455;    1307;     983;     324;       7
523;T001235;GM0738;2013;    4857;    3499;    1351;    1004;     347;       7
524;T001235;GM0738;2014;    4971;    3540;    1389;    1012;     377;      42
525;T001235;GM0738;2015;    5020;    3542;    1427;     962;     465;      51
526;T001235;GM0738;2016;    5031;    3611;    1407;     939;     468;      13
527;T001235;GM0738;2017;    5071;    3629;    1434;     927;     507;       8
528;T001235;GM0738;2018;    5109;    3701;    1375;     943;     432;      33
529;T001235;GM0738;2019;;;;;;
530;T001235;GM0738;2020;;;;;;
531;T001235;GM0358;2012;   12267;    7857;    4340;    3055;    1285;      70
532;T001235;GM0358;2013;   12354;    7913;    4395;    3052;    1343;      46
533;T001235;GM0358;2014;   12780;    8057;    4468;    3151;    1317;     255
534;T001235;GM0358;2015;   12803;    8107;    4501;    3195;    1306;     195
535;T001235;GM0358;2016;   12893;    8144;    4500;    3135;    1365;     249
536;T001235;GM0358;2017;   12919;    8158;    4516;    3134;    1382;     245
537;T001235;GM0358;2018;   12888;    8262;    4382;    3092;    1290;     244
538;T001235;GM0358;2019;   13091;    8458;    4629;    3108;    1521;       4
539;T001235;GM0358;2020;   13217;    8557;    4654;    3114;    1540;       6
540;T001235;GM0197;2012;   11504;    7973;    3492;    2467;    1025;      39
541;T001235;GM0197;2013;   11451;    8044;    3384;    2414;     970;      23
542;T001235;GM0197;2014;   11687;    8102;    3401;    2389;    1012;     184
543;T001235;GM0197;2015;   11775;    8164;    3417;    2344;    1073;     194
544;T001235;GM0197;2016;   11811;    8204;    3416;    2288;    1128;     191
545;T001235;GM0197;2017;   11872;    8262;    3418;    2282;    1136;     192
546;T001235;GM0197;2018;   11922;    8318;    3424;    2303;    1121;     180
547;T001235;GM0197;2019;   11971;    8476;    3476;    2298;    1178;      19
548;T001235;GM0197;2020;   11976;    8510;    3427;    2315;    1112;      39
549;T001235;GM0059;2012;   11663;    7473;    4160;    3635;     525;      30
550;T001235;GM0059;2013;   11711;    7508;    4175;    3633;     542;      28
551;T001235;GM0059;2014;   11894;    7510;    4205;    3632;     573;     179
552;T001235;GM0059;2015;   11917;    7555;    4184;    3594;     590;     178
553;T001235;GM0059;2016;   11946;    7571;    4195;    3499;     696;     180
554;T001235;GM0059;2017;   12028;    7551;    4293;    3538;     755;     184
555;T001235;GM0059;2018;   12075;    7714;    4166;    3602;     564;     195
556;T001235;GM0059;2019;   12118;    7757;    4344;    3772;     572;      17
557;T001235;GM0059;2020;   12129;    7734;    4388;    3751;     637;       7
558;T001235;GM0482;2012;    8083;    4726;    3350;    2820;     530;       7
559;T001235;GM0482;2013;    8111;    4757;    3348;    2805;     543;       6
560;T001235;GM0482;2014;    8122;    4774;    3343;    2794;     549;       5
561;T001235;GM0482;2015;    8138;    4830;    3294;    2781;     513;      14
562;T001235;GM0482;2016;    8220;    4943;    3243;    2734;     509;      34
563;T001235;GM0482;2017;    8252;    4920;    3328;    2753;     575;       4
564;T001235;GM0482;2018;    8276;    5011;    3255;    2757;     498;      10
565;T001235;GM0482;2019;    8324;    5104;    3211;    2752;     459;       9
566;T001235;GM0482;2020;    8353;    5096;    3246;    2755;     491;      11
567;T001235;GM0613;2012;    9822;    6612;    3141;    2594;     547;      69
568;T001235;GM0613;2013;   10059;    6811;    3218;    2624;     594;      30
569;T001235;GM0613;2014;   10165;    6828;    3248;    2604;     644;      89
570;T001235;GM0613;2015;   10167;    6826;    3255;    2612;     643;      86
571;T001235;GM0613;2016;   10208;    6867;    3255;    2653;     602;      86
572;T001235;GM0613;2017;   10286;    6923;    3275;    2656;     619;      88
573;T001235;GM0613;2018;   10333;    7022;    3222;    2651;     571;      89
574;T001235;GM0613;2019;   10347;    7133;    3205;    2702;     503;       9
575;T001235;GM0613;2020;   10517;    7270;    3205;    2694;     511;      42
576;T001235;GM0361;2012;   43703;   24716;   18807;   14310;    4497;     180
577;T001235;GM0361;2013;   44049;   24936;   18938;   13735;    5203;     175
578;T001235;GM0361;2014;   44884;   25178;   19173;   14335;    4838;     533
579;T001235;GM0361;2015;   50076;   28909;   20418;   15046;    5372;     749
580;T001235;GM0361;2016;   50346;   29049;   20566;   15115;    5451;     731
581;T001235;GM0361;2017;   50513;   28983;   20856;   15063;    5793;     674
582;T001235;GM0361;2018;   50830;   29487;   20716;   15099;    5617;     627
583;T001235;GM0361;2019;   51127;   30071;   21008;   15170;    5838;      48
584;T001235;GM0361;2020;   51339;   30043;   21242;   15248;    5994;      54
585;T001235;GM0141;2012;   31995;   17661;   14208;   11884;    2324;     126
586;T001235;GM0141;2013;   32117;   17685;   14342;   11911;    2431;      90
587;T001235;GM0141;2014;   32159;   17688;   14390;   11750;    2640;      81
588;T001235;GM0141;2015;   32281;   17732;   14405;   11703;    2702;     144
589;T001235;GM0141;2016;   32417;   17702;   14477;   11575;    2902;     238
590;T001235;GM0141;2017;   32859;   17564;   15121;   11699;    3422;     174
591;T001235;GM0141;2018;   32988;   17933;   14885;   11661;    3224;     170
592;T001235;GM0141;2019;   33472;   18308;   15129;   11699;    3430;      35
593;T001235;GM0141;2020;   33549;   18312;   15194;   11641;    3553;      43
594;T001235;GM0034;2012;   76755;   48517;   28095;   21732;    6363;     143
595;T001235;GM0034;2013;   77609;   49206;   28321;   21593;    6728;      82
596;T001235;GM0034;2014;   78330;   49656;   28552;   21637;    6915;     122
597;T001235;GM0034;2015;   78974;   50266;   28552;   21631;    6921;     156
598;T001235;GM0034;2016;   79721;   50834;   28724;   21785;    6939;     163
599;T001235;GM0034;2017;   80582;   51333;   29088;   21827;    7261;     161
600;T001235;GM0034;2018;   82312;   52076;   29997;   21855;    8142;     239
601;T001235;GM0034;2019;   84161;   54028;   29962;   22978;    6984;     171
602;T001235;GM0034;2020;   85977;   54906;   30895;   23334;    7561;     176
603;T001235;GM0484;2012;   31005;   19324;   11541;    8353;    3188;     140
604;T001235;GM0484;2013;   31280;   19492;   11658;    8357;    3301;     130
605;T001235;GM0484;2014;   45433;   28579;   16664;   12239;    4425;     190
606;T001235;GM0484;2015;   45753;   28751;   16824;   12410;    4414;     178
607;T001235;GM0484;2016;   45968;   28960;   16812;   12400;    4412;     196
608;T001235;GM0484;2017;   46723;   29236;   17208;   12508;    4700;     279
609;T001235;GM0484;2018;   47099;   29656;   17242;   12484;    4758;     201
610;T001235;GM0484;2019;   47753;   30388;   17328;   12519;    4809;      37
611;T001235;GM0484;2020;   48178;   30521;   17612;   12628;    4984;      45
612;T001235;GM1723;2012;    3936;    3022;     854;     461;     393;      60
613;T001235;GM1723;2013;    3984;    3062;     865;     532;     333;      57
614;T001235;GM1723;2014;    4050;    3079;     947;     552;     395;      24
615;T001235;GM1723;2015;    4149;    3137;     965;     572;     393;      47
616;T001235;GM1723;2016;    4214;    3174;     995;     574;     421;      45
617;T001235;GM1723;2017;    4254;    3192;    1010;     573;     437;      52
618;T001235;GM1723;2018;    4280;    3251;     990;     573;     417;      39
619;T001235;GM1723;2019;    4342;    3309;    1028;     594;     434;       5
620;T001235;GM1723;2020;    4371;    3324;    1036;     590;     446;      11
621;T001235;GM1959;2012;;;;;;
622;T001235;GM1959;2013;;;;;;
623;T001235;GM1959;2014;;;;;;
624;T001235;GM1959;2015;;;;;;
625;T001235;GM1959;2016;;;;;;
626;T001235;GM1959;2017;;;;;;
627;T001235;GM1959;2018;;;;;;
628;T001235;GM1959;2019;   22221;   15214;    6905;    5519;    1386;     102
629;T001235;GM1959;2020;   22399;   15357;    6956;    5519;    1437;      86
630;T001235;GM0060;2012;    1547;    1054;     456;       0;     456;      37
631;T001235;GM0060;2013;    1568;    1084;     446;       0;     446;      38
632;T001235;GM0060;2014;    1657;    1107;     465;       0;     465;      85
633;T001235;GM0060;2015;    1670;    1104;     473;       0;     473;      93
634;T001235;GM0060;2016;    1674;    1103;     474;       0;     474;      97
635;T001235;GM0060;2017;    1686;    1086;     499;       0;     499;     101
636;T001235;GM0060;2018;    1712;    1114;     492;       0;     492;     106
637;T001235;GM0060;2019;    1731;    1183;     529;       0;     529;      19
638;T001235;GM0060;2020;    1737;    1177;     536;       0;     536;      24
639;T001235;GM0307;2012;   63442;   36027;   26997;   20337;    6660;     418
640;T001235;GM0307;2013;   63856;   36524;   27017;   19822;    7195;     315
641;T001235;GM0307;2014;   64455;   36877;   27300;   19877;    7423;     278
642;T001235;GM0307;2015;   64833;   37293;   27285;   19982;    7303;     255
643;T001235;GM0307;2016;   65289;   37721;   27169;   19816;    7353;     399
644;T001235;GM0307;2017;   66034;   38138;   27600;   19710;    7890;     296
645;T001235;GM0307;2018;   66530;   38617;   27604;   19593;    8011;     309
646;T001235;GM0307;2019;   67181;   39334;   27703;   19873;    7830;     144
647;T001235;GM0307;2020;   67722;   39576;   27986;   19890;    8096;     160
648;T001235;GM0362;2012;   41304;   19082;   19220;   11155;    8065;    3002
649;T001235;GM0362;2013;   41616;   19281;   21036;   11583;    9453;    1299
650;T001235;GM0362;2014;   42395;   19472;   21420;   11850;    9570;    1503
651;T001235;GM0362;2015;   42736;   19572;   22613;   14384;    8229;     551
652;T001235;GM0362;2016;   43045;   19496;   22122;   12412;    9710;    1427
653;T001235;GM0362;2017;   41649;   19564;   21087;   12490;    8597;     998
654;T001235;GM0362;2018;   41782;   19779;   21032;   12504;    8528;     971
655;T001235;GM0362;2019;   42035;   19878;   22100;   12614;    9486;      57
656;T001235;GM0362;2020;   42310;   19813;   22385;   12636;    9749;     112
657;T001235;GM0363;2012;  408888;  113844;  289595;  187270;  102325;    5449
658;T001235;GM0363;2013;  411127;  117099;  289046;  185512;  103534;    4982
659;T001235;GM0363;2014;  413697;  119095;  290624;  183986;  106638;    3978
660;T001235;GM0363;2015;  416966;  122642;  291868;  185561;  106307;    2456
661;T001235;GM0363;2016;  424390;  125694;  296082;  184023;  112059;    2614
662;T001235;GM0363;2017;  428035;  126841;  298553;  181465;  117088;    2641
663;T001235;GM0363;2018;  432715;  128572;  301947;  183041;  118906;    2196
664;T001235;GM0363;2019;  441490;  131530;  308772;  180166;  128606;    1188
665;T001235;GM0363;2020;  447351;  131342;  313602;  178619;  134983;    2407
666;T001235;GM0200;2012;   67968;   39774;   27499;   20544;    6955;     695
667;T001235;GM0200;2013;   68319;   39982;   27892;   20705;    7187;     445
668;T001235;GM0200;2014;   69507;   40443;   28720;   20340;    8380;     344
669;T001235;GM0200;2015;   69804;   40878;   28709;   20279;    8430;     217
670;T001235;GM0200;2016;   70615;   41601;   28791;   20166;    8625;     223
671;T001235;GM0200;2017;   71050;   41673;   29101;   20094;    9007;     276
672;T001235;GM0200;2018;   71526;   42739;   28406;   20229;    8177;     381
673;T001235;GM0200;2019;   72445;   43586;   28745;   20862;    7883;     114
674;T001235;GM0200;2020;   73244;   44068;   29089;   20815;    8274;      87
675;T001235;GM0003;2012;    5732;    2808;    2918;    2455;     463;       6
676;T001235;GM0003;2013;    5785;    2832;    2945;    2526;     419;       8
677;T001235;GM0003;2014;    5840;    2828;    3010;    2566;     444;       2
678;T001235;GM0003;2015;    5850;    2830;    3017;    2573;     444;       3
679;T001235;GM0003;2016;    5881;    2884;    2993;    2596;     397;       4
680;T001235;GM0003;2017;    5899;    2892;    3002;    2593;     409;       5
681;T001235;GM0003;2018;    5925;    2895;    3007;    2589;     418;      23
682;T001235;GM0003;2019;    6032;    2911;    3119;    2607;     512;       2
683;T001235;GM0003;2020;    6042;    2915;    3126;    2595;     531;       1
684;T001235;GM0202;2012;   69605;   31052;   37359;   25866;   11493;    1194
685;T001235;GM0202;2013;   70571;   31280;   38805;   26372;   12433;     486
686;T001235;GM0202;2014;   71114;   31323;   39290;   26326;   12964;     501
687;T001235;GM0202;2015;   71962;   31549;   39816;   26942;   12874;     597
688;T001235;GM0202;2016;   72711;   31924;   40065;   26772;   13293;     722
689;T001235;GM0202;2017;   73640;   31968;   40805;   26688;   14117;     867
690;T001235;GM0202;2018;   74416;   32363;   41378;   27043;   14335;     675
691;T001235;GM0202;2019;   75632;   33134;   41937;   27180;   14757;     561
692;T001235;GM0202;2020;   76737;   33345;   42547;   27244;   15303;     845
693;T001235;GM0106;2012;   29854;   17707;   11923;    9093;    2830;     224
694;T001235;GM0106;2013;   30183;   17765;   12262;    9162;    3100;     156
695;T001235;GM0106;2014;   30539;   17806;   12638;    9236;    3402;      95
696;T001235;GM0106;2015;   30737;   17862;   12571;    9152;    3419;     304
697;T001235;GM0106;2016;   30691;   17971;   12387;    8954;    3433;     333
698;T001235;GM0106;2017;   30995;   18026;   12582;    8991;    3591;     387
699;T001235;GM0106;2018;   31424;   18212;   12777;    8867;    3910;     435
700;T001235;GM0106;2019;   31570;   18756;   12642;    8865;    3777;     172
701;T001235;GM0106;2020;   32154;   18922;   13061;    9000;    4061;     171
702;T001235;GM0743;2012;    6337;    4583;    1716;    1423;     293;      38
703;T001235;GM0743;2013;    6464;    4704;    1731;    1419;     312;      29
704;T001235;GM0743;2014;    6662;    4760;    1875;    1453;     422;      27
705;T001235;GM0743;2015;    6698;    4759;    1920;    1485;     435;      19
706;T001235;GM0743;2016;    6717;    4740;    1956;    1451;     505;      21
707;T001235;GM0743;2017;    6768;    4780;    1974;    1454;     520;      14
708;T001235;GM0743;2018;    6803;    4814;    1965;    1460;     505;      24
709;T001235;GM0743;2019;    6853;    4895;    1951;    1484;     467;       7
710;T001235;GM0743;2020;    6899;    4898;    1991;    1492;     499;      10
711;T001235;GM0744;2012;    2681;    1901;     761;     326;     435;      19
712;T001235;GM0744;2013;    2706;    1900;     781;     336;     445;      25
713;T001235;GM0744;2014;    2727;    1909;     798;     325;     473;      20
714;T001235;GM0744;2015;    2744;    1927;     804;     343;     461;      13
715;T001235;GM0744;2016;    2746;    1921;     811;     332;     479;      14
716;T001235;GM0744;2017;    2770;    1925;     828;     331;     497;      17
717;T001235;GM0744;2018;    2832;    1966;     852;     329;     523;      14
718;T001235;GM0744;2019;    2852;    1997;     799;     338;     461;      56
719;T001235;GM0744;2020;    2875;    2004;     800;     334;     466;      71
720;T001235;GM0308;2012;   11071;    6738;    4030;    2772;    1258;     303
721;T001235;GM0308;2013;   11228;    6749;    4246;    2799;    1447;     233
722;T001235;GM0308;2014;   11439;    6743;    4461;    2820;    1641;     235
723;T001235;GM0308;2015;   11586;    6774;    4478;    2794;    1684;     334
724;T001235;GM0308;2016;   11586;    6799;    4418;    2777;    1641;     369
725;T001235;GM0308;2017;   11676;    6815;    4426;    2777;    1649;     435
726;T001235;GM0308;2018;   11564;    6992;    4247;    2826;    1421;     325
727;T001235;GM0308;2019;   11647;    7109;    4513;    2913;    1600;      25
728;T001235;GM0308;2020;   11679;    7142;    4509;    2962;    1547;      28
729;T001235;GM0489;2012;   18421;   12301;    6033;    4079;    1954;      87
730;T001235;GM0489;2013;   18760;   12564;    6169;    4134;    2035;      27
731;T001235;GM0489;2014;   18806;   12605;    6188;    3998;    2190;      13
732;T001235;GM0489;2015;   18867;   12651;    6202;    4136;    2066;      14
733;T001235;GM0489;2016;   18918;   12913;    5991;    3984;    2007;      14
734;T001235;GM0489;2017;   19131;   13075;    6021;    4108;    1913;      35
735;T001235;GM0489;2018;   19184;   13251;    5897;    4107;    1790;      36
736;T001235;GM0489;2019;   19256;   13454;    5771;    4240;    1531;      31
737;T001235;GM0489;2020;   19416;   13517;    5865;    4278;    1587;      34
738;T001235;GM0203;2012;   19699;   13114;    6214;    4080;    2134;     371
739;T001235;GM0203;2013;   19835;   13204;    6301;    4072;    2229;     330
740;T001235;GM0203;2014;   20118;   13366;    6357;    3984;    2373;     395
741;T001235;GM0203;2015;   20598;   13726;    6496;    4064;    2432;     376
742;T001235;GM0203;2016;   20938;   14044;    6610;    4064;    2546;     284
743;T001235;GM0203;2017;   21330;   14161;    6821;    4092;    2729;     348
744;T001235;GM0203;2018;   21926;   14704;    6728;    4173;    2555;     494
745;T001235;GM0203;2019;   22249;   15081;    7129;    4359;    2770;      39
746;T001235;GM0203;2020;   22799;   15420;    7348;    4408;    2940;      31
747;T001235;GM0005;2012;    4424;    3016;    1400;    1025;     375;       8
748;T001235;GM0005;2013;    4464;    3048;    1406;    1028;     378;      10
749;T001235;GM0005;2014;    4500;    3058;    1431;    1000;     431;      11
750;T001235;GM0005;2015;    4529;    3080;    1438;    1097;     341;      11
751;T001235;GM0005;2016;    4570;    3090;    1466;    1131;     335;      14
752;T001235;GM0005;2017;    4569;    3114;    1439;    1085;     354;      16
753;T001235;GM0005;2018;    4614;    3170;    1424;    1060;     364;      20
754;T001235;GM0005;2019;;;;;;
755;T001235;GM0005;2020;;;;;;
756;T001235;GM0888;2012;    7360;    5108;    2221;    1595;     626;      31
757;T001235;GM0888;2013;    7373;    5091;    2246;    1593;     653;      36
758;T001235;GM0888;2014;    7417;    5170;    2218;    1627;     591;      29
759;T001235;GM0888;2015;    7416;    5136;    2254;    1624;     630;      26
760;T001235;GM0888;2016;    7415;    5103;    2287;    1620;     667;      25
761;T001235;GM0888;2017;    7410;    5095;    2292;    1604;     688;      23
762;T001235;GM0888;2018;    7424;    5161;    2234;    1592;     642;      29
763;T001235;GM0888;2019;    7485;    5227;    2245;    1608;     637;      13
764;T001235;GM0888;2020;    7488;    5224;    2251;    1604;     647;      13
765;T001235;GM1954;2012;;;;;;
766;T001235;GM1954;2013;;;;;;
767;T001235;GM1954;2014;;;;;;
768;T001235;GM1954;2015;;;;;;
769;T001235;GM1954;2016;;;;;;
770;T001235;GM1954;2017;;;;;;
771;T001235;GM1954;2018;;;;;;
772;T001235;GM1954;2019;   16635;   12124;    4456;    2974;    1482;      55
773;T001235;GM1954;2020;   16635;   12127;    4459;    2974;    1485;      49
774;T001235;GM0370;2012;    3422;    2509;     907;     700;     207;       6
775;T001235;GM0370;2013;    3432;    2523;     907;     698;     209;       2
776;T001235;GM0370;2014;    3635;    2651;     962;     733;     229;      22
777;T001235;GM0370;2015;    3641;    2685;     945;     730;     215;      11
778;T001235;GM0370;2016;    3657;    2688;     966;     730;     236;       3
779;T001235;GM0370;2017;    3790;    2807;     977;     728;     249;       6
780;T001235;GM0370;2018;    3836;    2854;     976;     728;     248;       6
781;T001235;GM0370;2019;    3941;    2973;     964;     744;     220;       4
782;T001235;GM0370;2020;    4036;    3064;     965;     745;     220;       7
783;T001235;GM0889;2012;    5939;    3933;    1944;    1743;     201;      62
784;T001235;GM0889;2013;    5925;    3948;    1943;    1733;     210;      34
785;T001235;GM0889;2014;    5904;    3963;    1930;    1717;     213;      11
786;T001235;GM0889;2015;    5911;    3883;    2016;    1703;     313;      12
787;T001235;GM0889;2016;    5882;    3896;    1970;    1644;     326;      16
788;T001235;GM0889;2017;    5888;    3904;    1971;    1627;     344;      13
789;T001235;GM0889;2018;    5946;    3974;    1957;    1682;     275;      15
790;T001235;GM0889;2019;    5959;    4039;    1918;    1663;     255;       2
791;T001235;GM0889;2020;    5965;    4039;    1924;    1656;     268;       2
792;T001235;GM0007;2012;    4168;    2972;    1143;     843;     300;      53
793;T001235;GM0007;2013;    4136;    2965;    1125;     824;     301;      46
794;T001235;GM0007;2014;    4136;    2966;    1127;     814;     313;      43
795;T001235;GM0007;2015;    4128;    2953;    1132;     808;     324;      43
796;T001235;GM0007;2016;    4116;    2931;    1142;     803;     339;      43
797;T001235;GM0007;2017;    4117;    2905;    1169;     799;     370;      43
798;T001235;GM0007;2018;;;;;;
799;T001235;GM0007;2019;;;;;;
800;T001235;GM0007;2020;;;;;;
801;T001235;GM1945;2012;;;;;;
802;T001235;GM1945;2013;;;;;;
803;T001235;GM1945;2014;;;;;;
804;T001235;GM1945;2015;;;;;;
805;T001235;GM1945;2016;   15283;    9164;    6043;    4527;    1516;      76
806;T001235;GM1945;2017;   15397;    9139;    6173;    4532;    1641;      85
807;T001235;GM1945;2018;   15519;    9414;    5995;    4519;    1476;     110
808;T001235;GM1945;2019;   15645;    9575;    5969;    4594;    1375;     101
809;T001235;GM1945;2020;   15802;    9646;    6014;    4587;    1427;     142
810;T001235;GM0491;2012;    3942;    2633;    1280;    1052;     228;      29
811;T001235;GM0491;2013;    4019;    2721;    1273;    1024;     249;      25
812;T001235;GM0491;2014;    4142;    2738;    1392;    1147;     245;      12
813;T001235;GM0491;2015;;;;;;
814;T001235;GM0491;2016;;;;;;
815;T001235;GM0491;2017;;;;;;
816;T001235;GM0491;2018;;;;;;
817;T001235;GM0491;2019;;;;;;
818;T001235;GM0491;2020;;;;;;
819;T001235;GM1724;2012;    7456;    5894;    1522;    1039;     483;      40
820;T001235;GM1724;2013;    7573;    5952;    1580;    1049;     531;      41
821;T001235;GM1724;2014;    7653;    5971;    1618;    1041;     577;      64
822;T001235;GM1724;2015;    7679;    5994;    1629;    1043;     586;      56
823;T001235;GM1724;2016;    7742;    6035;    1642;    1035;     607;      65
824;T001235;GM1724;2017;    7770;    6038;    1665;    1038;     627;      67
825;T001235;GM1724;2018;    7810;    6120;    1620;    1038;     582;      70
826;T001235;GM1724;2019;    7870;    6139;    1721;    1072;     649;      10
827;T001235;GM1724;2020;    7970;    6198;    1761;    1081;     680;      11
828;T001235;GM0893;2012;    5480;    3831;    1629;    1324;     305;      20
829;T001235;GM0893;2013;    5497;    3826;    1669;    1315;     354;       2
830;T001235;GM0893;2014;    5552;    3880;    1669;    1303;     366;       3
831;T001235;GM0893;2015;    5594;    3859;    1730;    1375;     355;       5
832;T001235;GM0893;2016;    5619;    3849;    1761;    1368;     393;       9
833;T001235;GM0893;2017;    5669;    3889;    1771;    1368;     403;       9
834;T001235;GM0893;2018;    5683;    3954;    1718;    1356;     362;      11
835;T001235;GM0893;2019;    5723;    4054;    1654;    1358;     296;      15
836;T001235;GM0893;2020;    5760;    4058;    1691;    1360;     331;      11
837;T001235;GM0373;2012;   14658;    9777;    4572;    2713;    1859;     309
838;T001235;GM0373;2013;   14635;    9774;    4602;    2685;    1917;     259
839;T001235;GM0373;2014;   14988;    9754;    4754;    2695;    2059;     480
840;T001235;GM0373;2015;   14986;    9780;    4740;    2693;    2047;     466
841;T001235;GM0373;2016;   14976;    9778;    4798;    2702;    2096;     400
842;T001235;GM0373;2017;   14992;    9808;    4790;    2700;    2090;     394
843;T001235;GM0373;2018;   15113;   10133;    4601;    2719;    1882;     379
844;T001235;GM0373;2019;   15209;   10287;    4878;    2795;    2083;      44
845;T001235;GM0373;2020;   15344;   10285;    4983;    2792;    2191;      76
846;T001235;GM0748;2012;   29604;   16849;   12640;    9618;    3022;     115
847;T001235;GM0748;2013;   29739;   16935;   12720;    9747;    2973;      84
848;T001235;GM0748;2014;   29887;   16953;   12839;    9781;    3058;      95
849;T001235;GM0748;2015;   30010;   16937;   12943;    9851;    3092;     130
850;T001235;GM0748;2016;   29738;   17009;   12624;    9652;    2972;     105
851;T001235;GM0748;2017;   29916;   17154;   12645;    9634;    3011;     117
852;T001235;GM0748;2018;   30047;   17076;   12833;    9520;    3313;     138
853;T001235;GM0748;2019;   30380;   17862;   12462;    9572;    2890;      56
854;T001235;GM0748;2020;   30884;   18083;   12765;    9681;    3084;      36
855;T001235;GM1859;2012;   18879;   12416;    6116;    4367;    1749;     347
856;T001235;GM1859;2013;   19205;   12600;    6291;    4383;    1908;     314
857;T001235;GM1859;2014;   19390;   12703;    6464;    4433;    2031;     223
858;T001235;GM1859;2015;   19299;   12744;    6414;    4497;    1917;     141
859;T001235;GM1859;2016;   19466;   12819;    6413;    4316;    2097;     234
860;T001235;GM1859;2017;   19458;   12825;    6409;    4292;    2117;     224
861;T001235;GM1859;2018;   19492;   13147;    6141;    4304;    1837;     204
862;T001235;GM1859;2019;   19541;   13264;    6255;    4714;    1541;      22
863;T001235;GM1859;2020;   19525;   13296;    6212;    4628;    1584;      17
864;T001235;GM1721;2012;   11307;    8281;    2990;    2337;     653;      36
865;T001235;GM1721;2013;   11368;    8312;    3029;    2321;     708;      27
866;T001235;GM1721;2014;   11941;    8454;    3323;    2272;    1051;     164
867;T001235;GM1721;2015;   12000;    8513;    3337;    2288;    1049;     150
868;T001235;GM1721;2016;   12044;    8610;    3283;    2306;     977;     151
869;T001235;GM1721;2017;   12059;    8640;    3306;    2276;    1030;     113
870;T001235;GM1721;2018;   12301;    8810;    3384;    2369;    1015;     107
871;T001235;GM1721;2019;   12451;    8951;    3466;    2360;    1106;      34
872;T001235;GM1721;2020;   12714;    9097;    3610;    2428;    1182;       7
873;T001235;GM0568;2012;    5378;    3680;    1650;    1374;     276;      48
874;T001235;GM0568;2013;    5499;    3773;    1685;    1350;     335;      41
875;T001235;GM0568;2014;    5517;    3787;    1719;    1361;     358;      11
876;T001235;GM0568;2015;;;;;;
877;T001235;GM0568;2016;;;;;;
878;T001235;GM0568;2017;;;;;;
879;T001235;GM0568;2018;;;;;;
880;T001235;GM0568;2019;;;;;;
881;T001235;GM0568;2020;;;;;;
882;T001235;GM0753;2012;   11703;    8596;    3087;    2397;     690;      20
883;T001235;GM0753;2013;   11769;    8670;    3082;    2395;     687;      17
884;T001235;GM0753;2014;   11965;    8669;    3185;    2444;     741;     111
885;T001235;GM0753;2015;   11952;    8743;    3186;    2449;     737;      23
886;T001235;GM0753;2016;   12031;    8786;    3229;    2472;     757;      16
887;T001235;GM0753;2017;   12326;    8837;    3441;    2505;     936;      48
888;T001235;GM0753;2018;   12353;    8887;    3416;    2475;     941;      50
889;T001235;GM0753;2019;   12535;    9047;    3448;    2537;     911;      40
890;T001235;GM0753;2020;   12698;    9094;    3577;    2600;     977;      27
891;T001235;GM0209;2012;   10374;    7026;    3330;    2460;     870;      18
892;T001235;GM0209;2013;   10365;    7081;    3268;    2443;     825;      16
893;T001235;GM0209;2014;   10538;    7103;    3417;    2545;     872;      18
894;T001235;GM0209;2015;   10581;    7136;    3424;    2552;     872;      21
895;T001235;GM0209;2016;   10667;    7178;    3427;    2519;     908;      62
896;T001235;GM0209;2017;   10829;    7222;    3561;    2532;    1029;      46
897;T001235;GM0209;2018;   11043;    7529;    3457;    2559;     898;      57
898;T001235;GM0209;2019;   11090;    7718;    3358;    2528;     830;      14
899;T001235;GM0209;2020;   11137;    7747;    3374;    2527;     847;      16
900;T001235;GM0375;2012;   18325;    9748;    8506;    7248;    1258;      71
901;T001235;GM0375;2013;   18483;    9826;    8621;    7282;    1339;      36
902;T001235;GM0375;2014;   18736;    9808;    8892;    7118;    1774;      36
903;T001235;GM0375;2015;   18760;    9835;    8867;    7066;    1801;      58
904;T001235;GM0375;2016;   18846;    9915;    8865;    7073;    1792;      66
905;T001235;GM0375;2017;   19106;   10065;    8969;    7206;    1763;      72
906;T001235;GM0375;2018;   19189;   10256;    8875;    7263;    1612;      58
907;T001235;GM0375;2019;   19280;   10528;    8740;    7076;    1664;      12
908;T001235;GM0375;2020;   19403;   10676;    8711;    7030;    1681;      16
909;T001235;GM0063;2012;    4539;    2892;    1643;    1325;     318;       4
910;T001235;GM0063;2013;    4496;    2910;    1583;    1275;     308;       3
911;T001235;GM0063;2014;    4559;    2984;    1571;    1262;     309;       4
912;T001235;GM0063;2015;    4666;    3036;    1541;    1259;     282;      89
913;T001235;GM0063;2016;    4696;    3053;    1553;    1261;     292;      90
914;T001235;GM0063;2017;    4697;    3066;    1540;    1248;     292;      91
915;T001235;GM0063;2018;;;;;;
916;T001235;GM0063;2019;;;;;;
917;T001235;GM0063;2020;;;;;;
918;T001235;GM0310;2012;   19274;   11434;    7306;    5056;    2250;     534
919;T001235;GM0310;2013;   19363;   11476;    7525;    5046;    2479;     362
920;T001235;GM0310;2014;   19195;   11248;    7592;    5077;    2515;     355
921;T001235;GM0310;2015;   19220;   11230;    7680;    5039;    2641;     310
922;T001235;GM0310;2016;   19260;   11263;    7690;    5017;    2673;     307
923;T001235;GM0310;2017;   19375;   11362;    7705;    5018;    2687;     308
924;T001235;GM0310;2018;   19412;   11520;    7753;    5081;    2672;     139
925;T001235;GM0310;2019;   19544;   11838;    7651;    5390;    2261;      55
926;T001235;GM0310;2020;   19577;   11829;    7634;    5383;    2251;     114
927;T001235;GM0585;2012;   12428;    8294;    4027;    3483;     544;     107
928;T001235;GM0585;2013;   12477;    8377;    4043;    3489;     554;      57
929;T001235;GM0585;2014;   12565;    8449;    4076;    3503;     573;      40
930;T001235;GM0585;2015;   12527;    8512;    3976;    3381;     595;      39
931;T001235;GM0585;2016;   12608;    8680;    3886;    3361;     525;      42
932;T001235;GM0585;2017;   12722;    8661;    4016;    3381;     635;      45
933;T001235;GM0585;2018;   12809;    8852;    3917;    3346;     571;      40
934;T001235;GM0585;2019;;;;;;
935;T001235;GM0585;2020;;;;;;
936;T001235;GM1728;2012;    8061;    6099;    1928;    1321;     607;      34
937;T001235;GM1728;2013;    8076;    6095;    1958;    1300;     658;      23
938;T001235;GM1728;2014;    8302;    6143;    2078;    1341;     737;      81
939;T001235;GM1728;2015;    8346;    6183;    2087;    1321;     766;      76
940;T001235;GM1728;2016;    8417;    6279;    2061;    1359;     702;      77
941;T001235;GM1728;2017;    8486;    6309;    2095;    1331;     764;      82
942;T001235;GM1728;2018;    8552;    6429;    2044;    1334;     710;      79
943;T001235;GM1728;2019;    8618;    6470;    2137;    1323;     814;      11
944;T001235;GM1728;2020;    8746;    6536;    2173;    1299;     874;      37
945;T001235;GM0376;2012;    3888;    2656;    1218;     814;     404;      14
946;T001235;GM0376;2013;    4078;    2718;    1325;     918;     407;      35
947;T001235;GM0376;2014;    4151;    2751;    1383;     953;     430;      17
948;T001235;GM0376;2015;    4269;    2820;    1430;     961;     469;      19
949;T001235;GM0376;2016;    4363;    2921;    1427;     959;     468;      15
950;T001235;GM0376;2017;    4639;    3059;    1565;    1026;     539;      15
951;T001235;GM0376;2018;    4864;    3317;    1531;    1035;     496;      16
952;T001235;GM0376;2019;    4941;    3410;    1513;    1080;     433;      18
953;T001235;GM0376;2020;    5075;    3510;    1519;    1080;     439;      46
954;T001235;GM0377;2012;    9439;    6608;    2788;    1739;    1049;      43
955;T001235;GM0377;2013;    9513;    6616;    2888;    1733;    1155;       9
956;T001235;GM0377;2014;    9565;    6619;    2942;    1726;    1216;       4
957;T001235;GM0377;2015;    9619;    6653;    2959;    1700;    1259;       7
958;T001235;GM0377;2016;    9653;    6760;    2879;    1673;    1206;      14
959;T001235;GM0377;2017;    9727;    6832;    2871;    1664;    1207;      24
960;T001235;GM0377;2018;    9894;    7002;    2779;    1662;    1117;     113
961;T001235;GM0377;2019;    9992;    7068;    2761;    1793;     968;     163
962;T001235;GM0377;2020;   10034;    7107;    2752;    1789;     963;     175
963;T001235;GM0055;2012;    8376;    5651;    2700;    2268;     432;      25
964;T001235;GM0055;2013;    8455;    5675;    2764;    2307;     457;      16
965;T001235;GM0055;2014;;;;;;
966;T001235;GM0055;2015;;;;;;
967;T001235;GM0055;2016;;;;;;
968;T001235;GM0055;2017;;;;;;
969;T001235;GM0055;2018;;;;;;
970;T001235;GM0055;2019;;;;;;
971;T001235;GM0055;2020;;;;;;
972;T001235;GM1901;2012;   13440;    9483;    3766;    2810;     956;     191
973;T001235;GM1901;2013;   13698;    9540;    4008;    2919;    1089;     150
974;T001235;GM1901;2014;   13715;    9622;    3941;    2899;    1042;     152
975;T001235;GM1901;2015;   13824;    9738;    3923;    2986;     937;     163
976;T001235;GM1901;2016;   14008;    9893;    3943;    2995;     948;     172
977;T001235;GM1901;2017;   14090;    9960;    3964;    3030;     934;     166
978;T001235;GM1901;2018;   14260;   10079;    4016;    3067;     949;     165
979;T001235;GM1901;2019;   14360;   10327;    4009;    2903;    1106;      24
980;T001235;GM1901;2020;   14499;   10416;    4071;    2889;    1182;      12
981;T001235;GM0755;2012;    3670;    2799;     851;     598;     253;      20
982;T001235;GM0755;2013;    3807;    2865;     910;     608;     302;      32
983;T001235;GM0755;2014;    3882;    2890;     904;     608;     296;      88
984;T001235;GM0755;2015;    3890;    2899;     898;     592;     306;      93
985;T001235;GM0755;2016;    3975;    2961;     929;     590;     339;      85
986;T001235;GM0755;2017;    4034;    2987;     966;     608;     358;      81
987;T001235;GM0755;2018;    4082;    3073;     932;     600;     332;      77
988;T001235;GM0755;2019;    4168;    3114;    1052;     673;     379;       2
989;T001235;GM0755;2020;    4248;    3177;    1068;     669;     399;       3
990;T001235;GM0009;2012;    2959;    2338;     619;     512;     107;       2
991;T001235;GM0009;2013;    2964;    2335;     627;     513;     114;       2
992;T001235;GM0009;2014;    3017;    2333;     682;     553;     129;       2
993;T001235;GM0009;2015;    3033;    2330;     701;     567;     134;       2
994;T001235;GM0009;2016;    3017;    2311;     703;     554;     149;       3
995;T001235;GM0009;2017;    3045;    2332;     710;     552;     158;       3
996;T001235;GM0009;2018;    3052;    2338;     712;     552;     160;       2
997;T001235;GM0009;2019;;;;;;
998;T001235;GM0009;2020;;;;;;
999;T001235;GM1681;2012;   11644;    8099;    3518;    2528;     990;      27
1000;T001235;GM1681;2013;   11619;    8103;    3497;    2495;    1002;      19
1001;T001235;GM1681;2014;   11710;    8165;    3527;    2356;    1171;      18
1002;T001235;GM1681;2015;   11734;    8201;    3508;    2352;    1156;      25
1003;T001235;GM1681;2016;   11714;    8251;    3443;    2286;    1157;      20
1004;T001235;GM1681;2017;   11572;    8240;    3303;    2319;     984;      29
1005;T001235;GM1681;2018;   11608;    8358;    3214;    2320;     894;      36
1006;T001235;GM1681;2019;   11645;    8493;    3133;    2314;     819;      19
1007;T001235;GM1681;2020;   11374;    8390;    2969;    2280;     689;      15
1008;T001235;GM0147;2012;    8951;    5898;    3028;    2335;     693;      25
1009;T001235;GM0147;2013;    9078;    5976;    3079;    2299;     780;      23
1010;T001235;GM0147;2014;    9155;    6088;    3058;    2277;     781;       9
1011;T001235;GM0147;2015;    9231;    6159;    3063;    2292;     771;       9
1012;T001235;GM0147;2016;    9316;    6261;    3046;    2271;     775;       9
1013;T001235;GM0147;2017;    9537;    6398;    3113;    2258;     855;      26
1014;T001235;GM0147;2018;    9748;    6622;    3074;    2250;     824;      52
1015;T001235;GM0147;2019;    9817;    6799;    3003;    2245;     758;      15
1016;T001235;GM0147;2020;    9954;    6912;    3026;    2260;     766;      16
1017;T001235;GM0654;2012;    9543;    6825;    2706;    2089;     617;      12
1018;T001235;GM0654;2013;    9641;    6855;    2776;    2111;     665;      10
1019;T001235;GM0654;2014;    9719;    6851;    2789;    2083;     706;      79
1020;T001235;GM0654;2015;    9657;    6914;    2730;    2073;     657;      13
1021;T001235;GM0654;2016;    9687;    6957;    2714;    2062;     652;      16
1022;T001235;GM0654;2017;    9735;    6988;    2728;    2083;     645;      19
1023;T001235;GM0654;2018;    9781;    7113;    2634;    2073;     561;      34
1024;T001235;GM0654;2019;    9785;    7212;    2552;    2053;     499;      21
1025;T001235;GM0654;2020;    9821;    7267;    2527;    2049;     478;      27
1026;T001235;GM0499;2012;    6168;    3815;    2326;    1951;     375;      27
1027;T001235;GM0499;2013;    6276;    3910;    2335;    1953;     382;      31
1028;T001235;GM0499;2014;;;;;;
1029;T001235;GM0499;2015;;;;;;
1030;T001235;GM0499;2016;;;;;;
1031;T001235;GM0499;2017;;;;;;
1032;T001235;GM0499;2018;;;;;;
1033;T001235;GM0499;2019;;;;;;
1034;T001235;GM0499;2020;;;;;;
1035;T001235;GM0756;2012;   11439;    7920;    3467;    2696;     771;      52
1036;T001235;GM0756;2013;   11528;    7967;    3518;    2710;     808;      43
1037;T001235;GM0756;2014;   11774;    8001;    3732;    2854;     878;      41
1038;T001235;GM0756;2015;   11784;    8045;    3697;    2798;     899;      42
1039;T001235;GM0756;2016;   11896;    8144;    3721;    2784;     937;      31
1040;T001235;GM0756;2017;   12044;    8182;    3834;    2849;     985;      28
1041;T001235;GM0756;2018;   12206;    8397;    3771;    2886;     885;      38
1042;T001235;GM0756;2019;   12427;    8529;    3889;    2891;     998;       9
1043;T001235;GM0756;2020;   12568;    8599;    3942;    2895;    1047;      27
1044;T001235;GM0757;2012;   12729;    7783;    4834;    3782;    1052;     112
1045;T001235;GM0757;2013;   12934;    7854;    4985;    3891;    1094;      95
1046;T001235;GM0757;2014;   13192;    7936;    5067;    3921;    1146;     189
1047;T001235;GM0757;2015;   13214;    7949;    5178;    3955;    1223;      87
1048;T001235;GM0757;2016;   13296;    8060;    5153;    3961;    1192;      83
1049;T001235;GM0757;2017;   13308;    8046;    5186;    3975;    1211;      76
1050;T001235;GM0757;2018;   13333;    8114;    5113;    3942;    1171;     106
1051;T001235;GM0757;2019;   13353;    8170;    5149;    3996;    1153;      34
1052;T001235;GM0757;2020;   13401;    8183;    5155;    3915;    1240;      63
1053;T001235;GM0758;2012;   77016;   43446;   33234;   23334;    9900;     336
1054;T001235;GM0758;2013;   78851;   44165;   34394;   23918;   10476;     292
1055;T001235;GM0758;2014;   80716;   44442;   35921;   25260;   10661;     353
1056;T001235;GM0758;2015;   81291;   44667;   36292;   25500;   10792;     332
1057;T001235;GM0758;2016;   81649;   45024;   36176;   25180;   10996;     449
1058;T001235;GM0758;2017;   82231;   44987;   36907;   24814;   12093;     337
1059;T001235;GM0758;2018;   83253;   45950;   37069;   24891;   12178;     234
1060;T001235;GM0758;2019;   83793;   46571;   36762;   24851;   11911;     460
1061;T001235;GM0758;2020;   84567;   46696;   37446;   24710;   12736;     425
1062;T001235;GM0501;2012;    7157;    4515;    2575;    1952;     623;      67
1063;T001235;GM0501;2013;    7478;    4649;    2763;    2129;     634;      66
1064;T001235;GM0501;2014;    7617;    4777;    2802;    2053;     749;      38
1065;T001235;GM0501;2015;    7678;    4882;    2744;    1853;     891;      52
1066;T001235;GM0501;2016;    7683;    4978;    2682;    1894;     788;      23
1067;T001235;GM0501;2017;    7798;    5040;    2728;    1862;     866;      30
1068;T001235;GM0501;2018;    7918;    5187;    2715;    1858;     857;      16
1069;T001235;GM0501;2019;    7963;    5295;    2663;    1858;     805;       5
1070;T001235;GM0501;2020;    8029;    5319;    2706;    1857;     849;       4
1071;T001235;GM1876;2012;   15566;   10773;    4687;    2915;    1772;     106
1072;T001235;GM1876;2013;   15600;   10789;    4729;    2882;    1847;      82
1073;T001235;GM1876;2014;   15997;   10850;    4816;    2609;    2207;     331
1074;T001235;GM1876;2015;   16074;   10909;    4835;    2877;    1958;     330
1075;T001235;GM1876;2016;   16117;   10959;    4824;    2848;    1976;     334
1076;T001235;GM1876;2017;   16063;   10960;    4860;    2859;    2001;     243
1077;T001235;GM1876;2018;   16088;   11310;    4564;    2887;    1677;     214
1078;T001235;GM1876;2019;   16152;   11407;    4700;    3043;    1657;      45
1079;T001235;GM1876;2020;   16198;   11418;    4743;    2998;    1745;      37
1080;T001235;GM0213;2012;    9038;    5280;    3681;    2970;     711;      77
1081;T001235;GM0213;2013;    9079;    5344;    3676;    2947;     729;      59
1082;T001235;GM0213;2014;    9097;    5393;    3656;    2914;     742;      48
1083;T001235;GM0213;2015;    9250;    5452;    3663;    2930;     733;     135
1084;T001235;GM0213;2016;    9260;    5468;    3657;    2909;     748;     135
1085;T001235;GM0213;2017;    9249;    5492;    3623;    2876;     747;     134
1086;T001235;GM0213;2018;    9279;    5679;    3464;    2877;     587;     136
1087;T001235;GM0213;2019;    9310;    5746;    3556;    2982;     574;       8
1088;T001235;GM0213;2020;    9348;    5797;    3544;    2934;     610;       7
1089;T001235;GM0899;2012;   14255;    8652;    5545;    4190;    1355;      58
1090;T001235;GM0899;2013;   14355;    8620;    5713;    4250;    1463;      22
1091;T001235;GM0899;2014;   14555;    8646;    5727;    4263;    1464;     182
1092;T001235;GM0899;2015;   14534;    8643;    5690;    4214;    1476;     201
1093;T001235;GM0899;2016;   14511;    8654;    5650;    4159;    1491;     207
1094;T001235;GM0899;2017;   14464;    8595;    5680;    4062;    1618;     189
1095;T001235;GM0899;2018;   14508;    8708;    5613;    4050;    1563;     187
1096;T001235;GM0899;2019;   14479;    8815;    5621;    4116;    1505;      43
1097;T001235;GM0899;2020;   14493;    8826;    5621;    4106;    1515;      46
1098;T001235;GM0312;2012;    5940;    4394;    1533;     968;     565;      13
1099;T001235;GM0312;2013;    6082;    4471;    1599;     985;     614;      12
1100;T001235;GM0312;2014;    6101;    4510;    1580;     982;     598;      11
1101;T001235;GM0312;2015;    6207;    4549;    1642;     989;     653;      16
1102;T001235;GM0312;2016;    6269;    4619;    1632;     986;     646;      18
1103;T001235;GM0312;2017;    6342;    4649;    1673;     988;     685;      20
1104;T001235;GM0312;2018;    6371;    4707;    1632;     991;     641;      32
1105;T001235;GM0312;2019;    6379;    4803;    1562;     992;     570;      14
1106;T001235;GM0312;2020;    6392;    4799;    1580;     991;     589;      13
1107;T001235;GM0313;2012;    7603;    5899;    1687;    1045;     642;      17
1108;T001235;GM0313;2013;    7719;    5974;    1743;    1056;     687;       2
1109;T001235;GM0313;2014;    7867;    5980;    1784;    1056;     728;     103
1110;T001235;GM0313;2015;    7977;    6074;    1799;    1045;     754;     104
1111;T001235;GM0313;2016;    8087;    5972;    2009;    1080;     929;     106
1112;T001235;GM0313;2017;    8135;    5981;    2046;    1072;     974;     108
1113;T001235;GM0313;2018;    8251;    6088;    2043;    1107;     936;     120
1114;T001235;GM0313;2019;    8414;    6296;    2012;    1157;     855;     106
1115;T001235;GM0313;2020;    8536;    6375;    2055;    1156;     899;     106
1116;T001235;GM0214;2012;   10018;    7346;    2580;    2030;     550;      92
1117;T001235;GM0214;2013;   10041;    7414;    2563;    2015;     548;      64
1118;T001235;GM0214;2014;   10196;    7507;    2633;    2096;     537;      56
1119;T001235;GM0214;2015;   10323;    7546;    2720;    2125;     595;      57
1120;T001235;GM0214;2016;   10386;    7610;    2703;    2123;     580;      73
1121;T001235;GM0214;2017;   10459;    7655;    2732;    2100;     632;      72
1122;T001235;GM0214;2018;   10529;    7772;    2687;    2105;     582;      70
1123;T001235;GM0214;2019;   10604;    7924;    2645;    2117;     528;      35
1124;T001235;GM0214;2020;   10829;    8078;    2716;    2136;     580;      35
1125;T001235;GM0381;2012;   14902;    9151;    5628;    3476;    2152;     123
1126;T001235;GM0381;2013;   15124;    9163;    5846;    3577;    2269;     115
1127;T001235;GM0381;2014;   15580;    9147;    6030;    3412;    2618;     403
1128;T001235;GM0381;2015;   15628;    9268;    5955;    3476;    2479;     405
1129;T001235;GM0381;2016;;;;;;
1130;T001235;GM0381;2017;;;;;;
1131;T001235;GM0381;2018;;;;;;
1132;T001235;GM0381;2019;;;;;;
1133;T001235;GM0381;2020;;;;;;
1134;T001235;GM0502;2012;   30308;   15337;   14952;   12150;    2802;      19
1135;T001235;GM0502;2013;   30440;   15454;   14980;   12084;    2896;       6
1136;T001235;GM0502;2014;   30727;   15543;   15050;   12007;    3043;     134
1137;T001235;GM0502;2015;   30728;   15649;   14945;   11801;    3144;     134
1138;T001235;GM0502;2016;   30727;   15778;   14812;   11609;    3203;     137
1139;T001235;GM0502;2017;   30745;   15804;   14799;   11514;    3285;     142
1140;T001235;GM0502;2018;   30748;   16221;   14448;   11411;    3037;      79
1141;T001235;GM0502;2019;   30853;   16717;   14114;   11340;    2774;      22
1142;T001235;GM0502;2020;   31270;   16809;   14434;   11311;    3123;      27
1143;T001235;GM0383;2012;   14940;   11215;    3605;    2405;    1200;     120
1144;T001235;GM0383;2013;   15129;   11231;    3870;    2450;    1420;      28
1145;T001235;GM0383;2014;   15151;   11237;    3890;    2434;    1456;      24
1146;T001235;GM0383;2015;   15317;   11312;    3950;    2478;    1472;      55
1147;T001235;GM0383;2016;   15459;   11407;    3998;    2467;    1531;      54
1148;T001235;GM0383;2017;   15666;   11588;    4033;    2485;    1548;      45
1149;T001235;GM0383;2018;   15814;   11803;    3959;    2491;    1468;      52
1150;T001235;GM0383;2019;   15973;   11931;    3885;    2572;    1313;     157
1151;T001235;GM0383;2020;   16056;   12058;    3901;    2565;    1336;      97
1152;T001235;GM0109;2012;   16846;   10998;    4969;    3673;    1296;     879
1153;T001235;GM0109;2013;   15237;   10523;    4615;    3685;     930;      99
1154;T001235;GM0109;2014;   15330;   10520;    4645;    3616;    1029;     165
1155;T001235;GM0109;2015;   15388;   10551;    4641;    3626;    1015;     196
1156;T001235;GM0109;2016;   15342;   10561;    4611;    3597;    1014;     170
1157;T001235;GM0109;2017;   15283;   10507;    4601;    3506;    1095;     175
1158;T001235;GM0109;2018;   15478;   10425;    4867;    3575;    1292;     186
1159;T001235;GM0109;2019;   15521;   10751;    4734;    3693;    1041;      36
1160;T001235;GM0109;2020;   15555;   10781;    4737;    3711;    1026;      37
1161;T001235;GM1706;2012;    8567;    6399;    2083;    1546;     537;      85
1162;T001235;GM1706;2013;    8630;    6461;    2100;    1543;     557;      69
1163;T001235;GM1706;2014;    8715;    6478;    2151;    1559;     592;      86
1164;T001235;GM1706;2015;    8756;    6501;    2166;    1540;     626;      89
1165;T001235;GM1706;2016;    8781;    6516;    2174;    1528;     646;      91
1166;T001235;GM1706;2017;    8841;    6536;    2251;    1525;     726;      54
1167;T001235;GM1706;2018;    8887;    6568;    2266;    1521;     745;      53
1168;T001235;GM1706;2019;    8962;    6606;    2350;    1511;     839;       6
1169;T001235;GM1706;2020;    9007;    6627;    2372;    1504;     868;       8
1170;T001235;GM0611;2012;    5560;    3858;    1684;    1339;     345;      18
1171;T001235;GM0611;2013;    5506;    3866;    1628;    1318;     310;      12
1172;T001235;GM0611;2014;    5557;    3894;    1650;    1342;     308;      13
1173;T001235;GM0611;2015;    5627;    3928;    1685;    1357;     328;      14
1174;T001235;GM0611;2016;    5622;    3953;    1659;    1353;     306;      10
1175;T001235;GM0611;2017;    5625;    3906;    1708;    1351;     357;      11
1176;T001235;GM0611;2018;    5635;    3972;    1654;    1345;     309;       9
1177;T001235;GM0611;2019;;;;;;
1178;T001235;GM0611;2020;;;;;;
1179;T001235;GM1684;2012;   10326;    6474;    3728;    3000;     728;     124
1180;T001235;GM1684;2013;   10497;    6574;    3811;    3076;     735;     112
1181;T001235;GM1684;2014;   10476;    6574;    3866;    3056;     810;      36
1182;T001235;GM1684;2015;   10513;    6650;    3824;    3016;     808;      39
1183;T001235;GM1684;2016;   10787;    6777;    3973;    3151;     822;      37
1184;T001235;GM1684;2017;   10727;    6822;    3859;    3013;     846;      46
1185;T001235;GM1684;2018;   10938;    6910;    3979;    3116;     863;      49
1186;T001235;GM1684;2019;   11094;    6964;    4092;    3095;     997;      38
1187;T001235;GM1684;2020;   11193;    7039;    4122;    3046;    1076;      32
1188;T001235;GM0216;2012;   11348;    6893;    4343;    3024;    1319;     112
1189;T001235;GM0216;2013;   11598;    7022;    4425;    3435;     990;     151
1190;T001235;GM0216;2014;   11630;    7079;    4446;    3396;    1050;     105
1191;T001235;GM0216;2015;   11529;    7099;    4344;    3259;    1085;      86
1192;T001235;GM0216;2016;   11862;    7286;    4421;    3438;     983;     155
1193;T001235;GM0216;2017;   12024;    7308;    4557;    3473;    1084;     159
1194;T001235;GM0216;2018;   12177;    7387;    4639;    3416;    1223;     151
1195;T001235;GM0216;2019;   12390;    7820;    4474;    3411;    1063;      96
1196;T001235;GM0216;2020;   12530;    7933;    4504;    3361;    1143;      93
1197;T001235;GM0148;2012;   10869;    8187;    2636;    1822;     814;      46
1198;T001235;GM0148;2013;   11022;    8285;    2698;    1878;     820;      39
1199;T001235;GM0148;2014;   11134;    8347;    2749;    1895;     854;      38
1200;T001235;GM0148;2015;   11238;    8403;    2797;    1905;     892;      38
1201;T001235;GM0148;2016;   11391;    8266;    3085;    1904;    1181;      40
1202;T001235;GM0148;2017;   11444;    8294;    3114;    1906;    1208;      36
1203;T001235;GM0148;2018;   11511;    8415;    3042;    1906;    1136;      54
1204;T001235;GM0148;2019;   11722;    8803;    2895;    1956;     939;      24
1205;T001235;GM0148;2020;   11889;    8856;    3012;    2036;     976;      21
1206;T001235;GM1891;2012;    7858;    4947;    2853;    2593;     260;      58
1207;T001235;GM1891;2013;    7867;    4958;    2855;    2579;     276;      54
1208;T001235;GM1891;2014;    8039;    5002;    2893;    2567;     326;     144
1209;T001235;GM1891;2015;    8046;    5003;    2951;    2600;     351;      92
1210;T001235;GM1891;2016;    8065;    5037;    2892;    2555;     337;     136
1211;T001235;GM1891;2017;    8084;    5020;    2914;    2551;     363;     150
1212;T001235;GM1891;2018;    8144;    5087;    2900;    2546;     354;     157
1213;T001235;GM1891;2019;    8147;    5130;    2989;    2634;     355;      28
1214;T001235;GM1891;2020;    8164;    5130;    3009;    2632;     377;      25
1215;T001235;GM0503;2012;   48035;   17862;   29576;   23034;    6542;     597
1216;T001235;GM0503;2013;   48329;   18142;   29836;   22929;    6907;     351
1217;T001235;GM0503;2014;   48438;   18209;   29849;   22849;    7000;     380
1218;T001235;GM0503;2015;   49199;   18499;   30298;   24329;    5969;     402
1219;T001235;GM0503;2016;   49627;   18666;   30503;   24232;    6271;     458
1220;T001235;GM0503;2017;   49838;   18447;   30995;   24200;    6795;     396
1221;T001235;GM0503;2018;   49855;   18560;   30942;   22666;    8276;     353
1222;T001235;GM0503;2019;   50610;   19199;   31089;   22781;    8308;     322
1223;T001235;GM0503;2020;   50904;   19274;   31296;   22662;    8634;     334
1224;T001235;GM0010;2012;   11982;    7475;    4442;    3432;    1010;      65
1225;T001235;GM0010;2013;   12027;    7473;    4493;    3434;    1059;      61
1226;T001235;GM0010;2014;   12229;    7459;    4749;    3543;    1206;      21
1227;T001235;GM0010;2015;   12232;    7422;    4792;    3530;    1262;      18
1228;T001235;GM0010;2016;   12273;    7593;    4554;    3519;    1035;     126
1229;T001235;GM0010;2017;   12237;    7562;    4551;    3465;    1086;     124
1230;T001235;GM0010;2018;   12241;    7518;    4698;    3508;    1190;      25
1231;T001235;GM0010;2019;   12182;    7506;    4653;    3456;    1197;      23
1232;T001235;GM0010;2020;   12223;    7459;    4743;    3465;    1278;      21
1233;T001235;GM0762;2012;   12829;    8444;    4362;    3293;    1069;      23
1234;T001235;GM0762;2013;   12994;    8541;    4432;    3317;    1115;      21
1235;T001235;GM0762;2014;   13198;    8591;    4439;    3295;    1144;     168
1236;T001235;GM0762;2015;   13344;    8672;    4477;    3322;    1155;     195
1237;T001235;GM0762;2016;   13433;    8757;    4487;    3321;    1166;     189
1238;T001235;GM0762;2017;   13523;    8803;    4538;    3327;    1211;     182
1239;T001235;GM0762;2018;   13644;    8987;    4465;    3376;    1089;     192
1240;T001235;GM0762;2019;   13887;    9185;    4690;    3441;    1249;      12
1241;T001235;GM0762;2020;   13955;    9233;    4710;    3429;    1281;      12
1242;T001235;GM0150;2012;   42268;   23602;   18381;   13680;    4701;     285
1243;T001235;GM0150;2013;   42092;   23595;   18305;   13394;    4911;     192
1244;T001235;GM0150;2014;   42203;   23799;   18227;   13130;    5097;     177
1245;T001235;GM0150;2015;   42858;   23967;   18402;   13067;    5335;     489
1246;T001235;GM0150;2016;   43643;   24300;   19219;   13492;    5727;     124
1247;T001235;GM0150;2017;   44653;   24389;   20099;   13744;    6355;     165
1248;T001235;GM0150;2018;   44707;   24739;   19849;   13622;    6227;     119
1249;T001235;GM0150;2019;   45313;   25328;   19894;   13547;    6347;      91
1250;T001235;GM0150;2020;   45988;   25407;   20361;   13739;    6622;     220
1251;T001235;GM0384;2012;   11843;    4829;    6343;    3189;    3154;     671
1252;T001235;GM0384;2013;   11891;    4853;    6388;    3176;    3212;     650
1253;T001235;GM0384;2014;   12657;    4909;    6939;    3705;    3234;     809
1254;T001235;GM0384;2015;   13132;    5044;    7897;    4295;    3602;     191
1255;T001235;GM0384;2016;   13216;    5115;    7322;    3682;    3640;     779
1256;T001235;GM0384;2017;   12770;    5182;    7364;    3638;    3726;     224
1257;T001235;GM0384;2018;   13136;    5521;    7381;    3603;    3778;     234
1258;T001235;GM0384;2019;   13803;    5972;    7815;    3764;    4051;      16
1259;T001235;GM0384;2020;   15015;    6122;    8869;    3759;    5110;      24
1260;T001235;GM1774;2012;   10105;    7427;    2631;    1407;    1224;      47
1261;T001235;GM1774;2013;   10215;    7522;    2652;    1412;    1240;      41
1262;T001235;GM1774;2014;   10445;    7536;    2658;    1453;    1205;     251
1263;T001235;GM1774;2015;   10461;    7571;    2693;    1484;    1209;     197
1264;T001235;GM1774;2016;   10528;    7581;    2686;    1435;    1251;     261
1265;T001235;GM1774;2017;   10661;    7701;    2697;    1433;    1264;     263
1266;T001235;GM1774;2018;   10774;    7934;    2566;    1432;    1134;     274
1267;T001235;GM1774;2019;   10900;    8061;    2802;    1419;    1383;      37
1268;T001235;GM1774;2020;   10939;    8084;    2817;    1418;    1399;      38
1269;T001235;GM0504;2012;    3345;    2155;    1185;     994;     191;       5
1270;T001235;GM0504;2013;;;;;;
1271;T001235;GM0504;2014;;;;;;
1272;T001235;GM0504;2015;;;;;;
1273;T001235;GM0504;2016;;;;;;
1274;T001235;GM0504;2017;;;;;;
1275;T001235;GM0504;2018;;;;;;
1276;T001235;GM0504;2019;;;;;;
1277;T001235;GM0504;2020;;;;;;
1278;T001235;GM0221;2012;    5207;    2673;    2518;    2191;     327;      16
1279;T001235;GM0221;2013;    5168;    2661;    2489;    2141;     348;      18
1280;T001235;GM0221;2014;    5171;    2664;    2498;    2120;     378;       9
1281;T001235;GM0221;2015;    5167;    2659;    2501;    2041;     460;       7
1282;T001235;GM0221;2016;    5238;    2685;    2544;    2086;     458;       9
1283;T001235;GM0221;2017;    5248;    2693;    2547;    2086;     461;       8
1284;T001235;GM0221;2018;    5279;    2753;    2520;    2116;     404;       6
1285;T001235;GM0221;2019;    5286;    2777;    2505;    2094;     411;       4
1286;T001235;GM0221;2020;    5293;    2789;    2498;    2083;     415;       6
1287;T001235;GM0222;2012;   24288;   14556;    9494;    7495;    1999;     238
1288;T001235;GM0222;2013;   24523;   14684;    9722;    7514;    2208;     117
1289;T001235;GM0222;2014;   24848;   14828;    9926;    7407;    2519;      94
1290;T001235;GM0222;2015;   25039;   14877;   10056;    7511;    2545;     106
1291;T001235;GM0222;2016;   25180;   14975;   10118;    7481;    2637;      87
1292;T001235;GM0222;2017;   25477;   15062;   10303;    7565;    2738;     112
1293;T001235;GM0222;2018;   25628;   14922;   10572;    7575;    2997;     134
1294;T001235;GM0222;2019;   25926;   15486;   10352;    7770;    2582;      88
1295;T001235;GM0222;2020;   26129;   15612;   10486;    7769;    2717;      31
1296;T001235;GM0766;2012;   10520;    7281;    3208;    2488;     720;      31
1297;T001235;GM0766;2013;   10646;    7395;    3230;    2509;     721;      21
1298;T001235;GM0766;2014;   10726;    7443;    3264;    2498;     766;      19
1299;T001235;GM0766;2015;   10780;    7473;    3289;    2512;     777;      18
1300;T001235;GM0766;2016;   10792;    7481;    3294;    2482;     812;      17
1301;T001235;GM0766;2017;   10838;    7493;    3329;    2450;     879;      16
1302;T001235;GM0766;2018;   11075;    7613;    3435;    2537;     898;      27
1303;T001235;GM0766;2019;   11241;    7883;    3351;    2386;     965;       7
1304;T001235;GM0766;2020;   11289;    7984;    3293;    2310;     983;      12
1305;T001235;GM0058;2012;   10558;    6865;    3674;    2961;     713;      19
1306;T001235;GM0058;2013;   10622;    6870;    3735;    2966;     769;      17
1307;T001235;GM0058;2014;   10856;    6867;    3768;    2960;     808;     221
1308;T001235;GM0058;2015;   10888;    6863;    3785;    2940;     845;     240
1309;T001235;GM0058;2016;   10886;    6901;    3774;    2892;     882;     211
1310;T001235;GM0058;2017;   10983;    6891;    3881;    2930;     951;     211
1311;T001235;GM0058;2018;   11024;    6979;    3826;    2917;     909;     219
1312;T001235;GM0058;2019;;;;;;
1313;T001235;GM0058;2020;;;;;;
1314;T001235;GM0505;2012;   53973;   29902;   23711;   17114;    6597;     360
1315;T001235;GM0505;2013;   54565;   30177;   24083;   17376;    6707;     305
1316;T001235;GM0505;2014;   54528;   30335;   23951;   17122;    6829;     242
1317;T001235;GM0505;2015;   54548;   30427;   23855;   17109;    6746;     266
1318;T001235;GM0505;2016;   54853;   30536;   24031;   16978;    7053;     286
1319;T001235;GM0505;2017;   54868;   30558;   24023;   16718;    7305;     287
1320;T001235;GM0505;2018;   55059;   31049;   23719;   16656;    7063;     291
1321;T001235;GM0505;2019;   55008;   31761;   23186;   16331;    6855;      61
1322;T001235;GM0505;2020;   55279;   31933;   23287;   16227;    7060;      59
1323;T001235;GM0498;2012;    7804;    5881;    1913;    1585;     328;      10
1324;T001235;GM0498;2013;    7876;    5898;    1970;    1583;     387;       8
1325;T001235;GM0498;2014;    8018;    5918;    2039;    1616;     423;      61
1326;T001235;GM0498;2015;    8045;    5930;    2045;    1598;     447;      70
1327;T001235;GM0498;2016;    8107;    5978;    2051;    1622;     429;      78
1328;T001235;GM0498;2017;    8154;    6026;    2051;    1623;     428;      77
1329;T001235;GM0498;2018;    8202;    6052;    2066;    1620;     446;      84
1330;T001235;GM0498;2019;    8280;    6133;    2087;    1683;     404;      60
1331;T001235;GM0498;2020;    8373;    6168;    2150;    1719;     431;      55
1332;T001235;GM1719;2012;   11105;    7881;    3141;    2577;     564;      83
1333;T001235;GM1719;2013;   11156;    7887;    3230;    2602;     628;      39
1334;T001235;GM1719;2014;   11364;    7942;    3282;    2648;     634;     140
1335;T001235;GM1719;2015;   11435;    8013;    3287;    2650;     637;     135
1336;T001235;GM1719;2016;   11501;    8070;    3298;    2630;     668;     133
1337;T001235;GM1719;2017;   11601;    8135;    3335;    2642;     693;     131
1338;T001235;GM1719;2018;   11708;    8293;    3232;    2630;     602;     183
1339;T001235;GM1719;2019;   11779;    8380;    3385;    2780;     605;      14
1340;T001235;GM1719;2020;   11761;    8412;    3337;    2709;     628;      12
1341;T001235;GM0303;2012;   17043;   10697;    5701;    4334;    1367;     645
1342;T001235;GM0303;2013;   17192;   10749;    6051;    4357;    1694;     392
1343;T001235;GM0303;2014;   17231;   10748;    6253;    4311;    1942;     230
1344;T001235;GM0303;2015;   17369;   10836;    6363;    4397;    1966;     170
1345;T001235;GM0303;2016;   16495;   10618;    5821;    4373;    1448;      56
1346;T001235;GM0303;2017;   16603;   10565;    5978;    4343;    1635;      60
1347;T001235;GM0303;2018;   16901;   10647;    6186;    4318;    1868;      68
1348;T001235;GM0303;2019;   17140;   11385;    5729;    4490;    1239;      26
1349;T001235;GM0303;2020;   17390;   11585;    5768;    4454;    1314;      37
1350;T001235;GM0225;2012;    7290;    4560;    2664;    2032;     632;      66
1351;T001235;GM0225;2013;    7348;    4631;    2678;    2037;     641;      39
1352;T001235;GM0225;2014;    7495;    4669;    2725;    1985;     740;     101
1353;T001235;GM0225;2015;    7607;    4756;    2780;    2004;     776;      71
1354;T001235;GM0225;2016;    7662;    4847;    2746;    1963;     783;      69
1355;T001235;GM0225;2017;    7807;    4888;    2852;    1978;     874;      67
1356;T001235;GM0225;2018;    7983;    5066;    2755;    1961;     794;     162
1357;T001235;GM0225;2019;    8047;    5194;    2808;    1968;     840;      45
1358;T001235;GM0225;2020;    8126;    5241;    2842;    1959;     883;      43
1359;T001235;GM0226;2012;   10390;    6747;    3630;    2561;    1069;      13
1360;T001235;GM0226;2013;   10513;    6782;    3684;    2609;    1075;      47
1361;T001235;GM0226;2014;   10605;    6794;    3762;    2683;    1079;      49
1362;T001235;GM0226;2015;   10616;    6793;    3772;    2715;    1057;      51
1363;T001235;GM0226;2016;   10635;    6831;    3758;    2711;    1047;      46
1364;T001235;GM0226;2017;   10645;    6817;    3783;    2716;    1067;      45
1365;T001235;GM0226;2018;   10678;    6992;    3638;    2842;     796;      48
1366;T001235;GM0226;2019;   10708;    7140;    3547;    2870;     677;      21
1367;T001235;GM0226;2020;   10743;    7181;    3542;    2869;     673;      20
1368;T001235;GM1711;2012;   14085;    9741;    4240;    2870;    1370;     104
1369;T001235;GM1711;2013;   14147;    9806;    4281;    2848;    1433;      60
1370;T001235;GM1711;2014;   14360;   10085;    4035;    2822;    1213;     240
1371;T001235;GM1711;2015;   14402;   10076;    4077;    2797;    1280;     249
1372;T001235;GM1711;2016;   14450;   10051;    4148;    2749;    1399;     251
1373;T001235;GM1711;2017;   14497;   10058;    4176;    2774;    1402;     263
1374;T001235;GM1711;2018;   14532;   10180;    4083;    2804;    1279;     269
1375;T001235;GM1711;2019;   14540;   10242;    4277;    2817;    1460;      21
1376;T001235;GM1711;2020;   14595;   10285;    4283;    2790;    1493;      27
1377;T001235;GM0385;2012;   11761;    9140;    2447;    1956;     491;     174
1378;T001235;GM0385;2013;   11876;    9227;    2475;    1999;     476;     174
1379;T001235;GM0385;2014;   12161;    9411;    2578;    2077;     501;     172
1380;T001235;GM0385;2015;   12285;    9444;    2669;    2070;     599;     172
1381;T001235;GM0385;2016;   14939;   11508;    3251;    2505;     746;     180
1382;T001235;GM0385;2017;   14819;   11582;    3229;    2484;     745;       8
1383;T001235;GM0385;2018;   14915;   11643;    3262;    2506;     756;      10
1384;T001235;GM0385;2019;   15029;   11685;    3269;    2554;     715;      75
1385;T001235;GM0385;2020;   15120;   11733;    3324;    2551;     773;      63
1386;T001235;GM0228;2012;   46871;   29462;   13690;    9543;    4147;    3719
1387;T001235;GM0228;2013;   47600;   29908;   14904;    9662;    5242;    2788
1388;T001235;GM0228;2014;   47757;   30064;   15172;    9648;    5524;    2521
1389;T001235;GM0228;2015;   48250;   30362;   15360;    9638;    5722;    2528
1390;T001235;GM0228;2016;   48915;   30705;   15702;    9693;    6009;    2508
1391;T001235;GM0228;2017;   49703;   31083;   16226;    9782;    6444;    2394
1392;T001235;GM0228;2018;   48007;   31408;   15776;    9807;    5969;     823
1393;T001235;GM0228;2019;   48552;   31708;   16522;   10356;    6166;     322
1394;T001235;GM0228;2020;   49152;   32304;   16706;   10354;    6352;     142
1395;T001235;GM0317;2012;    3438;    2420;     992;     763;     229;      26
1396;T001235;GM0317;2013;    3591;    2485;    1095;     838;     257;      11
1397;T001235;GM0317;2014;    3590;    2485;    1094;     838;     256;      11
1398;T001235;GM0317;2015;    3619;    2502;    1106;     838;     268;      11
1399;T001235;GM0317;2016;    3665;    2560;    1096;     838;     258;       9
1400;T001235;GM0317;2017;    3687;    2562;    1120;     833;     287;       5
1401;T001235;GM0317;2018;    3812;    2711;    1098;     854;     244;       3
1402;T001235;GM0317;2019;    3910;    2809;    1073;     847;     226;      28
1403;T001235;GM0317;2020;    4008;    2854;    1094;     872;     222;      60
1404;T001235;GM1651;2012;    7407;    4511;    2794;    2308;     486;     102
1405;T001235;GM1651;2013;    7349;    4509;    2819;    2287;     532;      21
1406;T001235;GM1651;2014;    7444;    4512;    2916;    2376;     540;      16
1407;T001235;GM1651;2015;    7464;    4490;    2964;    2386;     578;      10
1408;T001235;GM1651;2016;    7471;    4480;    2985;    2388;     597;       6
1409;T001235;GM1651;2017;    7410;    4473;    2932;    2321;     611;       5
1410;T001235;GM1651;2018;    7410;    4560;    2842;    2290;     552;       8
1411;T001235;GM1651;2019;;;;;;
1412;T001235;GM1651;2020;;;;;;
1413;T001235;GM0770;2012;    7647;    5736;    1816;    1379;     437;      95
1414;T001235;GM0770;2013;    7725;    5726;    1905;    1416;     489;      94
1415;T001235;GM0770;2014;    7856;    5766;    1962;    1459;     503;     128
1416;T001235;GM0770;2015;    7946;    5797;    1975;    1465;     510;     174
1417;T001235;GM0770;2016;    8008;    5847;    1988;    1444;     544;     173
1418;T001235;GM0770;2017;    8035;    5870;    1999;    1431;     568;     166
1419;T001235;GM0770;2018;    8071;    5931;    1979;    1424;     555;     161
1420;T001235;GM0770;2019;    8277;    6106;    2164;    1436;     728;       7
1421;T001235;GM0770;2020;    8402;    6157;    2233;    1453;     780;      12
1422;T001235;GM1903;2012;   10415;    7819;    2547;    1320;    1227;      49
1423;T001235;GM1903;2013;   10486;    7820;    2621;    1305;    1316;      45
1424;T001235;GM1903;2014;   10712;    7911;    2646;    1296;    1350;     155
1425;T001235;GM1903;2015;   10781;    7924;    2748;    1209;    1539;     109
1426;T001235;GM1903;2016;   10888;    8016;    2755;    1219;    1536;     117
1427;T001235;GM1903;2017;   10979;    8078;    2768;    1217;    1551;     133
1428;T001235;GM1903;2018;   11181;    8535;    2480;    1175;    1305;     166
1429;T001235;GM1903;2019;   11208;    8552;    2606;    1187;    1419;      50
1430;T001235;GM1903;2020;   11326;    8665;    2615;    1176;    1439;      46
1431;T001235;GM0772;2012;  101412;   46548;   53306;   40637;   12669;    1558
1432;T001235;GM0772;2013;  101969;   46949;   54027;   40679;   13348;     993
1433;T001235;GM0772;2014;  103507;   47195;   55231;   40921;   14310;    1081
1434;T001235;GM0772;2015;  104287;   47460;   55789;   41300;   14489;    1038
1435;T001235;GM0772;2016;  106732;   47577;   56468;   40782;   15686;    2687
1436;T001235;GM0772;2017;  107812;   48090;   57360;   40827;   16533;    2362
1437;T001235;GM0772;2018;  109468;   49101;   58878;   40062;   18816;    1489
1438;T001235;GM0772;2019;  111295;   49932;   61098;   41833;   19265;     265
1439;T001235;GM0772;2020;  112965;   50238;   62550;   42321;   20229;     177
1440;T001235;GM0230;2012;    8659;    5579;    3020;    2330;     690;      60
1441;T001235;GM0230;2013;    8762;    5636;    3065;    2327;     738;      61
1442;T001235;GM0230;2014;    8983;    5682;    3095;    2326;     769;     206
1443;T001235;GM0230;2015;    9101;    5769;    3120;    2405;     715;     212
1444;T001235;GM0230;2016;    9170;    5868;    3101;    2352;     749;     201
1445;T001235;GM0230;2017;    9186;    5841;    3144;    2352;     792;     201
1446;T001235;GM0230;2018;    9274;    5989;    3081;    2393;     688;     204
1447;T001235;GM0230;2019;    9268;    6018;    3249;    2481;     768;       1
1448;T001235;GM0230;2020;    9356;    6061;    3294;    2481;     813;       1
1449;T001235;GM0114;2012;   51220;   30698;   19432;   14643;    4789;    1090
1450;T001235;GM0114;2013;   48540;   29902;   18009;   13536;    4473;     629
1451;T001235;GM0114;2014;   49264;   30000;   18312;   13621;    4691;     952
1452;T001235;GM0114;2015;   49120;   29929;   18463;   13649;    4814;     728
1453;T001235;GM0114;2016;   49118;   30203;   18275;   13578;    4697;     640
1454;T001235;GM0114;2017;   48789;   30040;   18195;   13620;    4575;     554
1455;T001235;GM0114;2018;   48923;   30082;   18313;   13627;    4686;     528
1456;T001235;GM0114;2019;   49187;   30553;   18579;   14183;    4396;      55
1457;T001235;GM0114;2020;   49308;   30602;   18651;   14182;    4469;      55
1458;T001235;GM0388;2012;    8343;    4946;    3300;    2675;     625;      97
1459;T001235;GM0388;2013;    8399;    4982;    3338;    2646;     692;      79
1460;T001235;GM0388;2014;    8540;    4992;    3399;    2619;     780;     149
1461;T001235;GM0388;2015;    8613;    5038;    3450;    2709;     741;     125
1462;T001235;GM0388;2016;    8642;    5097;    3404;    2605;     799;     141
1463;T001235;GM0388;2017;    8689;    5135;    3411;    2591;     820;     143
1464;T001235;GM0388;2018;    8717;    5266;    3310;    2553;     757;     141
1465;T001235;GM0388;2019;    8754;    5321;    3375;    2678;     697;      58
1466;T001235;GM0388;2020;    8824;    5353;    3411;    2646;     765;      60
1467;T001235;GM0153;2012;   74142;   35454;   36880;   27992;    8888;    1808
1468;T001235;GM0153;2013;   74502;   35481;   37883;   28045;    9838;    1138
1469;T001235;GM0153;2014;   74787;   35381;   38239;   27775;   10464;    1167
1470;T001235;GM0153;2015;   75030;   35488;   38507;   30333;    8174;    1035
1471;T001235;GM0153;2016;   75056;   35590;   38201;   28587;    9614;    1265
1472;T001235;GM0153;2017;   74564;   35143;   38172;   29194;    8978;    1249
1473;T001235;GM0153;2018;   73672;   35734;   36992;   27976;    9016;     946
1474;T001235;GM0153;2019;   74588;   36381;   38081;   28233;    9848;     126
1475;T001235;GM0153;2020;   75222;   36490;   38567;   28177;   10390;     165
1476;T001235;GM0232;2012;   13662;    8654;    4912;    3706;    1206;      96
1477;T001235;GM0232;2013;   13698;    8658;    4957;    3705;    1252;      83
1478;T001235;GM0232;2014;   13802;    8648;    4957;    3640;    1317;     197
1479;T001235;GM0232;2015;   13839;    8680;    5032;    3723;    1309;     127
1480;T001235;GM0232;2016;   14097;    8818;    5115;    3774;    1341;     164
1481;T001235;GM0232;2017;   14177;    8828;    5183;    3807;    1376;     166
1482;T001235;GM0232;2018;   14243;    9043;    5052;    3828;    1224;     148
1483;T001235;GM0232;2019;   14349;    9296;    5038;    3990;    1048;      15
1484;T001235;GM0232;2020;   14586;    9434;    5132;    4043;    1089;      20
1485;T001235;GM0233;2012;   10295;    6260;    3660;    2652;    1008;     375
1486;T001235;GM0233;2013;   10301;    6293;    3862;    2652;    1210;     146
1487;T001235;GM0233;2014;   10620;    6440;    4053;    2646;    1407;     127
1488;T001235;GM0233;2015;   10781;    6516;    4115;    2660;    1455;     150
1489;T001235;GM0233;2016;   10785;    6600;    4053;    2662;    1391;     132
1490;T001235;GM0233;2017;   10861;    6647;    4081;    2694;    1387;     133
1491;T001235;GM0233;2018;   10948;    6765;    4058;    2703;    1355;     125
1492;T001235;GM0233;2019;   11002;    6898;    4078;    2725;    1353;      26
1493;T001235;GM0233;2020;   11156;    6982;    4140;    2754;    1386;      34
1494;T001235;GM0777;2012;   17468;   11198;    6243;    4806;    1437;      27
1495;T001235;GM0777;2013;   18043;   11367;    6631;    5160;    1471;      45
1496;T001235;GM0777;2014;   18152;   11394;    6724;    5037;    1687;      34
1497;T001235;GM0777;2015;   18183;   11486;    6659;    4992;    1667;      38
1498;T001235;GM0777;2016;   18408;   11568;    6788;    5090;    1698;      52
1499;T001235;GM0777;2017;   18513;   11627;    6818;    5082;    1736;      68
1500;T001235;GM0777;2018;   18732;   11727;    6922;    5098;    1824;      83
1501;T001235;GM0777;2019;   18967;   12167;    6791;    5318;    1473;       9
1502;T001235;GM0777;2020;   19093;   12236;    6843;    5336;    1507;      14
1503;T001235;GM1722;2012;    3807;    2622;    1121;     804;     317;      64
1504;T001235;GM1722;2013;    3797;    2646;    1097;     781;     316;      54
1505;T001235;GM1722;2014;    3740;    2636;    1064;     708;     356;      40
1506;T001235;GM1722;2015;    3852;    2646;    1095;     768;     327;     111
1507;T001235;GM1722;2016;    3860;    2643;    1106;     760;     346;     111
1508;T001235;GM1722;2017;    3853;    2636;    1107;     761;     346;     110
1509;T001235;GM1722;2018;    3847;    2691;    1050;     763;     287;     106
1510;T001235;GM1722;2019;;;;;;
1511;T001235;GM1722;2020;;;;;;
1512;T001235;GM0070;2012;    9318;    5950;    3274;    2642;     632;      94
1513;T001235;GM0070;2013;    9269;    5963;    3267;    2614;     653;      39
1514;T001235;GM0070;2014;    9510;    5977;    3426;    2479;     947;     107
1515;T001235;GM0070;2015;    9488;    5977;    3401;    2577;     824;     110
1516;T001235;GM0070;2016;    9501;    5970;    3417;    2558;     859;     114
1517;T001235;GM0070;2017;    9497;    5991;    3439;    2563;     876;      67
1518;T001235;GM0070;2018;;;;;;
1519;T001235;GM0070;2019;;;;;;
1520;T001235;GM0070;2020;;;;;;
1521;T001235;GM1921;2012;;;;;;
1522;T001235;GM1921;2013;;;;;;
1523;T001235;GM1921;2014;   22691;   15211;    7294;    5544;    1750;     186
1524;T001235;GM1921;2015;   22724;   15284;    7317;    5652;    1665;     123
1525;T001235;GM1921;2016;;;;;;
1526;T001235;GM1921;2017;;;;;;
1527;T001235;GM1921;2018;;;;;;
1528;T001235;GM1921;2019;;;;;;
1529;T001235;GM1921;2020;;;;;;
1530;T001235;GM1940;2012;;;;;;
1531;T001235;GM1940;2013;;;;;;
1532;T001235;GM1940;2014;;;;;;
1533;T001235;GM1940;2015;;;;;;
1534;T001235;GM1940;2016;   22818;   15340;    7310;    5599;    1711;     168
1535;T001235;GM1940;2017;   22887;   15393;    7307;    5515;    1792;     187
1536;T001235;GM1940;2018;   23086;   15709;    7186;    5536;    1650;     191
1537;T001235;GM1940;2019;   23209;   16022;    7133;    5593;    1540;      54
1538;T001235;GM1940;2020;   23347;   16139;    7135;    5562;    1573;      73
1539;T001235;GM0653;2012;    4791;    3324;    1454;    1028;     426;      13
1540;T001235;GM0653;2013;    4493;    3144;    1338;    1027;     311;      11
1541;T001235;GM0653;2014;;;;;;
1542;T001235;GM0653;2015;;;;;;
1543;T001235;GM0653;2016;;;;;;
1544;T001235;GM0653;2017;;;;;;
1545;T001235;GM0653;2018;;;;;;
1546;T001235;GM0653;2019;;;;;;
1547;T001235;GM0653;2020;;;;;;
1548;T001235;GM0779;2012;    9376;    5789;    3541;    3116;     425;      46
1549;T001235;GM0779;2013;    9395;    5810;    3558;    3110;     448;      27
1550;T001235;GM0779;2014;    9542;    5881;    3583;    3160;     423;      78
1551;T001235;GM0779;2015;    9560;    5915;    3625;    3112;     513;      20
1552;T001235;GM0779;2016;    9553;    5949;    3582;    3030;     552;      22
1553;T001235;GM0779;2017;    9594;    5954;    3616;    3020;     596;      24
1554;T001235;GM0779;2018;    9614;    5930;    3657;    3008;     649;      27
1555;T001235;GM0779;2019;    9638;    6045;    3588;    2991;     597;       5
1556;T001235;GM0779;2020;    9639;    6040;    3594;    3006;     588;       5
1557;T001235;GM0236;2012;   10371;    7145;    3111;    2199;     912;     115
1558;T001235;GM0236;2013;   10369;    7183;    3096;    2167;     929;      90
1559;T001235;GM0236;2014;   10504;    7287;    3095;    2139;     956;     122
1560;T001235;GM0236;2015;   10561;    7356;    3059;    2132;     927;     146
1561;T001235;GM0236;2016;   10630;    7561;    2949;    2156;     793;     120
1562;T001235;GM0236;2017;   10808;    7590;    3077;    2133;     944;     141
1563;T001235;GM0236;2018;   10940;    7657;    3178;    2183;     995;     105
1564;T001235;GM0236;2019;;;;;;
1565;T001235;GM0236;2020;;;;;;
1566;T001235;GM1771;2012;   17105;   10973;    6035;    4781;    1254;      97
1567;T001235;GM1771;2013;   17157;   11010;    6053;    4764;    1289;      94
1568;T001235;GM1771;2014;   17217;   11030;    6052;    4737;    1315;     135
1569;T001235;GM1771;2015;   17269;   11085;    6091;    4719;    1372;      93
1570;T001235;GM1771;2016;   17305;   11148;    6142;    4787;    1355;      15
1571;T001235;GM1771;2017;   17354;   11104;    6233;    4767;    1466;      17
1572;T001235;GM1771;2018;   17429;   11331;    6077;    4736;    1341;      21
1573;T001235;GM1771;2019;   17640;   11633;    5995;    4725;    1270;      12
1574;T001235;GM1771;2020;   17746;   11683;    6048;    4720;    1328;      15
1575;T001235;GM1652;2012;   11772;    7942;    3672;    2651;    1021;     158
1576;T001235;GM1652;2013;   12042;    8080;    3884;    2745;    1139;      78
1577;T001235;GM1652;2014;   12224;    8177;    3979;    2694;    1285;      68
1578;T001235;GM1652;2015;   12334;    8233;    4020;    2627;    1393;      81
1579;T001235;GM1652;2016;   12451;    8236;    4131;    2639;    1492;      84
1580;T001235;GM1652;2017;   12597;    8280;    4238;    2683;    1555;      79
1581;T001235;GM1652;2018;   12683;    8519;    4073;    2700;    1373;      91
1582;T001235;GM1652;2019;   12754;    8611;    4123;    2693;    1430;      20
1583;T001235;GM1652;2020;   12635;    8566;    4049;    2757;    1292;      20
1584;T001235;GM0907;2012;    7088;    4593;    2446;    1756;     690;      49
1585;T001235;GM0907;2013;    7199;    4653;    2504;    1814;     690;      42
1586;T001235;GM0907;2014;    7236;    4650;    2547;    1798;     749;      39
1587;T001235;GM0907;2015;    7324;    4710;    2579;    1718;     861;      35
1588;T001235;GM0907;2016;    7277;    4716;    2487;    1700;     787;      74
1589;T001235;GM0907;2017;    7361;    4740;    2565;    1747;     818;      56
1590;T001235;GM0907;2018;    7387;    4847;    2510;    1752;     758;      30
1591;T001235;GM0907;2019;    7408;    4938;    2446;    1780;     666;      24
1592;T001235;GM0907;2020;    7450;    4929;    2509;    1806;     703;      12
1593;T001235;GM0689;2012;    5737;    4258;    1474;    1188;     286;       5
1594;T001235;GM0689;2013;    5726;    4228;    1494;    1195;     299;       4
1595;T001235;GM0689;2014;    5714;    4241;    1468;    1161;     307;       5
1596;T001235;GM0689;2015;    5826;    4289;    1532;    1217;     315;       5
1597;T001235;GM0689;2016;    5883;    4341;    1537;    1213;     324;       5
1598;T001235;GM0689;2017;    5909;    4354;    1547;    1206;     341;       8
1599;T001235;GM0689;2018;    5926;    4417;    1497;    1196;     301;      12
1600;T001235;GM0689;2019;;;;;;
1601;T001235;GM0689;2020;;;;;;
1602;T001235;GM0784;2012;   10237;    6437;    3592;    2958;     634;     208
1603;T001235;GM0784;2013;   10757;    6769;    3859;    3177;     682;     129
1604;T001235;GM0784;2014;   11067;    6822;    4112;    3343;     769;     133
1605;T001235;GM0784;2015;   11076;    6852;    4095;    3326;     769;     129
1606;T001235;GM0784;2016;   11138;    6899;    4109;    3300;     809;     130
1607;T001235;GM0784;2017;   11149;    6960;    4110;    3294;     816;      79
1608;T001235;GM0784;2018;   11199;    7134;    4007;    3310;     697;      58
1609;T001235;GM0784;2019;   11270;    7226;    4029;    3368;     661;      15
1610;T001235;GM0784;2020;   11301;    7235;    4050;    3360;     690;      16
1611;T001235;GM0511;2012;    4788;    3154;    1503;    1177;     326;     131
1612;T001235;GM0511;2013;;;;;;
1613;T001235;GM0511;2014;;;;;;
1614;T001235;GM0511;2015;;;;;;
1615;T001235;GM0511;2016;;;;;;
1616;T001235;GM0511;2017;;;;;;
1617;T001235;GM0511;2018;;;;;;
1618;T001235;GM0511;2019;;;;;;
1619;T001235;GM0511;2020;;;;;;
1620;T001235;GM1924;2012;;;;;;
1621;T001235;GM1924;2013;   20182;   12369;    7643;    6349;    1294;     170
1622;T001235;GM1924;2014;   20574;   12663;    7799;    6427;    1372;     112
1623;T001235;GM1924;2015;   20845;   12802;    7924;    6447;    1477;     119
1624;T001235;GM1924;2016;   20915;   12968;    7830;    6415;    1415;     117
1625;T001235;GM1924;2017;   21089;   13029;    7933;    6409;    1524;     127
1626;T001235;GM1924;2018;   21374;   13422;    7796;    6408;    1388;     156
1627;T001235;GM1924;2019;   21597;   13774;    7790;    6440;    1350;      33
1628;T001235;GM1924;2020;   21855;   14001;    7805;    6426;    1379;      49
1629;T001235;GM0664;2012;   17321;   10053;    7096;    5199;    1897;     172
1630;T001235;GM0664;2013;   17410;   10181;    7080;    5293;    1787;     149
1631;T001235;GM0664;2014;   17548;   10127;    7280;    5305;    1975;     141
1632;T001235;GM0664;2015;   17684;   10231;    7230;    5381;    1849;     223
1633;T001235;GM0664;2016;   17748;   10280;    7238;    5381;    1857;     230
1634;T001235;GM0664;2017;   17939;   10353;    7311;    5331;    1980;     275
1635;T001235;GM0664;2018;   18062;   10592;    7128;    5264;    1864;     342
1636;T001235;GM0664;2019;   18251;   10892;    7205;    5279;    1926;     154
1637;T001235;GM0664;2020;   18553;   11033;    7285;    5300;    1985;     235
1638;T001235;GM0785;2012;    9703;    6411;    2949;    2501;     448;     343
1639;T001235;GM0785;2013;    9792;    6730;    3016;    2514;     502;      46
1640;T001235;GM0785;2014;    9843;    6767;    3030;    2506;     524;      46
1641;T001235;GM0785;2015;    9859;    6800;    3045;    2522;     523;      14
1642;T001235;GM0785;2016;    9906;    6857;    2989;    2476;     513;      60
1643;T001235;GM0785;2017;    9961;    6887;    3026;    2454;     572;      48
1644;T001235;GM0785;2018;   10164;    7132;    2980;    2479;     501;      52
1645;T001235;GM0785;2019;   10291;    7292;    2987;    2547;     440;      12
1646;T001235;GM0785;2020;   10363;    7332;    3022;    2534;     488;       9
1647;T001235;GM1942;2012;;;;;;
1648;T001235;GM1942;2013;;;;;;
1649;T001235;GM1942;2014;;;;;;
1650;T001235;GM1942;2015;;;;;;
1651;T001235;GM1942;2016;   26133;   16230;    9364;    5875;    3489;     539
1652;T001235;GM1942;2017;   26249;   16345;    9387;    5822;    3565;     517
1653;T001235;GM1942;2018;   26342;   16498;    9268;    5792;    3476;     576
1654;T001235;GM1942;2019;   26508;   16868;    9518;    5953;    3565;     122
1655;T001235;GM1942;2020;   26679;   16946;    9684;    5977;    3707;      49
1656;T001235;GM0512;2012;   15569;    7180;    8176;    7126;    1050;     213
1657;T001235;GM0512;2013;   15622;    7210;    8211;    7117;    1094;     201
1658;T001235;GM0512;2014;   16019;    7351;    8508;    7073;    1435;     160
1659;T001235;GM0512;2015;   15980;    7417;    8460;    7056;    1404;     103
1660;T001235;GM0512;2016;   16092;    7523;    8450;    6966;    1484;     119
1661;T001235;GM0512;2017;   16300;    7703;    8481;    6923;    1558;     116
1662;T001235;GM0512;2018;   16392;    7882;    8397;    6856;    1541;     113
1663;T001235;GM0512;2019;   16599;    8111;    8445;    6816;    1629;      43
1664;T001235;GM0512;2020;   17210;    8367;    8821;    6663;    2158;      22
1665;T001235;GM0513;2012;   30704;   16879;   13744;   10074;    3670;      81
1666;T001235;GM0513;2013;   31067;   17019;   14007;   10298;    3709;      41
1667;T001235;GM0513;2014;   31542;   17073;   14256;   10241;    4015;     213
1668;T001235;GM0513;2015;   31694;   17344;   14161;   10279;    3882;     189
1669;T001235;GM0513;2016;   31868;   17505;   14095;    9991;    4104;     268
1670;T001235;GM0513;2017;   32131;   17551;   14287;   10062;    4225;     293
1671;T001235;GM0513;2018;   32758;   17757;   14700;   10121;    4579;     301
1672;T001235;GM0513;2019;   33174;   18391;   14715;   10106;    4609;      68
1673;T001235;GM0513;2020;   33439;   18511;   14861;   10068;    4793;      67
1674;T001235;GM0693;2012;    3519;    2418;    1067;     803;     264;      34
1675;T001235;GM0693;2013;;;;;;
1676;T001235;GM0693;2014;;;;;;
1677;T001235;GM0693;2015;;;;;;
1678;T001235;GM0693;2016;;;;;;
1679;T001235;GM0693;2017;;;;;;
1680;T001235;GM0693;2018;;;;;;
1681;T001235;GM0693;2019;;;;;;
1682;T001235;GM0693;2020;;;;;;
1683;T001235;GM0365;2012;    2572;    1947;     616;     434;     182;       9
1684;T001235;GM0365;2013;    2585;    1964;     614;     435;     179;       7
1685;T001235;GM0365;2014;    2591;    1966;     620;     434;     186;       5
1686;T001235;GM0365;2015;;;;;;
1687;T001235;GM0365;2016;;;;;;
1688;T001235;GM0365;2017;;;;;;
1689;T001235;GM0365;2018;;;;;;
1690;T001235;GM0365;2019;;;;;;
1691;T001235;GM0365;2020;;;;;;
1692;T001235;GM0786;2012;    5083;    3446;    1605;    1076;     529;      32
1693;T001235;GM0786;2013;    5089;    3457;    1609;    1070;     539;      23
1694;T001235;GM0786;2014;    5142;    3505;    1613;    1055;     558;      24
1695;T001235;GM0786;2015;    5294;    3527;    1740;    1175;     565;      27
1696;T001235;GM0786;2016;    5304;    3543;    1729;    1172;     557;      32
1697;T001235;GM0786;2017;    5305;    3560;    1718;    1167;     551;      27
1698;T001235;GM0786;2018;    5419;    3649;    1665;    1160;     505;     105
1699;T001235;GM0786;2019;    5446;    3707;    1626;    1162;     464;     113
1700;T001235;GM0786;2020;    5465;    3714;    1666;    1156;     510;      85
1701;T001235;GM0518;2012;  241376;  106212;  131428;   80377;   51051;    3736
1702;T001235;GM0518;2013;  244880;  106626;  133795;   80704;   53091;    4459
1703;T001235;GM0518;2014;  249994;  106614;  137147;   80922;   56225;    6233
1704;T001235;GM0518;2015;  251374;  106703;  138680;   81313;   57367;    5991
1705;T001235;GM0518;2016;  253210;  106908;  140044;   79804;   60240;    6258
1706;T001235;GM0518;2017;  255103;  108103;  142423;   79593;   62830;    4577
1707;T001235;GM0518;2018;  256694;  107931;  143870;   79198;   64672;    4893
1708;T001235;GM0518;2019;  259264;  110274;  146959;   81036;   65923;    2031
1709;T001235;GM0518;2020;  262492;  110235;  149733;   81872;   67861;    2524
1710;T001235;GM0241;2012;    7655;    4599;    3040;    2239;     801;      16
1711;T001235;GM0241;2013;    8160;    4746;    3404;    2599;     805;      10
1712;T001235;GM0241;2014;    8118;    4732;    3364;    2567;     797;      22
1713;T001235;GM0241;2015;   15093;    9114;    5900;    4621;    1279;      79
1714;T001235;GM0241;2016;;;;;;
1715;T001235;GM0241;2017;;;;;;
1716;T001235;GM0241;2018;;;;;;
1717;T001235;GM0241;2019;;;;;;
1718;T001235;GM0241;2020;;;;;;
1719;T001235;GM0014;2012;   93324;   36600;   54504;   35535;   18969;    2220
1720;T001235;GM0014;2013;   95291;   36820;   56787;   36253;   20534;    1684
1721;T001235;GM0014;2014;   97031;   36988;   58425;   36765;   21660;    1618
1722;T001235;GM0014;2015;   97905;   37127;   59982;   39402;   20580;     796
1723;T001235;GM0014;2016;   99250;   37418;   60970;   38943;   22027;     862
1724;T001235;GM0014;2017;  101169;   38009;   62418;   38807;   23611;     742
1725;T001235;GM0014;2018;  100946;   38402;   61486;   37152;   24334;    1058
1726;T001235;GM0014;2019;  114733;   47806;   66538;   39166;   27372;     389
1727;T001235;GM0014;2020;  116445;   47919;   67651;   38821;   28830;     875
1728;T001235;GM0015;2012;    4699;    3492;    1181;     937;     244;      26
1729;T001235;GM0015;2013;    4825;    3532;    1286;     993;     293;       7
1730;T001235;GM0015;2014;    4857;    3537;    1288;     984;     304;      32
1731;T001235;GM0015;2015;    4938;    3554;    1285;     978;     307;      99
1732;T001235;GM0015;2016;    4946;    3577;    1270;     967;     303;      99
1733;T001235;GM0015;2017;    4982;    3573;    1303;     962;     341;     106
1734;T001235;GM0015;2018;    5007;    3697;    1210;     957;     253;     100
1735;T001235;GM0015;2019;;;;;;
1736;T001235;GM0015;2020;;;;;;
1737;T001235;GM1729;2012;    6362;    4262;    1928;    1169;     759;     172
1738;T001235;GM1729;2013;    6636;    4445;    2103;    1231;     872;      88
1739;T001235;GM1729;2014;    6818;    4459;    2153;    1253;     900;     206
1740;T001235;GM1729;2015;    6840;    4349;    2278;    1247;    1031;     213
1741;T001235;GM1729;2016;    6789;    4320;    2247;    1258;     989;     222
1742;T001235;GM1729;2017;    6791;    4345;    2241;    1256;     985;     205
1743;T001235;GM1729;2018;    6784;    4451;    2126;    1255;     871;     207
1744;T001235;GM1729;2019;    6821;    4550;    2245;    1267;     978;      26
1745;T001235;GM1729;2020;    6867;    4570;    2275;    1289;     986;      22
1746;T001235;GM0158;2012;    9790;    6654;    2969;    2259;     710;     167
1747;T001235;GM0158;2013;    9904;    6753;    3020;    2253;     767;     131
1748;T001235;GM0158;2014;   10072;    6769;    3056;    2227;     829;     247
1749;T001235;GM0158;2015;   10134;    6788;    3131;    2267;     864;     215
1750;T001235;GM0158;2016;   10162;    6805;    3116;    2230;     886;     241
1751;T001235;GM0158;2017;   10195;    6816;    3140;    2223;     917;     239
1752;T001235;GM0158;2018;   10315;    7042;    3016;    2210;     806;     257
1753;T001235;GM0158;2019;   10410;    7132;    3264;    2312;     952;      14
1754;T001235;GM0158;2020;   10497;    7205;    3280;    2327;     953;      12
1755;T001235;GM0788;2012;    5121;    3937;    1095;     768;     327;      89
1756;T001235;GM0788;2013;    5263;    4000;    1180;     780;     400;      83
1757;T001235;GM0788;2014;    5315;    3984;    1222;     760;     462;     109
1758;T001235;GM0788;2015;    5317;    3993;    1218;     770;     448;     106
1759;T001235;GM0788;2016;    5429;    4019;    1239;     763;     476;     171
1760;T001235;GM0788;2017;    5525;    4095;    1290;     773;     517;     140
1761;T001235;GM0788;2018;    5805;    4218;    1379;     902;     477;     208
1762;T001235;GM0788;2019;    5904;    4273;    1627;     984;     643;       4
1763;T001235;GM0788;2020;    5957;    4308;    1603;     943;     660;      46
1764;T001235;GM0392;2012;   71173;   37347;   32742;   23205;    9537;    1084
1765;T001235;GM0392;2013;   71725;   37746;   33320;   23349;    9971;     659
1766;T001235;GM0392;2014;   72356;   38067;   33698;   22941;   10757;     591
1767;T001235;GM0392;2015;   73230;   38480;   34329;   23242;   11087;     421
1768;T001235;GM0392;2016;   73674;   38758;   34464;   22951;   11513;     452
1769;T001235;GM0392;2017;   74037;   38933;   34613;   22881;   11732;     491
1770;T001235;GM0392;2018;   74796;   39709;   34644;   22726;   11918;     443
1771;T001235;GM0392;2019;   75633;   40433;   35057;   23019;   12038;     143
1772;T001235;GM0392;2020;   76436;   40497;   35798;   22959;   12839;     141
1773;T001235;GM0393;2012;    2200;    1448;     738;     496;     242;      14
1774;T001235;GM0393;2013;    2247;    1500;     738;     495;     243;       9
1775;T001235;GM0393;2014;    2264;    1512;     742;     505;     237;      10
1776;T001235;GM0393;2015;    2276;    1532;     734;     503;     231;      10
1777;T001235;GM0393;2016;    2281;    1553;     719;     499;     220;       9
1778;T001235;GM0393;2017;    2312;    1590;     714;     499;     215;       8
1779;T001235;GM0393;2018;    2357;    1635;     713;     499;     214;       9
1780;T001235;GM0393;2019;;;;;;
1781;T001235;GM0393;2020;;;;;;
1782;T001235;GM0394;2012;   58757;   38056;   20369;   14070;    6299;     332
1783;T001235;GM0394;2013;   58925;   38377;   20408;   13790;    6618;     140
1784;T001235;GM0394;2014;   59214;   38558;   20459;   13459;    7000;     197
1785;T001235;GM0394;2015;   59292;   38654;   20376;   13816;    6560;     262
1786;T001235;GM0394;2016;   59699;   39027;   20274;   13680;    6594;     398
1787;T001235;GM0394;2017;   60085;   39332;   20448;   13627;    6821;     305
1788;T001235;GM0394;2018;   60622;   40345;   19961;   13800;    6161;     316
1789;T001235;GM0394;2019;   63511;   42814;   20639;   14434;    6205;      58
1790;T001235;GM0394;2020;   64195;   43148;   20983;   14539;    6444;      64
1791;T001235;GM1655;2012;   12664;    7930;    4616;    4014;     602;     118
1792;T001235;GM1655;2013;   13034;    8208;    4753;    4053;     700;      73
1793;T001235;GM1655;2014;   12933;    8128;    4735;    4081;     654;      70
1794;T001235;GM1655;2015;   12991;    8210;    4737;    3951;     786;      44
1795;T001235;GM1655;2016;   13027;    8213;    4776;    4033;     743;      38
1796;T001235;GM1655;2017;   13060;    8205;    4824;    3962;     862;      31
1797;T001235;GM1655;2018;   13093;    8163;    4892;    3963;     929;      38
1798;T001235;GM1655;2019;   13310;    8609;    4689;    4029;     660;      12
1799;T001235;GM1655;2020;   13399;    8678;    4710;    4019;     691;      11
1800;T001235;GM0160;2012;   23260;   15866;    7165;    4961;    2204;     229
1801;T001235;GM0160;2013;   23396;   15955;    7222;    4953;    2269;     219
1802;T001235;GM0160;2014;   23554;   16033;    7288;    4994;    2294;     233
1803;T001235;GM0160;2015;   23662;   16051;    7403;    5118;    2285;     208
1804;T001235;GM0160;2016;   23864;   16187;    7410;    5010;    2400;     267
1805;T001235;GM0160;2017;   24113;   16287;    7549;    5016;    2533;     277
1806;T001235;GM0160;2018;   24316;   16896;    7149;    5091;    2058;     271
1807;T001235;GM0160;2019;   24513;   17190;    6979;    5162;    1817;     344
1808;T001235;GM0160;2020;   24810;   17389;    7221;    5275;    1946;     200
1809;T001235;GM0243;2012;   18433;   10660;    7437;    5645;    1792;     336
1810;T001235;GM0243;2013;   18517;   10790;    7446;    5651;    1795;     281
1811;T001235;GM0243;2014;   18562;   10800;    7498;    5536;    1962;     264
1812;T001235;GM0243;2015;   18712;   10807;    7579;    5698;    1881;     326
1813;T001235;GM0243;2016;   18873;   10999;    7648;    5735;    1913;     226
1814;T001235;GM0243;2017;   19185;   11123;    7751;    5740;    2011;     311
1815;T001235;GM0243;2018;   19289;   11161;    7800;    5739;    2061;     328
1816;T001235;GM0243;2019;   19450;   11516;    7779;    5803;    1976;     155
1817;T001235;GM0243;2020;   19942;   11788;    8019;    5877;    2142;     135
1818;T001235;GM0523;2012;    7012;    4312;    2605;    2150;     455;      95
1819;T001235;GM0523;2013;    7047;    4336;    2624;    2150;     474;      87
1820;T001235;GM0523;2014;    7058;    4353;    2621;    2128;     493;      84
1821;T001235;GM0523;2015;    7074;    4403;    2590;    2103;     487;      81
1822;T001235;GM0523;2016;    7131;    4482;    2567;    2084;     483;      82
1823;T001235;GM0523;2017;    7212;    4537;    2593;    2085;     508;      82
1824;T001235;GM0523;2018;    7248;    4618;    2534;    2065;     469;      96
1825;T001235;GM0523;2019;    7313;    4749;    2525;    2081;     444;      39
1826;T001235;GM0523;2020;    7451;    4860;    2565;    2101;     464;      26
1827;T001235;GM0017;2012;    8497;    5785;    2665;    1296;    1369;      47
1828;T001235;GM0017;2013;    8531;    5800;    2707;    1290;    1417;      24
1829;T001235;GM0017;2014;    8628;    5851;    2758;    1305;    1453;      19
1830;T001235;GM0017;2015;    8615;    5921;    2685;    1274;    1411;       9
1831;T001235;GM0017;2016;    8612;    5952;    2648;    1238;    1410;      12
1832;T001235;GM0017;2017;    8738;    6042;    2681;    1182;    1499;      15
1833;T001235;GM0017;2018;    8925;    6382;    2523;    1201;    1322;      20
1834;T001235;GM0017;2019;;;;;;
1835;T001235;GM0017;2020;;;;;;
1836;T001235;GM0395;2012;    6246;    4617;    1597;    1227;     370;      32
1837;T001235;GM0395;2013;;;;;;
1838;T001235;GM0395;2014;;;;;;
1839;T001235;GM0395;2015;;;;;;
1840;T001235;GM0395;2016;;;;;;
1841;T001235;GM0395;2017;;;;;;
1842;T001235;GM0395;2018;;;;;;
1843;T001235;GM0395;2019;;;;;;
1844;T001235;GM0395;2020;;;;;;
1845;T001235;GM0072;2012;    7371;    4058;    3262;    2464;     798;      51
1846;T001235;GM0072;2013;    7390;    4097;    3248;    2451;     797;      45
1847;T001235;GM0072;2014;    7425;    4095;    3295;    2473;     822;      35
1848;T001235;GM0072;2015;    7477;    4100;    3357;    2504;     853;      20
1849;T001235;GM0072;2016;    7533;    4133;    3368;    2515;     853;      32
1850;T001235;GM0072;2017;    7561;    4131;    3395;    2510;     885;      35
1851;T001235;GM0072;2018;    7621;    4229;    3362;    2505;     857;      30
1852;T001235;GM0072;2019;    7627;    4302;    3321;    2463;     858;       4
1853;T001235;GM0072;2020;    7798;    4316;    3478;    2570;     908;       4
1854;T001235;GM0244;2012;    5035;    3122;    1708;    1348;     360;     205
1855;T001235;GM0244;2013;    5128;    3202;    1804;    1358;     446;     122
1856;T001235;GM0244;2014;    5052;    3230;    1759;    1308;     451;      63
1857;T001235;GM0244;2015;    5160;    3251;    1790;    1356;     434;     119
1858;T001235;GM0244;2016;    5240;    3271;    1849;    1373;     476;     120
1859;T001235;GM0244;2017;    5270;    3320;    1866;    1384;     482;      84
1860;T001235;GM0244;2018;    5284;    3404;    1793;    1380;     413;      87
1861;T001235;GM0244;2019;    5277;    3485;    1767;    1399;     368;      25
1862;T001235;GM0244;2020;    5298;    3511;    1764;    1388;     376;      23
1863;T001235;GM0396;2012;   17035;    9689;    7297;    5769;    1528;      49
1864;T001235;GM0396;2013;   17012;    9719;    7245;    5698;    1547;      48
1865;T001235;GM0396;2014;   17273;    9785;    7385;    5631;    1754;     103
1866;T001235;GM0396;2015;   17361;    9909;    7401;    5627;    1774;      51
1867;T001235;GM0396;2016;   17457;    9964;    7433;    5655;    1778;      60
1868;T001235;GM0396;2017;   17513;    9992;    7461;    5657;    1804;      60
1869;T001235;GM0396;2018;   17439;   10263;    7116;    5543;    1573;      60
1870;T001235;GM0396;2019;   17501;   10437;    7046;    5780;    1266;      18
1871;T001235;GM0396;2020;   17578;   10495;    7061;    5676;    1385;      22
1872;T001235;GM0397;2012;   11751;    7602;    3978;    2497;    1481;     171
1873;T001235;GM0397;2013;   11813;    7622;    4081;    2509;    1572;     110
1874;T001235;GM0397;2014;   12247;    7727;    4323;    2592;    1731;     197
1875;T001235;GM0397;2015;   12321;    7786;    4351;    2585;    1766;     184
1876;T001235;GM0397;2016;   12520;    7916;    4352;    2575;    1777;     252
1877;T001235;GM0397;2017;   12511;    7925;    4342;    2551;    1791;     244
1878;T001235;GM0397;2018;   12561;    8102;    4190;    2551;    1639;     269
1879;T001235;GM0397;2019;   12587;    8176;    4325;    2725;    1600;      86
1880;T001235;GM0397;2020;   12628;    8209;    4332;    2679;    1653;      87
1881;T001235;GM0246;2012;    7402;    5133;    2194;    1733;     461;      75
1882;T001235;GM0246;2013;    7580;    5268;    2273;    1767;     506;      39
1883;T001235;GM0246;2014;    7756;    5283;    2278;    1773;     505;     195
1884;T001235;GM0246;2015;    7782;    5298;    2294;    1809;     485;     190
1885;T001235;GM0246;2016;    7803;    5326;    2289;    1792;     497;     188
1886;T001235;GM0246;2017;    7810;    5334;    2301;    1788;     513;     175
1887;T001235;GM0246;2018;    7815;    5356;    2289;    1792;     497;     170
1888;T001235;GM0246;2019;    7888;    5430;    2371;    1917;     454;      87
1889;T001235;GM0246;2020;    7924;    5463;    2432;    1882;     550;      29
1890;T001235;GM0074;2012;   19712;   11293;    8233;    6219;    2014;     186
1891;T001235;GM0074;2013;   19709;   11438;    8170;    6089;    2081;     101
1892;T001235;GM0074;2014;   22974;   13429;    9272;    6804;    2468;     273
1893;T001235;GM0074;2015;   23134;   13530;    9274;    6908;    2366;     330
1894;T001235;GM0074;2016;   23230;   13579;    9383;    6804;    2579;     268
1895;T001235;GM0074;2017;   23250;   13648;    9343;    6745;    2598;     259
1896;T001235;GM0074;2018;   23367;   13721;    9368;    6641;    2727;     278
1897;T001235;GM0074;2019;   23532;   13996;    9374;    6749;    2625;     162
1898;T001235;GM0074;2020;   23528;   14106;    9291;    6785;    2506;     131
1899;T001235;GM0398;2012;   21273;   14872;    6361;    4700;    1661;      40
1900;T001235;GM0398;2013;   21493;   15021;    6449;    4761;    1688;      23
1901;T001235;GM0398;2014;   21959;   15193;    6676;    4877;    1799;      90
1902;T001235;GM0398;2015;   22216;   15254;    6873;    4946;    1927;      89
1903;T001235;GM0398;2016;   22311;   15358;    6864;    4867;    1997;      89
1904;T001235;GM0398;2017;   22743;   15544;    7110;    4930;    2180;      89
1905;T001235;GM0398;2018;   23216;   15977;    7068;    4951;    2117;     171
1906;T001235;GM0398;2019;   23411;   16326;    7073;    5153;    1920;      12
1907;T001235;GM0398;2020;   23913;   16618;    7282;    5160;    2122;      13
1908;T001235;GM0917;2012;   45243;   21315;   23748;   17331;    6417;     180
1909;T001235;GM0917;2013;   45326;   21221;   23976;   17294;    6682;     129
1910;T001235;GM0917;2014;   45373;   21149;   24086;   17287;    6799;     138
1911;T001235;GM0917;2015;   45169;   21078;   23916;   16992;    6924;     175
1912;T001235;GM0917;2016;   45227;   21015;   24048;   16877;    7171;     164
1913;T001235;GM0917;2017;   45619;   20975;   24069;   16738;    7331;     575
1914;T001235;GM0917;2018;   45758;   21176;   24000;   16703;    7297;     582
1915;T001235;GM0917;2019;   45834;   21527;   24185;   16752;    7433;     122
1916;T001235;GM0917;2020;   45976;   21542;   24323;   16797;    7526;     111
1917;T001235;GM1658;2012;    6341;    4762;    1538;     974;     564;      41
1918;T001235;GM1658;2013;    6424;    4813;    1575;     987;     588;      36
1919;T001235;GM1658;2014;    6518;    4859;    1582;     974;     608;      77
1920;T001235;GM1658;2015;    6558;    4896;    1610;     979;     631;      52
1921;T001235;GM1658;2016;    6628;    4953;    1573;     946;     627;     102
1922;T001235;GM1658;2017;    6655;    4937;    1617;     942;     675;     101
1923;T001235;GM1658;2018;    6772;    5179;    1506;     983;     523;      87
1924;T001235;GM1658;2019;    6817;    5257;    1506;    1009;     497;      54
1925;T001235;GM1658;2020;    6861;    5286;    1520;    1004;     516;      55
1926;T001235;GM0399;2012;    9862;    7234;    2513;    1753;     760;     115
1927;T001235;GM0399;2013;    9905;    7258;    2553;    1712;     841;      94
1928;T001235;GM0399;2014;   10075;    7244;    2709;    1780;     929;     122
1929;T001235;GM0399;2015;   10207;    7211;    2873;    1781;    1092;     123
1930;T001235;GM0399;2016;   10233;    7231;    2881;    1832;    1049;     121
1931;T001235;GM0399;2017;   10366;    7290;    2932;    1869;    1063;     144
1932;T001235;GM0399;2018;   10528;    7516;    2842;    1864;     978;     170
1933;T001235;GM0399;2019;   10574;    7718;    2842;    1869;     973;      14
1934;T001235;GM0399;2020;   10775;    7821;    2939;    1906;    1033;      15
1935;T001235;GM0400;2012;   26990;   14304;   12480;   10676;    1804;     206
1936;T001235;GM0400;2013;   27138;   14361;   12612;   10706;    1906;     165
1937;T001235;GM0400;2014;   27689;   14423;   12806;   10673;    2133;     460
1938;T001235;GM0400;2015;   27869;   14591;   12900;   10682;    2218;     378
1939;T001235;GM0400;2016;   27939;   14644;   13024;   10757;    2267;     271
1940;T001235;GM0400;2017;   27986;   14651;   13009;   10666;    2343;     326
1941;T001235;GM0400;2018;   27988;   14853;   12821;    8549;    4272;     314
1942;T001235;GM0400;2019;   28056;   15138;   12904;   10533;    2371;      14
1943;T001235;GM0400;2020;   28213;   15285;   12898;   10515;    2383;      30
1944;T001235;GM0163;2012;   14319;   10088;    4194;    3147;    1047;      37
1945;T001235;GM0163;2013;   14359;   10102;    4230;    3149;    1081;      27
1946;T001235;GM0163;2014;   14371;   10114;    4235;    3133;    1102;      22
1947;T001235;GM0163;2015;   14414;   10190;    4189;    3134;    1055;      35
1948;T001235;GM0163;2016;   14526;   10223;    4269;    3080;    1189;      34
1949;T001235;GM0163;2017;   14593;   10263;    4283;    3080;    1203;      47
1950;T001235;GM0163;2018;   14645;   10552;    4037;    3140;     897;      56
1951;T001235;GM0163;2019;   14734;   10672;    4016;    3146;     870;      46
1952;T001235;GM0163;2020;   14889;   10765;    4076;    3175;     901;      48
1953;T001235;GM0530;2012;   17131;   10867;    6190;    5239;     951;      74
1954;T001235;GM0530;2013;   17241;   10966;    6206;    5248;     958;      69
1955;T001235;GM0530;2014;   17249;   10979;    6250;    5288;     962;      20
1956;T001235;GM0530;2015;   17298;   11051;    6223;    5270;     953;      24
1957;T001235;GM0530;2016;   17305;   11158;    6131;    5256;     875;      16
1958;T001235;GM0530;2017;   17377;   11226;    6132;    5239;     893;      19
1959;T001235;GM0530;2018;   17925;   11646;    6258;    5354;     904;      21
1960;T001235;GM0530;2019;   17907;   11792;    6101;    5311;     790;      14
1961;T001235;GM0530;2020;   17967;   11835;    6120;    5316;     804;      12
1962;T001235;GM0794;2012;   38363;   20443;   17770;   14745;    3025;     150
1963;T001235;GM0794;2013;   38662;   20521;   18001;   14799;    3202;     140
1964;T001235;GM0794;2014;   39072;   20594;   18346;   15293;    3053;     132
1965;T001235;GM0794;2015;   39162;   20688;   18438;   14863;    3575;      36
1966;T001235;GM0794;2016;   39407;   20808;   18569;   14830;    3739;      30
1967;T001235;GM0794;2017;   39533;   20855;   18645;   14823;    3822;      33
1968;T001235;GM0794;2018;   39798;   21281;   18457;   14957;    3500;      60
1969;T001235;GM0794;2019;   40319;   21729;   18568;   15117;    3451;      22
1970;T001235;GM0794;2020;   40788;   21972;   18704;   15230;    3474;     112
1971;T001235;GM0531;2012;   11585;    7616;    3616;    2819;     797;     353
1972;T001235;GM0531;2013;   11392;    7643;    3634;    2816;     818;     115
1973;T001235;GM0531;2014;   11533;    7785;    3690;    2829;     861;      58
1974;T001235;GM0531;2015;   11640;    7964;    3618;    2815;     803;      58
1975;T001235;GM0531;2016;   11725;    8067;    3597;    2797;     800;      61
1976;T001235;GM0531;2017;   11842;    8162;    3618;    2819;     799;      62
1977;T001235;GM0531;2018;   12141;    8484;    3599;    2821;     778;      58
1978;T001235;GM0531;2019;   12214;    8675;    3526;    2843;     683;      13
1979;T001235;GM0531;2020;   12314;    8781;    3523;    2852;     671;      10
1980;T001235;GM0164;2012;   37131;   20159;   16748;   13055;    3693;     224
1981;T001235;GM0164;2013;   37284;   20317;   16859;   13175;    3684;     108
1982;T001235;GM0164;2014;   37625;   20388;   16689;   12887;    3802;     548
1983;T001235;GM0164;2015;   37718;   20543;   16655;   12802;    3853;     520
1984;T001235;GM0164;2016;   37888;   20674;   16684;   12656;    4028;     530
1985;T001235;GM0164;2017;   37908;   20655;   16741;   12554;    4187;     512
1986;T001235;GM0164;2018;   38169;   21195;   16452;   12425;    4027;     522
1987;T001235;GM0164;2019;   38373;   21623;   16729;   12229;    4500;      21
1988;T001235;GM0164;2020;   38701;   21813;   16779;   12202;    4577;     109
1989;T001235;GM0796;2012;   63223;   32591;   30383;   23402;    6981;     249
1990;T001235;GM0796;2013;   64413;   33193;   30889;   24147;    6742;     331
1991;T001235;GM0796;2014;   65174;   33497;   31190;   23721;    7469;     487
1992;T001235;GM0796;2015;   68962;   35750;   32240;   24428;    7812;     972
1993;T001235;GM0796;2016;   69726;   36141;   32363;   24186;    8177;    1222
1994;T001235;GM0796;2017;   70255;   36473;   32841;   23900;    8941;     941
1995;T001235;GM0796;2018;   71196;   36836;   33409;   24063;    9346;     951
1996;T001235;GM0796;2019;   72003;   37820;   33952;   24307;    9645;     231
1997;T001235;GM0796;2020;   72991;   38268;   34441;   24469;    9972;     282
1998;T001235;GM0252;2012;    6700;    4813;    1878;    1290;     588;       9
1999;T001235;GM0252;2013;    6713;    4841;    1860;    1263;     597;      12
2000;T001235;GM0252;2014;    6729;    4843;    1878;    1255;     623;       8
2001;T001235;GM0252;2015;    6945;    4893;    1944;    1318;     626;     108
2002;T001235;GM0252;2016;    6991;    4901;    1980;    1323;     657;     110
2003;T001235;GM0252;2017;    7064;    4913;    2043;    1331;     712;     108
2004;T001235;GM0252;2018;    7123;    5028;    1980;    1348;     632;     115
2005;T001235;GM0252;2019;    7160;    5107;    1928;    1349;     579;     125
2006;T001235;GM0252;2020;    7206;    5129;    1945;    1350;     595;     132
2007;T001235;GM0797;2012;   17748;   11969;    5676;    4669;    1007;     103
2008;T001235;GM0797;2013;   17874;   11996;    5804;    4753;    1051;      74
2009;T001235;GM0797;2014;   18050;   11989;    5847;    4763;    1084;     214
2010;T001235;GM0797;2015;   18199;   12049;    5997;    4862;    1135;     153
2011;T001235;GM0797;2016;   18281;   12138;    5932;    4804;    1128;     211
2012;T001235;GM0797;2017;   18352;   12196;    5943;    4802;    1141;     213
2013;T001235;GM0797;2018;   18523;   12370;    5928;    4806;    1122;     225
2014;T001235;GM0797;2019;   18759;   12693;    6050;    4866;    1184;      16
2015;T001235;GM0797;2020;   19193;   12969;    6214;    4984;    1230;      10
2016;T001235;GM0534;2012;    8978;    5780;    3175;    2190;     985;      23
2017;T001235;GM0534;2013;    9163;    5830;    3324;    2267;    1057;       9
2018;T001235;GM0534;2014;    9297;    5888;    3324;    2266;    1058;      85
2019;T001235;GM0534;2015;    9399;    5935;    3442;    2260;    1182;      22
2020;T001235;GM0534;2016;    9398;    5944;    3426;    2456;     970;      28
2021;T001235;GM0534;2017;    9419;    6000;    3391;    2406;     985;      28
2022;T001235;GM0534;2018;    9681;    6277;    3391;    2454;     937;      13
2023;T001235;GM0534;2019;    9766;    6476;    3285;    2505;     780;       5
2024;T001235;GM0534;2020;    9849;    6562;    3282;    2455;     827;       5
2025;T001235;GM0798;2012;    6115;    4580;    1385;     904;     481;     150
2026;T001235;GM0798;2013;    6176;    4677;    1413;     842;     571;      86
2027;T001235;GM0798;2014;    6289;    4703;    1508;     901;     607;      78
2028;T001235;GM0798;2015;    6297;    4708;    1514;     902;     612;      75
2029;T001235;GM0798;2016;    6476;    4731;    1565;     903;     662;     180
2030;T001235;GM0798;2017;    6493;    4731;    1616;     933;     683;     146
2031;T001235;GM0798;2018;    6522;    4910;    1470;     926;     544;     142
2032;T001235;GM0798;2019;    6591;    4999;    1580;     935;     645;      12
2033;T001235;GM0798;2020;    6724;    5100;    1612;     930;     682;      12
2034;T001235;GM0402;2012;   38937;   21053;   17808;   12753;    5055;      76
2035;T001235;GM0402;2013;   39673;   21437;   18119;   12735;    5384;     117
2036;T001235;GM0402;2014;   40667;   21501;   18432;   12515;    5917;     734
2037;T001235;GM0402;2015;   40861;   21585;   18525;   12536;    5989;     751
2038;T001235;GM0402;2016;   41123;   21826;   18675;   12494;    6181;     622
2039;T001235;GM0402;2017;   41638;   22132;   18795;   12387;    6408;     711
2040;T001235;GM0402;2018;   41942;   22192;   19085;   12334;    6751;     665
2041;T001235;GM0402;2019;   42324;   22937;   19311;   12773;    6538;      76
2042;T001235;GM0402;2020;   42676;   23023;   19575;   12851;    6724;      78
2043;T001235;GM1963;2012;;;;;;
2044;T001235;GM1963;2013;;;;;;
2045;T001235;GM1963;2014;;;;;;
2046;T001235;GM1963;2015;;;;;;
2047;T001235;GM1963;2016;;;;;;
2048;T001235;GM1963;2017;;;;;;
2049;T001235;GM1963;2018;;;;;;
2050;T001235;GM1963;2019;   37542;   26338;   11154;    9512;    1642;      50
2051;T001235;GM1963;2020;   37821;   26560;   11189;    9439;    1750;      72
2052;T001235;GM1735;2012;   14642;    9512;    4961;    3324;    1637;     169
2053;T001235;GM1735;2013;   14655;    9594;    4903;    3219;    1684;     158
2054;T001235;GM1735;2014;   14790;    9694;    4934;    3187;    1747;     162
2055;T001235;GM1735;2015;   14903;    9825;    4907;    3124;    1783;     171
2056;T001235;GM1735;2016;   14868;    9841;    4856;    3032;    1824;     171
2057;T001235;GM1735;2017;   14969;    9890;    4902;    3058;    1844;     177
2058;T001235;GM1735;2018;   15054;   10187;    4686;    3059;    1627;     181
2059;T001235;GM1735;2019;   15122;   10270;    4837;    3056;    1781;      15
2060;T001235;GM1735;2020;   15211;   10333;    4861;    3048;    1813;      17
2061;T001235;GM1966;2012;;;;;;
2062;T001235;GM1966;2013;;;;;;
2063;T001235;GM1966;2014;;;;;;
2064;T001235;GM1966;2015;;;;;;
2065;T001235;GM1966;2016;;;;;;
2066;T001235;GM1966;2017;;;;;;
2067;T001235;GM1966;2018;;;;;;
2068;T001235;GM1966;2019;   22631;   15197;    7343;    5609;    1734;      91
2069;T001235;GM1966;2020;   22743;   15242;    7449;    5522;    1927;      52
2070;T001235;GM1911;2012;   20011;   13681;    6263;    5003;    1260;      67
2071;T001235;GM1911;2013;   20184;   13782;    6337;    5034;    1303;      65
2072;T001235;GM1911;2014;   20445;   13857;    6399;    4996;    1403;     189
2073;T001235;GM1911;2015;   20543;   13951;    6402;    4962;    1440;     190
2074;T001235;GM1911;2016;   20554;   13965;    6410;    4866;    1544;     179
2075;T001235;GM1911;2017;   20616;   14062;    6379;    4824;    1555;     175
2076;T001235;GM1911;2018;   20689;   14274;    6238;    4789;    1449;     177
2077;T001235;GM1911;2019;   20786;   14567;    6084;    4821;    1263;     135
2078;T001235;GM1911;2020;   20882;   14606;    6130;    4805;    1325;     146
2079;T001235;GM0118;2012;   23279;   14632;    8627;    7358;    1269;      20
2080;T001235;GM0118;2013;   23398;   14716;    8644;    7283;    1361;      38
2081;T001235;GM0118;2014;   24275;   14955;    9196;    7401;    1795;     124
2082;T001235;GM0118;2015;   24443;   14973;    9329;    7219;    2110;     141
2083;T001235;GM0118;2016;   24504;   15042;    9291;    7167;    2124;     171
2084;T001235;GM0118;2017;   24684;   15019;    9512;    7169;    2343;     153
2085;T001235;GM0118;2018;   24867;   15169;    9536;    7288;    2248;     162
2086;T001235;GM0118;2019;   25147;   15427;    9627;    7702;    1925;      93
2087;T001235;GM0118;2020;   25236;   15503;    9533;    7195;    2338;     200
2088;T001235;GM0018;2012;   16379;    9111;    7166;    5586;    1580;     102
2089;T001235;GM0018;2013;   15814;    8922;    6839;    5567;    1272;      53
2090;T001235;GM0018;2014;   15769;    8905;    6832;    5173;    1659;      32
2091;T001235;GM0018;2015;   15908;    8848;    6936;    5209;    1727;     124
2092;T001235;GM0018;2016;   15971;    8885;    6938;    5458;    1480;     148
2093;T001235;GM0018;2017;   16016;    8900;    6988;    5501;    1487;     128
2094;T001235;GM0018;2018;;;;;;
2095;T001235;GM0018;2019;;;;;;
2096;T001235;GM0018;2020;;;;;;
2097;T001235;GM0405;2012;   30947;   18372;   12524;   10497;    2027;      51
2098;T001235;GM0405;2013;   31354;   18608;   12644;   10509;    2135;     102
2099;T001235;GM0405;2014;   31943;   18681;   13093;   10114;    2979;     169
2100;T001235;GM0405;2015;   32226;   18858;   13121;   10125;    2996;     247
2101;T001235;GM0405;2016;   32423;   19153;   13112;   10053;    3059;     158
2102;T001235;GM0405;2017;   32640;   19279;   13163;   10074;    3089;     198
2103;T001235;GM0405;2018;   32783;   19633;   12986;   10047;    2939;     164
2104;T001235;GM0405;2019;   32744;   20013;   12704;    9854;    2850;      27
2105;T001235;GM0405;2020;   33086;   20174;   12878;    9874;    3004;      34
2106;T001235;GM1507;2012;   16594;   12840;    3700;    2621;    1079;      54
2107;T001235;GM1507;2013;   16797;   12952;    3806;    2633;    1173;      39
2108;T001235;GM1507;2014;   17116;   12985;    3952;    2690;    1262;     179
2109;T001235;GM1507;2015;   17256;   13092;    4004;    2744;    1260;     160
2110;T001235;GM1507;2016;   17431;   13218;    4051;    2778;    1273;     162
2111;T001235;GM1507;2017;   17480;   13238;    4145;    2768;    1377;      97
2112;T001235;GM1507;2018;   17610;   13304;    4201;    2542;    1659;     105
2113;T001235;GM1507;2019;   17672;   13432;    4164;    2730;    1434;      76
2114;T001235;GM1507;2020;   17839;   13551;    4227;    2736;    1491;      61
2115;T001235;GM0321;2012;   18971;   12664;    6154;    5159;     995;     153
2116;T001235;GM0321;2013;   19155;   12723;    6397;    5173;    1224;      35
2117;T001235;GM0321;2014;   19365;   12906;    6426;    4851;    1575;      33
2118;T001235;GM0321;2015;   19441;   12988;    6414;    5060;    1354;      39
2119;T001235;GM0321;2016;   19542;   13080;    6389;    4883;    1506;      73
2120;T001235;GM0321;2017;   19808;   13159;    6591;    4904;    1687;      58
2121;T001235;GM0321;2018;   20032;   13197;    6749;    4999;    1750;      86
2122;T001235;GM0321;2019;   20271;   13777;    6478;    5080;    1398;      16
2123;T001235;GM0321;2020;   20417;   13835;    6567;    5083;    1484;      15
2124;T001235;GM0406;2012;   18242;   10313;    7924;    6306;    1618;       5
2125;T001235;GM0406;2013;   18316;   10436;    7877;    6232;    1645;       3
2126;T001235;GM0406;2014;   18434;   10564;    7787;    6142;    1645;      83
2127;T001235;GM0406;2015;   18547;   10665;    7796;    6134;    1662;      86
2128;T001235;GM0406;2016;   18592;   10767;    7740;    6047;    1693;      85
2129;T001235;GM0406;2017;   18718;   10675;    7949;    6090;    1859;      94
2130;T001235;GM0406;2018;   18834;   10852;    7866;    6099;    1767;     116
2131;T001235;GM0406;2019;   18874;   11054;    7771;    6144;    1627;      49
2132;T001235;GM0406;2020;   18924;   11042;    7814;    6176;    1638;      68
2133;T001235;GM0677;2012;   13091;    9165;    3811;    2545;    1266;     115
2134;T001235;GM0677;2013;   13046;    9416;    3534;    2521;    1013;      96
2135;T001235;GM0677;2014;   13103;    9303;    3697;    2508;    1189;     103
2136;T001235;GM0677;2015;   13190;    9431;    3636;    2524;    1112;     123
2137;T001235;GM0677;2016;   13272;    9491;    3671;    2540;    1131;     110
2138;T001235;GM0677;2017;   13323;    9509;    3701;    2543;    1158;     113
2139;T001235;GM0677;2018;   13384;    9700;    3572;    2563;    1009;     112
2140;T001235;GM0677;2019;   13520;    9849;    3430;    2573;     857;     241
2141;T001235;GM0677;2020;   13587;    9868;    3444;    2568;     876;     275
2142;T001235;GM0353;2012;   13726;    8681;    5008;    3509;    1499;      37
2143;T001235;GM0353;2013;   13857;    8740;    5096;    3561;    1535;      21
2144;T001235;GM0353;2014;   13968;    8781;    5126;    3539;    1587;      61
2145;T001235;GM0353;2015;   14006;    8852;    5031;    3460;    1571;     123
2146;T001235;GM0353;2016;   14169;    9019;    5034;    3499;    1535;     116
2147;T001235;GM0353;2017;   14319;    8964;    5246;    3586;    1660;     109
2148;T001235;GM0353;2018;   14344;    8923;    5314;    3547;    1767;     107
2149;T001235;GM0353;2019;   14377;    9251;    5122;    3516;    1606;       4
2150;T001235;GM0353;2020;   14407;    9253;    5147;    3505;    1642;       7
2151;T001235;GM1884;2012;   10520;    6740;    3721;    3037;     684;      59
2152;T001235;GM1884;2013;   10651;    6830;    3785;    3014;     771;      36
2153;T001235;GM1884;2014;   10764;    6816;    3817;    3005;     812;     131
2154;T001235;GM1884;2015;   10835;    6861;    3834;    3024;     810;     140
2155;T001235;GM1884;2016;   11056;    7011;    3901;    3067;     834;     144
2156;T001235;GM1884;2017;   11204;    7123;    3940;    3062;     878;     141
2157;T001235;GM1884;2018;   11294;    7276;    3875;    3060;     815;     143
2158;T001235;GM1884;2019;   11486;    7497;    3953;    3170;     783;      36
2159;T001235;GM1884;2020;   11726;    7692;    3995;    3191;     804;      39
2160;T001235;GM0166;2012;   20845;   12594;    8081;    5626;    2455;     170
2161;T001235;GM0166;2013;   20887;   12794;    7951;    5646;    2305;     142
2162;T001235;GM0166;2014;   21069;   12935;    7955;    5582;    2373;     179
2163;T001235;GM0166;2015;   21149;   13075;    7890;    5527;    2363;     184
2164;T001235;GM0166;2016;   21343;   13179;    8025;    5580;    2445;     139
2165;T001235;GM0166;2017;   21535;   13362;    8055;    5554;    2501;     118
2166;T001235;GM0166;2018;   21843;   13754;    7943;    5656;    2287;     146
2167;T001235;GM0166;2019;   22097;   14049;    8014;    5730;    2284;      34
2168;T001235;GM0166;2020;   22517;   14304;    8183;    5777;    2406;      30
2169;T001235;GM0678;2012;    5005;    3795;    1207;     764;     443;       3
2170;T001235;GM0678;2013;    5055;    3834;    1219;     775;     444;       2
2171;T001235;GM0678;2014;    5171;    3879;    1252;     771;     481;      40
2172;T001235;GM0678;2015;    5195;    3890;    1261;     779;     482;      44
2173;T001235;GM0678;2016;    5223;    3922;    1258;     785;     473;      43
2174;T001235;GM0678;2017;    5275;    3900;    1331;     786;     545;      44
2175;T001235;GM0678;2018;    5317;    3986;    1287;     792;     495;      44
2176;T001235;GM0678;2019;    5350;    4068;    1261;     797;     464;      21
2177;T001235;GM0678;2020;    5403;    4107;    1262;     781;     481;      34
2178;T001235;GM0537;2012;   24307;   15608;    8627;    7399;    1228;      72
2179;T001235;GM0537;2013;   24614;   15507;    9018;    7455;    1563;      89
2180;T001235;GM0537;2014;   25022;   15680;    9241;    7366;    1875;     101
2181;T001235;GM0537;2015;   25491;   16234;    9152;    7443;    1709;     105
2182;T001235;GM0537;2016;   25814;   16495;    9175;    7391;    1784;     144
2183;T001235;GM0537;2017;   26265;   16835;    9239;    7400;    1839;     191
2184;T001235;GM0537;2018;   26329;   16945;    9188;    7329;    1859;     196
2185;T001235;GM0537;2019;   26724;   17291;    9390;    7484;    1906;      43
2186;T001235;GM0537;2020;   26869;   17405;    9421;    7415;    2006;      43
2187;T001235;GM0928;2012;   21338;   12121;    9119;    6403;    2716;      98
2188;T001235;GM0928;2013;   21387;   12031;    9282;    6439;    2843;      74
2189;T001235;GM0928;2014;   22468;   12180;    9901;    6817;    3084;     387
2190;T001235;GM0928;2015;   24014;   12124;   11503;    7928;    3575;     387
2191;T001235;GM0928;2016;   23967;   12106;   11477;    7875;    3602;     384
2192;T001235;GM0928;2017;   23883;   12139;   11339;    7763;    3576;     405
2193;T001235;GM0928;2018;   23904;   12364;   11131;    7706;    3425;     409
2194;T001235;GM0928;2019;   23679;   12603;   10836;    7440;    3396;     240
2195;T001235;GM0928;2020;   23771;   12584;   10989;    7600;    3389;     198
2196;T001235;GM1598;2012;    8847;    6887;    1916;     637;    1279;      44
2197;T001235;GM1598;2013;    8963;    6968;    1955;     634;    1321;      40
2198;T001235;GM1598;2014;    9128;    6978;    2059;     670;    1389;      91
2199;T001235;GM1598;2015;    9148;    6994;    2085;     690;    1395;      69
2200;T001235;GM1598;2016;    9220;    7023;    2106;     664;    1442;      91
2201;T001235;GM1598;2017;    9237;    6992;    2154;     650;    1504;      91
2202;T001235;GM1598;2018;    9291;    7009;    2181;     660;    1521;     101
2203;T001235;GM1598;2019;    9395;    7343;    2046;     671;    1375;       6
2204;T001235;GM1598;2020;    9473;    7409;    2037;     524;    1513;      27
2205;T001235;GM0079;2012;    5413;    3701;    1701;    1264;     437;      11
2206;T001235;GM0079;2013;    5442;    3729;    1704;    1261;     443;       9
2207;T001235;GM0079;2014;    5461;    3717;    1735;    1258;     477;       9
2208;T001235;GM0079;2015;    5452;    3718;    1724;    1242;     482;      10
2209;T001235;GM0079;2016;    5426;    3732;    1681;    1295;     386;      13
2210;T001235;GM0079;2017;    5489;    3719;    1727;    1311;     416;      43
2211;T001235;GM0079;2018;    5524;    3829;    1654;    1324;     330;      41
2212;T001235;GM0079;2019;;;;;;
2213;T001235;GM0079;2020;;;;;;
2214;T001235;GM0588;2012;    4355;    3166;    1169;     964;     205;      20
2215;T001235;GM0588;2013;    4382;    3181;    1195;     986;     209;       6
2216;T001235;GM0588;2014;    4372;    3188;    1181;     971;     210;       3
2217;T001235;GM0588;2015;    4395;    3214;    1178;     965;     213;       3
2218;T001235;GM0588;2016;    4457;    3258;    1194;     950;     244;       5
2219;T001235;GM0588;2017;    4571;    3304;    1264;     960;     304;       3
2220;T001235;GM0588;2018;    4595;    3344;    1245;     953;     292;       6
2221;T001235;GM0588;2019;;;;;;
2222;T001235;GM0588;2020;;;;;;
2223;T001235;GM0542;2012;   12109;    7042;    5047;    4561;     486;      20
2224;T001235;GM0542;2013;   12461;    7166;    5273;    4773;     500;      22
2225;T001235;GM0542;2014;   12329;    7193;    5017;    4506;     511;     119
2226;T001235;GM0542;2015;   12322;    7215;    4992;    4494;     498;     115
2227;T001235;GM0542;2016;   12318;    7254;    4956;    4476;     480;     108
2228;T001235;GM0542;2017;   12333;    7282;    4943;    4467;     476;     108
2229;T001235;GM0542;2018;   12451;    7326;    5015;    4566;     449;     110
2230;T001235;GM0542;2019;   12527;    7448;    5076;    4506;     570;       3
2231;T001235;GM0542;2020;   12636;    7477;    5156;    4572;     584;       3
2232;T001235;GM1931;2012;;;;;;
2233;T001235;GM1931;2013;;;;;;
2234;T001235;GM1931;2014;;;;;;
2235;T001235;GM1931;2015;   23265;   14607;    8489;    6579;    1910;     169
2236;T001235;GM1931;2016;   23331;   14830;    8423;    6594;    1829;      78
2237;T001235;GM1931;2017;   23541;   15080;    8376;    6544;    1832;      85
2238;T001235;GM1931;2018;   23569;   15355;    8132;    6396;    1736;      82
2239;T001235;GM1931;2019;   23787;   15658;    8103;    6444;    1659;      26
2240;T001235;GM1931;2020;   23933;   15767;    8128;    6433;    1695;      38
2241;T001235;GM1659;2012;    8755;    6021;    2675;    2056;     619;      59
2242;T001235;GM1659;2013;    9125;    6112;    2990;    2284;     706;      23
2243;T001235;GM1659;2014;    9138;    6101;    3007;    2274;     733;      30
2244;T001235;GM1659;2015;    9227;    6182;    2993;    2269;     724;      52
2245;T001235;GM1659;2016;    9237;    6216;    2969;    2229;     740;      52
2246;T001235;GM1659;2017;    9231;    6206;    2976;    2233;     743;      49
2247;T001235;GM1659;2018;    9318;    6434;    2839;    2263;     576;      45
2248;T001235;GM1659;2019;    9446;    6582;    2857;    2268;     589;       7
2249;T001235;GM1659;2020;    9531;    6612;    2911;    2287;     624;       8
2250;T001235;GM1685;2012;    5698;    4125;    1533;    1133;     400;      40
2251;T001235;GM1685;2013;    5793;    4236;    1534;    1116;     418;      23
2252;T001235;GM1685;2014;    5912;    4262;    1552;    1124;     428;      98
2253;T001235;GM1685;2015;    5971;    4364;    1512;    1112;     400;      95
2254;T001235;GM1685;2016;    6004;    4382;    1548;    1138;     410;      74
2255;T001235;GM1685;2017;    6074;    4433;    1568;    1136;     432;      73
2256;T001235;GM1685;2018;    6126;    4499;    1542;    1128;     414;      85
2257;T001235;GM1685;2019;    6300;    4643;    1654;    1186;     468;       3
2258;T001235;GM1685;2020;    6403;    4728;    1674;    1180;     494;       1
2259;T001235;GM0882;2012;   17833;   11124;    6641;    5064;    1577;      68
2260;T001235;GM0882;2013;   17899;   11072;    6787;    4999;    1788;      40
2261;T001235;GM0882;2014;   17969;   11098;    6739;    4994;    1745;     132
2262;T001235;GM0882;2015;   17897;   11071;    6691;    4909;    1782;     135
2263;T001235;GM0882;2016;   17923;   11079;    6678;    4852;    1826;     166
2264;T001235;GM0882;2017;   18038;   11046;    6847;    4939;    1908;     145
2265;T001235;GM0882;2018;   18128;   11221;    6731;    4978;    1753;     176
2266;T001235;GM0882;2019;   18139;   11397;    6672;    5098;    1574;      70
2267;T001235;GM0882;2020;   18142;   11363;    6669;    5097;    1572;     110
2268;T001235;GM0415;2012;    4391;    2903;    1476;    1185;     291;      12
2269;T001235;GM0415;2013;    4432;    2929;    1492;    1190;     302;      11
2270;T001235;GM0415;2014;    4463;    2928;    1524;    1204;     320;      11
2271;T001235;GM0415;2015;    4646;    2967;    1663;    1280;     383;      16
2272;T001235;GM0415;2016;    4668;    3003;    1651;    1264;     387;      14
2273;T001235;GM0415;2017;    4739;    3044;    1683;    1287;     396;      12
2274;T001235;GM0415;2018;    4835;    3210;    1612;    1287;     325;      13
2275;T001235;GM0415;2019;    4853;    3223;    1623;    1287;     336;       7
2276;T001235;GM0415;2020;    4896;    3249;    1640;    1287;     353;       7
2277;T001235;GM0416;2012;   10696;    8077;    2605;    1793;     812;      14
2278;T001235;GM0416;2013;   10773;    8115;    2649;    1804;     845;       9
2279;T001235;GM0416;2014;   10937;    8129;    2755;    2082;     673;      53
2280;T001235;GM0416;2015;   11079;    8127;    2898;    2138;     760;      54
2281;T001235;GM0416;2016;   11295;    8200;    3018;    2183;     835;      77
2282;T001235;GM0416;2017;   11312;    8212;    3022;    2160;     862;      78
2283;T001235;GM0416;2018;   11467;    8419;    3006;    2175;     831;      42
2284;T001235;GM0416;2019;   11567;    8586;    2977;    2306;     671;       4
2285;T001235;GM0416;2020;   11650;    8643;    3003;    2316;     687;       4
2286;T001235;GM1621;2012;   21230;   15414;    5670;    4315;    1355;     146
2287;T001235;GM1621;2013;   21913;   15793;    6003;    4417;    1586;     117
2288;T001235;GM1621;2014;   22158;   15895;    6117;    4436;    1681;     146
2289;T001235;GM1621;2015;   22523;   16099;    6230;    4436;    1794;     194
2290;T001235;GM1621;2016;   22942;   16511;    6278;    4466;    1812;     153
2291;T001235;GM1621;2017;   23255;   16688;    6401;    4502;    1899;     166
2292;T001235;GM1621;2018;   23565;   17062;    6350;    4489;    1861;     153
2293;T001235;GM1621;2019;   23802;   17459;    6324;    4565;    1759;      19
2294;T001235;GM1621;2020;   24249;   17766;    6428;    4578;    1850;      55
2295;T001235;GM0417;2012;    4971;    3432;    1511;     876;     635;      28
2296;T001235;GM0417;2013;    5161;    3456;    1601;     898;     703;     104
2297;T001235;GM0417;2014;    5166;    3417;    1678;     897;     781;      71
2298;T001235;GM0417;2015;    5167;    3422;    1678;     897;     781;      67
2299;T001235;GM0417;2016;    5181;    3456;    1665;     897;     768;      60
2300;T001235;GM0417;2017;    5244;    3451;    1665;     876;     789;     128
2301;T001235;GM0417;2018;    5269;    3559;    1581;     896;     685;     129
2302;T001235;GM0417;2019;    5280;    3616;    1607;     808;     799;      57
2303;T001235;GM0417;2020;    5400;    3617;    1727;     913;     814;      56
2304;T001235;GM0022;2012;    8057;    5286;    2704;    1931;     773;      67
2305;T001235;GM0022;2013;    8308;    5336;    2951;    2062;     889;      21
2306;T001235;GM0022;2014;    8367;    5336;    3009;    2130;     879;      22
2307;T001235;GM0022;2015;    8412;    5394;    2986;    2191;     795;      32
2308;T001235;GM0022;2016;    8498;    5377;    3111;    2151;     960;      10
2309;T001235;GM0022;2017;    8587;    5504;    3073;    2154;     919;      10
2310;T001235;GM0022;2018;    8614;    5586;    3008;    2153;     855;      20
2311;T001235;GM0022;2019;;;;;;
2312;T001235;GM0022;2020;;;;;;
2313;T001235;GM0545;2012;    8480;    4365;    4053;    3517;     536;      62
2314;T001235;GM0545;2013;    8544;    4400;    4109;    3549;     560;      35
2315;T001235;GM0545;2014;    8686;    4434;    4163;    3528;     635;      89
2316;T001235;GM0545;2015;    8565;    4497;    4004;    3373;     631;      64
2317;T001235;GM0545;2016;    8757;    4599;    4095;    3352;     743;      63
2318;T001235;GM0545;2017;    8762;    4670;    4034;    3270;     764;      58
2319;T001235;GM0545;2018;    8875;    4791;    4025;    3264;     761;      59
2320;T001235;GM0545;2019;;;;;;
2321;T001235;GM0545;2020;;;;;;
2322;T001235;GM0080;2012;   46778;   23056;   23324;   15596;    7728;     398
2323;T001235;GM0080;2013;   47727;   23234;   24162;   15755;    8407;     331
2324;T001235;GM0080;2014;   53112;   26389;   26352;   17294;    9058;     371
2325;T001235;GM0080;2015;   53792;   26325;   27109;   17461;    9648;     358
2326;T001235;GM0080;2016;   54245;   26296;   27491;   17333;   10158;     458
2327;T001235;GM0080;2017;   54461;   26481;   27553;   17254;   10299;     427
2328;T001235;GM0080;2018;   60905;   30872;   29512;   18217;   11295;     521
2329;T001235;GM0080;2019;   61492;   31934;   29248;   18505;   10743;     310
2330;T001235;GM0080;2020;   62599;   32063;   30188;   18307;   11881;     348
2331;T001235;GM0081;2012;    4256;    3196;    1056;     851;     205;       4
2332;T001235;GM0081;2013;    4267;    3187;    1077;     851;     226;       3
2333;T001235;GM0081;2014;    4325;    3193;    1089;     840;     249;      43
2334;T001235;GM0081;2015;    4341;    3209;    1088;     835;     253;      44
2335;T001235;GM0081;2016;    4352;    3206;    1098;     824;     274;      48
2336;T001235;GM0081;2017;    4353;    3219;    1090;     819;     271;      44
2337;T001235;GM0081;2018;;;;;;
2338;T001235;GM0081;2019;;;;;;
2339;T001235;GM0081;2020;;;;;;
2340;T001235;GM0546;2012;   53611;   24240;   28470;   18872;    9598;     901
2341;T001235;GM0546;2013;   54400;   24526;   29311;   19441;    9870;     563
2342;T001235;GM0546;2014;   55202;   24732;   29977;   19820;   10157;     493
2343;T001235;GM0546;2015;   55231;   25132;   29657;   19849;    9808;     442
2344;T001235;GM0546;2016;   56636;   25484;   30663;   19501;   11162;     489
2345;T001235;GM0546;2017;   57476;   25599;   31276;   19772;   11504;     601
2346;T001235;GM0546;2018;   58079;   25348;   32152;   19576;   12576;     579
2347;T001235;GM0546;2019;   59088;   25801;   33151;   19898;   13253;     136
2348;T001235;GM0546;2020;   59832;   25683;   33997;   19957;   14040;     152
2349;T001235;GM0547;2012;   11838;    7308;    4503;    3075;    1428;      27
2350;T001235;GM0547;2013;   11843;    7402;    4420;    3104;    1316;      21
2351;T001235;GM0547;2014;   11891;    7455;    4411;    2888;    1523;      25
2352;T001235;GM0547;2015;   11958;    7556;    4384;    3087;    1297;      18
2353;T001235;GM0547;2016;   12016;    7598;    4348;    3061;    1287;      70
2354;T001235;GM0547;2017;   12068;    7690;    4343;    3078;    1265;      35
2355;T001235;GM0547;2018;   12118;    7806;    4294;    3079;    1215;      18
2356;T001235;GM0547;2019;   12121;    7878;    4239;    3009;    1230;       4
2357;T001235;GM0547;2020;   12119;    7899;    4214;    2971;    1243;       6
2358;T001235;GM1916;2012;   35969;   20124;   15827;    9602;    6225;      18
2359;T001235;GM1916;2013;   35868;   20174;   15686;    9471;    6215;       8
2360;T001235;GM1916;2014;   36175;   20237;   15744;    9365;    6379;     194
2361;T001235;GM1916;2015;   36383;   20468;   15720;    9425;    6295;     195
2362;T001235;GM1916;2016;   36398;   20546;   15647;    9409;    6238;     205
2363;T001235;GM1916;2017;   36444;   20532;   15702;    9375;    6327;     210
2364;T001235;GM1916;2018;   36481;   20393;   15858;    9463;    6395;     230
2365;T001235;GM1916;2019;   36781;   21179;   15450;    9425;    6025;     152
2366;T001235;GM1916;2020;   36944;   21310;   15522;    9404;    6118;     112
2367;T001235;GM0995;2012;   32216;   20222;   11366;    9129;    2237;     628
2368;T001235;GM0995;2013;   32379;   20319;   11835;    9097;    2738;     225
2369;T001235;GM0995;2014;   32578;   20303;   12074;    9152;    2922;     201
2370;T001235;GM0995;2015;   32658;   20270;   12181;    9234;    2947;     207
2371;T001235;GM0995;2016;   32755;   20345;   12270;    9274;    2996;     140
2372;T001235;GM0995;2017;   32895;   20410;   12406;    9260;    3146;      79
2373;T001235;GM0995;2018;   32767;   20317;   12349;    9210;    3139;     101
2374;T001235;GM0995;2019;   32893;   21033;   11831;    9271;    2560;      29
2375;T001235;GM0995;2020;   33385;   21214;   12139;    9382;    2757;      32
2376;T001235;GM0082;2012;    6315;    4169;    2090;    1571;     519;      56
2377;T001235;GM0082;2013;    6435;    4245;    2151;    1571;     580;      39
2378;T001235;GM0082;2014;;;;;;
2379;T001235;GM0082;2015;;;;;;
2380;T001235;GM0082;2016;;;;;;
2381;T001235;GM0082;2017;;;;;;
2382;T001235;GM0082;2018;;;;;;
2383;T001235;GM0082;2019;;;;;;
2384;T001235;GM0082;2020;;;;;;
2385;T001235;GM1640;2012;   15231;   12218;    2960;    1896;    1064;      53
2386;T001235;GM1640;2013;   15327;   12274;    3025;    1934;    1091;      28
2387;T001235;GM1640;2014;   15520;   12271;    3043;    1906;    1137;     206
2388;T001235;GM1640;2015;   15669;   12232;    3123;    1933;    1190;     314
2389;T001235;GM1640;2016;   15718;   12181;    3214;    1914;    1300;     323
2390;T001235;GM1640;2017;   15735;   12162;    3260;    1917;    1343;     313
2391;T001235;GM1640;2018;   15745;   12271;    3192;    1903;    1289;     282
2392;T001235;GM1640;2019;   15832;   12341;    3466;    2005;    1461;      25
2393;T001235;GM1640;2020;   15992;   12394;    3576;    2015;    1561;      22
2394;T001235;GM0327;2012;   12133;    8334;    3746;    2795;     951;      53
2395;T001235;GM0327;2013;   12415;    8501;    3875;    2887;     988;      39
2396;T001235;GM0327;2014;   12389;    8537;    3832;    2655;    1177;      20
2397;T001235;GM0327;2015;   12400;    8538;    3821;    2598;    1223;      41
2398;T001235;GM0327;2016;   12425;    8631;    3772;    2619;    1153;      22
2399;T001235;GM0327;2017;   12495;    8680;    3792;    2612;    1180;      23
2400;T001235;GM0327;2018;   12637;    8741;    3869;    2696;    1173;      27
2401;T001235;GM0327;2019;   12905;    9151;    3746;    2665;    1081;       8
2402;T001235;GM0327;2020;   13043;    9216;    3819;    2712;    1107;       8
2403;T001235;GM0694;2012;    3762;    2344;    1399;    1220;     179;      19
2404;T001235;GM0694;2013;;;;;;
2405;T001235;GM0694;2014;;;;;;
2406;T001235;GM0694;2015;;;;;;
2407;T001235;GM0694;2016;;;;;;
2408;T001235;GM0694;2017;;;;;;
2409;T001235;GM0694;2018;;;;;;
2410;T001235;GM0694;2019;;;;;;
2411;T001235;GM0694;2020;;;;;;
2412;T001235;GM0733;2012;    4288;    2861;    1396;    1151;     245;      31
2413;T001235;GM0733;2013;    4409;    2897;    1484;    1231;     253;      28
2414;T001235;GM0733;2014;    4467;    2929;    1502;    1178;     324;      36
2415;T001235;GM0733;2015;    4501;    2949;    1505;    1189;     316;      47
2416;T001235;GM0733;2016;    4538;    3012;    1476;    1193;     283;      50
2417;T001235;GM0733;2017;    4532;    3016;    1486;    1171;     315;      30
2418;T001235;GM0733;2018;    4594;    3065;    1493;    1178;     315;      36
2419;T001235;GM0733;2019;;;;;;
2420;T001235;GM0733;2020;;;;;;
2421;T001235;GM1705;2012;   18539;   13449;    5083;    3829;    1254;       7
2422;T001235;GM1705;2013;   18781;   13581;    5193;    3851;    1342;       7
2423;T001235;GM1705;2014;   18884;   13589;    5284;    3804;    1480;      11
2424;T001235;GM1705;2015;   19214;   13684;    5328;    3787;    1541;     202
2425;T001235;GM1705;2016;   19423;   13843;    5366;    3828;    1538;     214
2426;T001235;GM1705;2017;   19638;   13813;    5543;    3888;    1655;     282
2427;T001235;GM1705;2018;   19646;   14069;    5368;    3894;    1474;     209
2428;T001235;GM1705;2019;   19783;   14285;    5370;    3901;    1469;     128
2429;T001235;GM1705;2020;   19872;   14320;    5460;    3919;    1541;      92
2430;T001235;GM0553;2012;    9637;    6031;    3603;    2899;     704;       3
2431;T001235;GM0553;2013;    9653;    6048;    3602;    2882;     720;       3
2432;T001235;GM0553;2014;    9782;    6060;    3720;    2851;     869;       2
2433;T001235;GM0553;2015;    9935;    6195;    3734;    2855;     879;       6
2434;T001235;GM0553;2016;   10080;    6266;    3805;    2876;     929;       9
2435;T001235;GM0553;2017;   10183;    6283;    3858;    2883;     975;      42
2436;T001235;GM0553;2018;   10049;    6378;    3638;    2787;     851;      33
2437;T001235;GM0553;2019;   10217;    6464;    3673;    2828;     845;      80
2438;T001235;GM0553;2020;   10330;    6560;    3687;    2830;     857;      83
2439;T001235;GM0140;2012;    4496;    3374;    1108;     893;     215;      14
2440;T001235;GM0140;2013;    4531;    3397;    1119;     905;     214;      15
2441;T001235;GM0140;2014;    4551;    3425;    1112;     889;     223;      14
2442;T001235;GM0140;2015;    4527;    3434;    1069;     855;     214;      24
2443;T001235;GM0140;2016;    4515;    3448;    1046;     830;     216;      21
2444;T001235;GM0140;2017;    4528;    3446;    1063;     821;     242;      19
2445;T001235;GM0140;2018;;;;;;
2446;T001235;GM0140;2019;;;;;;
2447;T001235;GM0140;2020;;;;;;
2448;T001235;GM0262;2012;   14113;    9672;    4373;    2766;    1607;      68
2449;T001235;GM0262;2013;   14265;    9758;    4452;    2776;    1676;      55
2450;T001235;GM0262;2014;   14396;    9848;    4483;    2809;    1674;      65
2451;T001235;GM0262;2015;   14519;    9935;    4498;    2900;    1598;      86
2452;T001235;GM0262;2016;   14624;   10011;    4492;    2888;    1604;     121
2453;T001235;GM0262;2017;   14778;   10134;    4519;    2904;    1615;     125
2454;T001235;GM0262;2018;   14916;   10391;    4389;    2894;    1495;     136
2455;T001235;GM0262;2019;   14997;   10531;    4450;    2831;    1619;      16
2456;T001235;GM0262;2020;   15096;   10647;    4432;    2830;    1602;      17
2457;T001235;GM0809;2012;    9864;    6192;    3472;    2414;    1058;     200
2458;T001235;GM0809;2013;    9961;    6241;    3709;    2456;    1253;      11
2459;T001235;GM0809;2014;   10033;    6249;    3776;    2468;    1308;       8
2460;T001235;GM0809;2015;   10025;    6265;    3748;    2443;    1305;      12
2461;T001235;GM0809;2016;   10110;    6347;    3746;    2492;    1254;      17
2462;T001235;GM0809;2017;   10169;    6344;    3812;    2519;    1293;      13
2463;T001235;GM0809;2018;   10209;    6429;    3764;    2535;    1229;      16
2464;T001235;GM0809;2019;   10317;    6543;    3750;    2529;    1221;      24
2465;T001235;GM0809;2020;   10409;    6590;    3795;    2519;    1276;      24
2466;T001235;GM0331;2012;    5315;    3930;    1314;     977;     337;      71
2467;T001235;GM0331;2013;    5347;    3974;    1364;     976;     388;       9
2468;T001235;GM0331;2014;    5364;    3985;    1364;     973;     391;      15
2469;T001235;GM0331;2015;    5383;    3940;    1424;     969;     455;      19
2470;T001235;GM0331;2016;    5488;    3969;    1495;     968;     527;      24
2471;T001235;GM0331;2017;    5526;    4015;    1489;     958;     531;      22
2472;T001235;GM0331;2018;    5581;    4060;    1485;     964;     521;      36
2473;T001235;GM0331;2019;    5660;    4217;    1429;    1003;     426;      14
2474;T001235;GM0331;2020;    5741;    4261;    1469;    1005;     464;      11
2475;T001235;GM0024;2012;    4478;    3026;    1442;    1181;     261;      10
2476;T001235;GM0024;2013;    4508;    3032;    1467;    1202;     265;       9
2477;T001235;GM0024;2014;    4621;    3018;    1594;    1311;     283;       9
2478;T001235;GM0024;2015;    4657;    3018;    1623;    1339;     284;      16
2479;T001235;GM0024;2016;    4648;    3021;    1555;    1269;     286;      72
2480;T001235;GM0024;2017;    4627;    2988;    1566;    1267;     299;      73
2481;T001235;GM0024;2018;    4687;    3024;    1578;    1241;     337;      85
2482;T001235;GM0024;2019;    4698;    3050;    1632;    1312;     320;      16
2483;T001235;GM0024;2020;    4687;    3041;    1644;    1314;     330;       2
2484;T001235;GM0168;2012;    9291;    6380;    2769;    2007;     762;     142
2485;T001235;GM0168;2013;    9429;    6402;    2852;    1998;     854;     175
2486;T001235;GM0168;2014;    9462;    6388;    2918;    1999;     919;     156
2487;T001235;GM0168;2015;    9497;    6404;    2923;    2016;     907;     170
2488;T001235;GM0168;2016;    9559;    6432;    2963;    1967;     996;     164
2489;T001235;GM0168;2017;    9626;    6411;    3060;    1982;    1078;     155
2490;T001235;GM0168;2018;    9712;    6589;    2980;    1987;     993;     143
2491;T001235;GM0168;2019;    9733;    6646;    3069;    1972;    1097;      18
2492;T001235;GM0168;2020;    9789;    6746;    3024;    1940;    1084;      19
2493;T001235;GM1671;2012;    4553;    3192;     998;     688;     310;     363
2494;T001235;GM1671;2013;    4589;    3200;    1038;     683;     355;     351
2495;T001235;GM1671;2014;    4559;    3223;    1042;     668;     374;     294
2496;T001235;GM1671;2015;;;;;;
2497;T001235;GM1671;2016;;;;;;
2498;T001235;GM1671;2017;;;;;;
2499;T001235;GM1671;2018;;;;;;
2500;T001235;GM1671;2019;;;;;;
2501;T001235;GM1671;2020;;;;;;
2502;T001235;GM0263;2012;    9484;    6432;    2948;    2235;     713;     104
2503;T001235;GM0263;2013;    9531;    6520;    2949;    2207;     742;      62
2504;T001235;GM0263;2014;    9566;    6568;    2935;    2171;     764;      63
2505;T001235;GM0263;2015;    9639;    6634;    2955;    2175;     780;      50
2506;T001235;GM0263;2016;    9695;    6837;    2820;    2128;     692;      38
2507;T001235;GM0263;2017;    9749;    6800;    2893;    2127;     766;      56
2508;T001235;GM0263;2018;    9830;    6887;    2899;    2109;     790;      44
2509;T001235;GM0263;2019;    9947;    7067;    2857;    2125;     732;      23
2510;T001235;GM0263;2020;   10115;    7172;    2921;    2120;     801;      22
2511;T001235;GM1641;2012;   10280;    7744;    2432;    1646;     786;     104
2512;T001235;GM1641;2013;   10298;    7718;    2509;    1640;     869;      71
2513;T001235;GM1641;2014;   10559;    7825;    2628;    1560;    1068;     106
2514;T001235;GM1641;2015;   10599;    7841;    2655;    1588;    1067;     103
2515;T001235;GM1641;2016;   10601;    7827;    2668;    1570;    1098;     106
2516;T001235;GM1641;2017;   10641;    7801;    2740;    1588;    1152;     100
2517;T001235;GM1641;2018;   10678;    7946;    2639;    1585;    1054;      93
2518;T001235;GM1641;2019;   10702;    8010;    2673;    1782;     891;      19
2519;T001235;GM1641;2020;   10856;    8103;    2733;    1794;     939;      20
2520;T001235;GM0556;2012;   14511;    7176;    7184;    6314;     870;     151
2521;T001235;GM0556;2013;   14459;    7272;    7177;    6246;     931;      10
2522;T001235;GM0556;2014;   14805;    7272;    7295;    6343;     952;     238
2523;T001235;GM0556;2015;   14846;    7339;    7296;    6343;     953;     211
2524;T001235;GM0556;2016;   14938;    7444;    7276;    6324;     952;     218
2525;T001235;GM0556;2017;   14943;    7484;    7190;    6228;     962;     269
2526;T001235;GM0556;2018;   15058;    7616;    7115;    6226;     889;     327
2527;T001235;GM0556;2019;   15127;    7923;    7193;    6195;     998;      11
2528;T001235;GM0556;2020;   15186;    8039;    7107;    6170;     937;      40
2529;T001235;GM0935;2012;   59234;   22938;   33902;   21850;   12052;    2394
2530;T001235;GM0935;2013;   60360;   23196;   35449;   22452;   12997;    1715
2531;T001235;GM0935;2014;   61021;   23394;   35838;   22859;   12979;    1789
2532;T001235;GM0935;2015;   60764;   23474;   35719;   22837;   12882;    1571
2533;T001235;GM0935;2016;   60948;   23557;   35747;   22567;   13180;    1644
2534;T001235;GM0935;2017;   61485;   23631;   36362;   22582;   13780;    1492
2535;T001235;GM0935;2018;   61955;   23655;   36841;   22032;   14809;    1459
2536;T001235;GM0935;2019;   61884;   24358;   36882;   22258;   14624;     644
2537;T001235;GM0935;2020;   61833;   24345;   36797;   22010;   14787;     691
2538;T001235;GM1663;2012;    5218;    3531;    1665;    1207;     458;      22
2539;T001235;GM1663;2013;    5205;    3537;    1644;    1204;     440;      24
2540;T001235;GM1663;2014;    5263;    3507;    1668;    1197;     471;      88
2541;T001235;GM1663;2015;    5280;    3493;    1697;    1192;     505;      90
2542;T001235;GM1663;2016;    5260;    3490;    1681;    1168;     513;      89
2543;T001235;GM1663;2017;    5227;    3519;    1629;    1132;     497;      79
2544;T001235;GM1663;2018;    5208;    3531;    1603;    1131;     472;      74
2545;T001235;GM1663;2019;;;;;;
2546;T001235;GM1663;2020;;;;;;
2547;T001235;GM0025;2012;    4113;    3033;    1069;     839;     230;      11
2548;T001235;GM0025;2013;    4156;    3034;    1118;     838;     280;       4
2549;T001235;GM0025;2014;    4241;    3042;    1195;     836;     359;       4
2550;T001235;GM0025;2015;    4254;    3052;    1199;     835;     364;       3
2551;T001235;GM0025;2016;    4291;    3079;    1207;     832;     375;       5
2552;T001235;GM0025;2017;    4351;    3121;    1223;     828;     395;       7
2553;T001235;GM0025;2018;    4396;    3226;    1166;     801;     365;       4
2554;T001235;GM0025;2019;;;;;;
2555;T001235;GM0025;2020;;;;;;
2556;T001235;GM0420;2012;   17346;   12090;    5214;    4321;     893;      42
2557;T001235;GM0420;2013;   17528;   12177;    5319;    4336;     983;      32
2558;T001235;GM0420;2014;   18124;   12443;    5557;    4307;    1250;     124
2559;T001235;GM0420;2015;   18237;   12456;    5658;    4349;    1309;     123
2560;T001235;GM0420;2016;   18402;   12569;    5705;    4343;    1362;     128
2561;T001235;GM0420;2017;   18607;   12722;    5742;    4354;    1388;     143
2562;T001235;GM0420;2018;   18774;   12807;    5860;    4392;    1468;     107
2563;T001235;GM0420;2019;   18957;   13195;    5689;    4523;    1166;      73
2564;T001235;GM0420;2020;   19100;   13260;    5763;    4508;    1255;      77
2565;T001235;GM0938;2012;    8345;    5935;    2398;    1575;     823;      12
2566;T001235;GM0938;2013;    8360;    5949;    2402;    1575;     827;       9
2567;T001235;GM0938;2014;    8385;    5926;    2450;    1585;     865;       9
2568;T001235;GM0938;2015;    8445;    5915;    2516;    1605;     911;      14
2569;T001235;GM0938;2016;    8569;    5956;    2545;    1636;     909;      68
2570;T001235;GM0938;2017;    8590;    5936;    2586;    1643;     943;      68
2571;T001235;GM0938;2018;    8587;    6182;    2335;    1620;     715;      70
2572;T001235;GM0938;2019;    8603;    6231;    2344;    1660;     684;      28
2573;T001235;GM0938;2020;    8629;    6239;    2371;    1657;     714;      19
2574;T001235;GM1948;2012;;;;;;
2575;T001235;GM1948;2013;;;;;;
2576;T001235;GM1948;2014;;;;;;
2577;T001235;GM1948;2015;;;;;;
2578;T001235;GM1948;2016;;;;;;
2579;T001235;GM1948;2017;   33148;   23171;    9712;    6863;    2849;     265
2580;T001235;GM1948;2018;   33475;   23709;    9335;    6983;    2352;     431
2581;T001235;GM1948;2019;   34102;   23832;   10247;    7224;    3023;      23
2582;T001235;GM1948;2020;   34544;   24079;   10454;    7266;    3188;      11
2583;T001235;GM1908;2012;    5630;    4011;    1614;    1165;     449;       5
2584;T001235;GM1908;2013;    5668;    4054;    1613;    1174;     439;       1
2585;T001235;GM1908;2014;    5831;    4185;    1645;    1170;     475;       1
2586;T001235;GM1908;2015;    5840;    4197;    1642;    1278;     364;       1
2587;T001235;GM1908;2016;    5851;    4214;    1636;    1210;     426;       1
2588;T001235;GM1908;2017;    5849;    4222;    1627;    1198;     429;       0
2589;T001235;GM1908;2018;;;;;;
2590;T001235;GM1908;2019;;;;;;
2591;T001235;GM1908;2020;;;;;;
2592;T001235;GM1987;2012;    5370;    3410;    1923;    1507;     416;      37
2593;T001235;GM1987;2013;    5369;    3430;    1909;    1513;     396;      30
2594;T001235;GM1987;2014;    5411;    3435;    1949;    1545;     404;      27
2595;T001235;GM1987;2015;    5406;    3440;    1943;    1530;     413;      23
2596;T001235;GM1987;2016;    5408;    3438;    1951;    1523;     428;      19
2597;T001235;GM1987;2017;    5407;    3450;    1941;    1523;     418;      16
2598;T001235;GM1987;2018;;;;;;
2599;T001235;GM1987;2019;;;;;;
2600;T001235;GM1987;2020;;;;;;
2601;T001235;GM0119;2012;   14352;    8246;    6032;    4407;    1625;      74
2602;T001235;GM0119;2013;   14686;    8477;    6135;    4432;    1703;      74
2603;T001235;GM0119;2014;   15101;    8493;    6256;    4395;    1861;     352
2604;T001235;GM0119;2015;   15076;    8526;    6202;    4386;    1816;     348
2605;T001235;GM0119;2016;   15177;    8584;    6210;    4774;    1436;     383
2606;T001235;GM0119;2017;   15388;    8789;    6214;    4819;    1395;     385
2607;T001235;GM0119;2018;   15586;    8868;    6317;    4793;    1524;     401
2608;T001235;GM0119;2019;   15658;    9081;    6572;    4915;    1657;       5
2609;T001235;GM0119;2020;   15851;    9148;    6699;    4966;    1733;       4
2610;T001235;GM0687;2012;   22576;   13201;    9160;    6774;    2386;     215
2611;T001235;GM0687;2013;   22739;   13343;    9330;    6798;    2532;      66
2612;T001235;GM0687;2014;   23169;   13407;    9391;    6818;    2573;     371
2613;T001235;GM0687;2015;   23008;   13484;    9250;    6752;    2498;     274
2614;T001235;GM0687;2016;   23004;   13557;    9226;    6751;    2475;     221
2615;T001235;GM0687;2017;   23167;   13585;    9321;    6732;    2589;     261
2616;T001235;GM0687;2018;   23349;   13888;    9253;    6701;    2552;     208
2617;T001235;GM0687;2019;   23532;   14295;    9181;    6665;    2516;      56
2618;T001235;GM0687;2020;   23683;   14399;    9190;    6609;    2581;      94
2619;T001235;GM0559;2012;    7586;    4501;    3018;    2590;     428;      67
2620;T001235;GM0559;2013;;;;;;
2621;T001235;GM0559;2014;;;;;;
2622;T001235;GM0559;2015;;;;;;
2623;T001235;GM0559;2016;;;;;;
2624;T001235;GM0559;2017;;;;;;
2625;T001235;GM0559;2018;;;;;;
2626;T001235;GM0559;2019;;;;;;
2627;T001235;GM0559;2020;;;;;;
2628;T001235;GM1842;2012;    7195;    5103;    2083;    1660;     423;       9
2629;T001235;GM1842;2013;    7281;    5189;    2086;    1655;     431;       6
2630;T001235;GM1842;2014;    7449;    5326;    2118;    1622;     496;       5
2631;T001235;GM1842;2015;    7578;    5410;    2161;    1632;     529;       7
2632;T001235;GM1842;2016;    7649;    5533;    2108;    1583;     525;       8
2633;T001235;GM1842;2017;    7727;    5559;    2157;    1600;     557;      11
2634;T001235;GM1842;2018;    7836;    5717;    2112;    1630;     482;       7
2635;T001235;GM1842;2019;    7883;    5802;    2076;    1646;     430;       5
2636;T001235;GM1842;2020;    7904;    5815;    2085;    1649;     436;       4
2637;T001235;GM1731;2012;   13950;    9417;    4465;    3444;    1021;      68
2638;T001235;GM1731;2013;   13986;    9590;    4345;    3428;     917;      51
2639;T001235;GM1731;2014;   13976;    9622;    4333;    3429;     904;      21
2640;T001235;GM1731;2015;   14045;    9675;    4331;    3412;     919;      39
2641;T001235;GM1731;2016;   14030;    9687;    4287;    3365;     922;      56
2642;T001235;GM1731;2017;   14156;    9730;    4363;    3351;    1012;      63
2643;T001235;GM1731;2018;   14304;    9789;    4453;    3376;    1077;      62
2644;T001235;GM1731;2019;   14313;    9972;    4276;    3320;     956;      65
2645;T001235;GM1731;2020;   14378;    9994;    4364;    3305;    1059;      20
2646;T001235;GM1952;2012;;;;;;
2647;T001235;GM1952;2013;;;;;;
2648;T001235;GM1952;2014;;;;;;
2649;T001235;GM1952;2015;;;;;;
2650;T001235;GM1952;2016;;;;;;
2651;T001235;GM1952;2017;;;;;;
2652;T001235;GM1952;2018;   28025;   17249;   10510;    8257;    2253;     266
2653;T001235;GM1952;2019;   28074;   17479;   10514;    8412;    2102;      81
2654;T001235;GM1952;2020;   28167;   17478;   10603;    8432;    2171;      86
2655;T001235;GM0815;2012;    4378;    3130;    1193;     950;     243;      55
2656;T001235;GM0815;2013;    4437;    3195;    1207;     946;     261;      35
2657;T001235;GM0815;2014;    4514;    3194;    1217;     939;     278;     103
2658;T001235;GM0815;2015;    4511;    3206;    1206;     927;     279;      99
2659;T001235;GM0815;2016;    4440;    3217;    1187;     911;     276;      36
2660;T001235;GM0815;2017;    4494;    3241;    1223;     903;     320;      30
2661;T001235;GM0815;2018;    4531;    3307;    1190;     916;     274;      34
2662;T001235;GM0815;2019;    4569;    3313;    1254;     923;     331;       2
2663;T001235;GM0815;2020;    4627;    3354;    1266;     926;     340;       7
2664;T001235;GM0265;2012;    2486;    1648;     836;     749;      87;       2
2665;T001235;GM0265;2013;    2528;    1664;     862;     777;      85;       2
2666;T001235;GM0265;2014;    2564;    1675;     887;     792;      95;       2
2667;T001235;GM0265;2015;;;;;;
2668;T001235;GM0265;2016;;;;;;
2669;T001235;GM0265;2017;;;;;;
2670;T001235;GM0265;2018;;;;;;
2671;T001235;GM0265;2019;;;;;;
2672;T001235;GM0265;2020;;;;;;
2673;T001235;GM1709;2012;   15708;   10198;    5389;    4472;     917;     121
2674;T001235;GM1709;2013;   15812;   10324;    5467;    4471;     996;      21
2675;T001235;GM1709;2014;   15970;   10381;    5566;    4428;    1138;      23
2676;T001235;GM1709;2015;   16077;   10456;    5578;    4396;    1182;      43
2677;T001235;GM1709;2016;   16116;   10486;    5589;    4338;    1251;      41
2678;T001235;GM1709;2017;   16315;   10514;    5759;    4338;    1421;      42
2679;T001235;GM1709;2018;   16340;   10432;    5862;    4431;    1431;      46
2680;T001235;GM1709;2019;   16407;   10796;    5592;    4434;    1158;      19
2681;T001235;GM1709;2020;   16501;   10879;    5605;    4437;    1168;      17
2682;T001235;GM1978;2012;;;;;;
2683;T001235;GM1978;2013;;;;;;
2684;T001235;GM1978;2014;;;;;;
2685;T001235;GM1978;2015;;;;;;
2686;T001235;GM1978;2016;;;;;;
2687;T001235;GM1978;2017;;;;;;
2688;T001235;GM1978;2018;;;;;;
2689;T001235;GM1978;2019;   17159;   11782;    5290;    4499;     791;      87
2690;T001235;GM1978;2020;   17205;   11850;    5263;    4437;     826;      92
2691;T001235;GM1927;2012;;;;;;
2692;T001235;GM1927;2013;   10840;    6822;    3971;    3343;     628;      47
2693;T001235;GM1927;2014;   10938;    6849;    3991;    3346;     645;      98
2694;T001235;GM1927;2015;   10941;    6922;    3925;    3281;     644;      94
2695;T001235;GM1927;2016;   11021;    7014;    3913;    3329;     584;      94
2696;T001235;GM1927;2017;   11109;    7093;    3923;    3303;     620;      93
2697;T001235;GM1927;2018;   11206;    7272;    3836;    3296;     540;      98
2698;T001235;GM1927;2019;;;;;;
2699;T001235;GM1927;2020;;;;;;
2700;T001235;GM1955;2012;   14625;    9515;    5046;    3765;    1281;      64
2701;T001235;GM1955;2013;   14738;    9608;    5083;    3789;    1294;      47
2702;T001235;GM1955;2014;   14933;    9742;    5134;    3833;    1301;      57
2703;T001235;GM1955;2015;   15170;    9816;    5341;    3956;    1385;      13
2704;T001235;GM1955;2016;   15281;    9919;    5349;    3845;    1504;      13
2705;T001235;GM1955;2017;   15385;    9953;    5425;    3831;    1594;       7
2706;T001235;GM1955;2018;   15525;   10166;    5348;    3871;    1477;      11
2707;T001235;GM1955;2019;   15727;   10364;    5310;    3845;    1465;      53
2708;T001235;GM1955;2020;   15917;   10454;    5407;    3863;    1544;      56
2709;T001235;GM0335;2012;    5350;    3959;    1372;     910;     462;      19
2710;T001235;GM0335;2013;    5443;    4018;    1399;     919;     480;      26
2711;T001235;GM0335;2014;    5483;    4018;    1417;     844;     573;      48
2712;T001235;GM0335;2015;    5506;    4028;    1433;     926;     507;      45
2713;T001235;GM0335;2016;    5572;    4109;    1416;     869;     547;      47
2714;T001235;GM0335;2017;    5667;    4109;    1478;     885;     593;      80
2715;T001235;GM0335;2018;    5730;    4136;    1513;     886;     627;      81
2716;T001235;GM0335;2019;    5733;    4285;    1441;     933;     508;       7
2717;T001235;GM0335;2020;    5740;    4267;    1466;     933;     533;       7
2718;T001235;GM0944;2012;    3476;    2558;     874;     598;     276;      44
2719;T001235;GM0944;2013;    3489;    2569;     882;     593;     289;      38
2720;T001235;GM0944;2014;    3518;    2607;     878;     590;     288;      33
2721;T001235;GM0944;2015;    3544;    2606;     900;     609;     291;      38
2722;T001235;GM0944;2016;    3560;    2611;     909;     610;     299;      40
2723;T001235;GM0944;2017;    3563;    2609;     917;     607;     310;      37
2724;T001235;GM0944;2018;    3617;    2638;     938;     597;     341;      41
2725;T001235;GM0944;2019;    3579;    2665;     911;     591;     320;       3
2726;T001235;GM0944;2020;    3591;    2685;     904;     595;     309;       2
2727;T001235;GM0424;2012;    2754;    1663;    1087;     824;     263;       4
2728;T001235;GM0424;2013;    2755;    1656;    1094;     823;     271;       5
2729;T001235;GM0424;2014;    2800;    1645;    1152;     823;     329;       3
2730;T001235;GM0424;2015;    2781;    1658;    1119;     807;     312;       4
2731;T001235;GM0424;2016;;;;;;
2732;T001235;GM0424;2017;;;;;;
2733;T001235;GM0424;2018;;;;;;
2734;T001235;GM0424;2019;;;;;;
2735;T001235;GM0424;2020;;;;;;
2736;T001235;GM0425;2012;    7517;    5292;    2190;    1603;     587;      35
2737;T001235;GM0425;2013;    7527;    5296;    2209;    1585;     624;      22
2738;T001235;GM0425;2014;    7553;    5277;    2253;    1561;     692;      23
2739;T001235;GM0425;2015;    7666;    5309;    2271;    1544;     727;      86
2740;T001235;GM0425;2016;;;;;;
2741;T001235;GM0425;2017;;;;;;
2742;T001235;GM0425;2018;;;;;;
2743;T001235;GM0425;2019;;;;;;
2744;T001235;GM0425;2020;;;;;;
2745;T001235;GM1740;2012;    8085;    4882;    3179;    2543;     636;      24
2746;T001235;GM1740;2013;    8052;    4916;    3124;    2555;     569;      12
2747;T001235;GM1740;2014;    8036;    4991;    3036;    2475;     561;       9
2748;T001235;GM1740;2015;    8250;    5110;    3129;    2560;     569;      11
2749;T001235;GM1740;2016;    8391;    5190;    3186;    2586;     600;      15
2750;T001235;GM1740;2017;    8510;    5282;    3211;    2581;     630;      17
2751;T001235;GM1740;2018;    8625;    5520;    3092;    2596;     496;      13
2752;T001235;GM1740;2019;    8748;    5693;    3037;    2573;     464;      18
2753;T001235;GM1740;2020;    8867;    5781;    3060;    2592;     468;      26
2754;T001235;GM0643;2012;    5931;    3723;    2198;    1633;     565;      10
2755;T001235;GM0643;2013;    6091;    3837;    2213;    1677;     536;      41
2756;T001235;GM0643;2014;    6152;    3878;    2262;    1717;     545;      12
2757;T001235;GM0643;2015;;;;;;
2758;T001235;GM0643;2016;;;;;;
2759;T001235;GM0643;2017;;;;;;
2760;T001235;GM0643;2018;;;;;;
2761;T001235;GM0643;2019;;;;;;
2762;T001235;GM0643;2020;;;;;;
2763;T001235;GM0946;2012;    6916;    4783;    2119;    1595;     524;      14
2764;T001235;GM0946;2013;    6991;    4861;    2115;    1554;     561;      15
2765;T001235;GM0946;2014;    7076;    4911;    2094;    1544;     550;      71
2766;T001235;GM0946;2015;    7118;    4921;    2124;    1531;     593;      73
2767;T001235;GM0946;2016;    7165;    4928;    2166;    1520;     646;      71
2768;T001235;GM0946;2017;    7240;    4998;    2172;    1513;     659;      70
2769;T001235;GM0946;2018;    7337;    5077;    2188;    1509;     679;      72
2770;T001235;GM0946;2019;    7385;    5200;    2171;    1505;     666;      14
2771;T001235;GM0946;2020;    7457;    5271;    2171;    1484;     687;      15
2772;T001235;GM0304;2012;    4607;    3134;    1388;    1143;     245;      85
2773;T001235;GM0304;2013;    4621;    3158;    1399;    1133;     266;      64
2774;T001235;GM0304;2014;    4661;    3201;    1417;    1115;     302;      43
2775;T001235;GM0304;2015;    4660;    3204;    1417;    1140;     277;      39
2776;T001235;GM0304;2016;    4786;    3294;    1394;    1163;     231;      98
2777;T001235;GM0304;2017;    4861;    3336;    1422;    1149;     273;     103
2778;T001235;GM0304;2018;    4898;    3371;    1422;    1149;     273;     105
2779;T001235;GM0304;2019;;;;;;
2780;T001235;GM0304;2020;;;;;;
2781;T001235;GM0356;2012;   26411;   15656;   10681;    8648;    2033;      74
2782;T001235;GM0356;2013;   26647;   15767;   10799;    8590;    2209;      81
2783;T001235;GM0356;2014;   27068;   15999;   10857;    8559;    2298;     212
2784;T001235;GM0356;2015;   27507;   16213;   11067;    8716;    2351;     227
2785;T001235;GM0356;2016;   27799;   16385;   11125;    8727;    2398;     289
2786;T001235;GM0356;2017;   27976;   16484;   11161;    8652;    2509;     331
2787;T001235;GM0356;2018;   28495;   16610;   11569;    8672;    2897;     316
2788;T001235;GM0356;2019;   28710;   17236;   11382;    8771;    2611;      92
2789;T001235;GM0356;2020;   28844;   17270;   11390;    8719;    2671;     184
2790;T001235;GM0569;2012;   10346;    7251;    3043;    2291;     752;      52
2791;T001235;GM0569;2013;   10420;    7334;    3044;    2317;     727;      42
2792;T001235;GM0569;2014;   10597;    7449;    3121;    2332;     789;      27
2793;T001235;GM0569;2015;   10741;    7530;    3149;    2321;     828;      62
2794;T001235;GM0569;2016;   10835;    7695;    3082;    2313;     769;      58
2795;T001235;GM0569;2017;   11113;    7893;    3165;    2348;     817;      55
2796;T001235;GM0569;2018;   11298;    8077;    3146;    2377;     769;      75
2797;T001235;GM0569;2019;   11361;    8223;    3125;    2382;     743;      13
2798;T001235;GM0569;2020;   11498;    8320;    3158;    2412;     746;      20
2799;T001235;GM0571;2012;    3467;    1965;    1447;    1308;     139;      55
2800;T001235;GM0571;2013;;;;;;
2801;T001235;GM0571;2014;;;;;;
2802;T001235;GM0571;2015;;;;;;
2803;T001235;GM0571;2016;;;;;;
2804;T001235;GM0571;2017;;;;;;
2805;T001235;GM0571;2018;;;;;;
2806;T001235;GM0571;2019;;;;;;
2807;T001235;GM0571;2020;;;;;;
2808;T001235;GM0267;2012;   15519;   10568;    4921;    3260;    1661;      30
2809;T001235;GM0267;2013;   15676;   10670;    4996;    3813;    1183;      10
2810;T001235;GM0267;2014;   15773;   10732;    5025;    3814;    1211;      16
2811;T001235;GM0267;2015;   15922;   10876;    5027;    3797;    1230;      19
2812;T001235;GM0267;2016;   16131;   11021;    5093;    3810;    1283;      17
2813;T001235;GM0267;2017;   16344;   11144;    5161;    3869;    1292;      39
2814;T001235;GM0267;2018;   16669;   11347;    5219;    3908;    1311;     103
2815;T001235;GM0267;2019;   17125;   11956;    5157;    3997;    1160;      12
2816;T001235;GM0267;2020;   17321;   12106;    5196;    4003;    1193;      19
2817;T001235;GM0268;2012;   74162;   31000;   41750;   30538;   11212;    1412
2818;T001235;GM0268;2013;   76518;   31280;   42726;   30807;   11919;    2512
2819;T001235;GM0268;2014;   77248;   31382;   43204;   30725;   12479;    2662
2820;T001235;GM0268;2015;   78678;   31812;   46066;   33634;   12432;     800
2821;T001235;GM0268;2016;   79593;   32304;   46395;   33953;   12442;     894
2822;T001235;GM0268;2017;   78200;   32753;   44429;   31882;   12547;    1018
2823;T001235;GM0268;2018;   79473;   34065;   44640;   32064;   12576;     768
2824;T001235;GM0268;2019;   80710;   35056;   45326;   32259;   13067;     328
2825;T001235;GM0268;2020;   81717;   35519;   45772;   32312;   13460;     426
2826;T001235;GM1930;2012;;;;;;
2827;T001235;GM1930;2013;;;;;;
2828;T001235;GM1930;2014;;;;;;
2829;T001235;GM1930;2015;   38989;   22097;   16872;   14929;    1943;      20
2830;T001235;GM1930;2016;   39083;   22265;   16802;   14605;    2197;      16
2831;T001235;GM1930;2017;   39192;   22309;   16809;   14946;    1863;      74
2832;T001235;GM1930;2018;   38830;   21989;   16763;   14882;    1881;      78
2833;T001235;GM1930;2019;   39036;   22603;   16409;   14819;    1590;      24
2834;T001235;GM1930;2020;   39225;   22736;   16467;   14795;    1672;      22
2835;T001235;GM1970;2012;;;;;;
2836;T001235;GM1970;2013;;;;;;
2837;T001235;GM1970;2014;;;;;;
2838;T001235;GM1970;2015;;;;;;
2839;T001235;GM1970;2016;;;;;;
2840;T001235;GM1970;2017;;;;;;
2841;T001235;GM1970;2018;;;;;;
2842;T001235;GM1970;2019;   20395;   13636;    6634;    5081;    1553;     125
2843;T001235;GM1970;2020;   20630;   13694;    6800;    5087;    1713;     136
2844;T001235;GM1695;2012;    4103;    2703;    1396;     636;     760;       4
2845;T001235;GM1695;2013;    4096;    2733;    1361;     635;     726;       2
2846;T001235;GM1695;2014;    4168;    2765;    1385;     643;     742;      18
2847;T001235;GM1695;2015;    4324;    2798;    1501;     651;     850;      25
2848;T001235;GM1695;2016;    4347;    2817;    1498;     653;     845;      32
2849;T001235;GM1695;2017;    4361;    2818;    1536;     646;     890;       7
2850;T001235;GM1695;2018;    4394;    2861;    1526;     652;     874;       7
2851;T001235;GM1695;2019;    4400;    3067;    1058;     615;     443;     275
2852;T001235;GM1695;2020;    4460;    3092;    1058;     612;     446;     310
2853;T001235;GM1699;2012;   14094;    9993;    4001;    2467;    1534;     100
2854;T001235;GM1699;2013;   14204;   10106;    4033;    2491;    1542;      65
2855;T001235;GM1699;2014;   14516;   10204;    4105;    2500;    1605;     207
2856;T001235;GM1699;2015;   14558;   10244;    4097;    2490;    1607;     217
2857;T001235;GM1699;2016;   14555;   10217;    4130;    2833;    1297;     208
2858;T001235;GM1699;2017;   14630;   10326;    4091;    2848;    1243;     213
2859;T001235;GM1699;2018;   14649;   10314;    4123;    2829;    1294;     212
2860;T001235;GM1699;2019;   14716;   10458;    4204;    2826;    1378;      54
2861;T001235;GM1699;2020;   14817;   10494;    4176;    2856;    1320;     147
2862;T001235;GM0171;2012;   18759;   12429;    6282;    5140;    1142;      48
2863;T001235;GM0171;2013;   18928;   12536;    6318;    5117;    1201;      74
2864;T001235;GM0171;2014;   19357;   12566;    6636;    5086;    1550;     155
2865;T001235;GM0171;2015;   19493;   12583;    6674;    5030;    1644;     236
2866;T001235;GM0171;2016;   19583;   12663;    6654;    5026;    1628;     266
2867;T001235;GM0171;2017;   19535;   12533;    6754;    4897;    1857;     248
2868;T001235;GM0171;2018;   19786;   12776;    6737;    4981;    1756;     273
2869;T001235;GM0171;2019;   20018;   13080;    6930;    4948;    1982;       8
2870;T001235;GM0171;2020;   20134;   13173;    6949;    4920;    2029;      12
2871;T001235;GM0575;2012;   12847;    8036;    4414;    2261;    2153;     397
2872;T001235;GM0575;2013;   12921;    8024;    4598;    2259;    2339;     299
2873;T001235;GM0575;2014;   12154;    7577;    4289;    2256;    2033;     288
2874;T001235;GM0575;2015;   12058;    7617;    4153;    2258;    1895;     288
2875;T001235;GM0575;2016;   12267;    7670;    4161;    2237;    1924;     436
2876;T001235;GM0575;2017;   12309;    7641;    4203;    2223;    1980;     465
2877;T001235;GM0575;2018;   12389;    7726;    4224;    2230;    1994;     439
2878;T001235;GM0575;2019;   19688;   12382;    7070;    4249;    2821;     236
2879;T001235;GM0575;2020;   19930;   12555;    7149;    4241;    2908;     226
2880;T001235;GM0576;2012;    6427;    3955;    2450;    1790;     660;      22
2881;T001235;GM0576;2013;    6542;    4037;    2498;    1905;     593;       7
2882;T001235;GM0576;2014;    6867;    4102;    2624;    1983;     641;     141
2883;T001235;GM0576;2015;    6922;    4163;    2687;    2034;     653;      72
2884;T001235;GM0576;2016;    6942;    4200;    2601;    1911;     690;     141
2885;T001235;GM0576;2017;    7156;    4310;    2707;    1935;     772;     139
2886;T001235;GM0576;2018;    7115;    4354;    2608;    1908;     700;     153
2887;T001235;GM0576;2019;;;;;;
2888;T001235;GM0576;2020;;;;;;
2889;T001235;GM0820;2012;    9449;    7115;    2325;    1521;     804;       9
2890;T001235;GM0820;2013;    9867;    7348;    2508;    1642;     866;      11
2891;T001235;GM0820;2014;    9881;    7332;    2538;    1633;     905;      11
2892;T001235;GM0820;2015;    9918;    7342;    2560;    1639;     921;      16
2893;T001235;GM0820;2016;   10017;    7360;    2639;    1657;     982;      18
2894;T001235;GM0820;2017;   10032;    7393;    2620;    1640;     980;      19
2895;T001235;GM0820;2018;   10131;    7596;    2491;    1638;     853;      44
2896;T001235;GM0820;2019;   10165;    7682;    2466;    1634;     832;      17
2897;T001235;GM0820;2020;   10285;    7721;    2548;    1651;     897;      16
2898;T001235;GM0302;2012;   10167;    6410;    3593;    2453;    1140;     164
2899;T001235;GM0302;2013;   10354;    6434;    3722;    2500;    1222;     198
2900;T001235;GM0302;2014;   10208;    6397;    3698;    2458;    1240;     113
2901;T001235;GM0302;2015;   10386;    6503;    3784;    2603;    1181;      99
2902;T001235;GM0302;2016;   10449;    6548;    3760;    2556;    1204;     141
2903;T001235;GM0302;2017;   10463;    6578;    3731;    2540;    1191;     154
2904;T001235;GM0302;2018;   10611;    6864;    3610;    2559;    1051;     137
2905;T001235;GM0302;2019;   10851;    7048;    3744;    2630;    1114;      59
2906;T001235;GM0302;2020;   10957;    7152;    3735;    2622;    1113;      70
2907;T001235;GM0951;2012;    6815;    4840;    1948;    1426;     522;      27
2908;T001235;GM0951;2013;    6906;    4925;    1972;    1416;     556;       9
2909;T001235;GM0951;2014;    6911;    4944;    1957;    1367;     590;      10
2910;T001235;GM0951;2015;    6941;    4961;    1970;    1381;     589;      10
2911;T001235;GM0951;2016;    6947;    4957;    1984;    1364;     620;       6
2912;T001235;GM0951;2017;    6953;    4946;    1997;    1350;     647;      10
2913;T001235;GM0951;2018;    6956;    5025;    1920;    1329;     591;      11
2914;T001235;GM0951;2019;;;;;;
2915;T001235;GM0951;2020;;;;;;
2916;T001235;GM0579;2012;    9822;    6932;    2737;    1813;     924;     153
2917;T001235;GM0579;2013;   10010;    7076;    2789;    1820;     969;     145
2918;T001235;GM0579;2014;   10269;    7147;    2859;    1729;    1130;     263
2919;T001235;GM0579;2015;   10366;    7285;    2882;    1804;    1078;     199
2920;T001235;GM0579;2016;   10379;    7372;    2903;    1793;    1110;     104
2921;T001235;GM0579;2017;   10459;    7457;    2899;    1747;    1152;     103
2922;T001235;GM0579;2018;   10475;    7382;    2989;    1749;    1240;     104
2923;T001235;GM0579;2019;   10691;    7684;    2910;    1751;    1159;      97
2924;T001235;GM0579;2020;   10862;    7744;    3082;    1757;    1325;      36
2925;T001235;GM0823;2012;    6913;    5435;    1453;     951;     502;      25
2926;T001235;GM0823;2013;    6906;    5431;    1468;     959;     509;       7
2927;T001235;GM0823;2014;    6936;    5418;    1511;     952;     559;       7
2928;T001235;GM0823;2015;    7031;    5491;    1531;     969;     562;       9
2929;T001235;GM0823;2016;    7437;    5776;    1646;     988;     658;      15
2930;T001235;GM0823;2017;    7650;    5808;    1664;     988;     676;     178
2931;T001235;GM0823;2018;    7728;    5911;    1652;    1017;     635;     165
2932;T001235;GM0823;2019;    7861;    6006;    1841;    1016;     825;      14
2933;T001235;GM0823;2020;    7965;    6078;    1868;    1023;     845;      19
2934;T001235;GM0824;2012;   10767;    7294;    3405;    2332;    1073;      68
2935;T001235;GM0824;2013;   11036;    7356;    3561;    2424;    1137;     119
2936;T001235;GM0824;2014;   11108;    7394;    3610;    2355;    1255;     104
2937;T001235;GM0824;2015;   11091;    7390;    3603;    2415;    1188;      98
2938;T001235;GM0824;2016;   11178;    7417;    3662;    2425;    1237;      99
2939;T001235;GM0824;2017;   11265;    7501;    3673;    2436;    1237;      91
2940;T001235;GM0824;2018;   11439;    7763;    3496;    2453;    1043;     180
2941;T001235;GM0824;2019;   11567;    7930;    3610;    2442;    1168;      27
2942;T001235;GM0824;2020;   11619;    7939;    3625;    2442;    1183;      55
2943;T001235;GM1895;2012;   18090;   11462;    6430;    4953;    1477;     198
2944;T001235;GM1895;2013;   18073;   11485;    6502;    4943;    1559;      86
2945;T001235;GM1895;2014;   18100;   11457;    6591;    4905;    1686;      52
2946;T001235;GM1895;2015;   18287;   11432;    6807;    5097;    1710;      48
2947;T001235;GM1895;2016;   18396;   11431;    6899;    5133;    1766;      66
2948;T001235;GM1895;2017;   18382;   11379;    6933;    5095;    1838;      70
2949;T001235;GM1895;2018;   18382;   11530;    6786;    5055;    1731;      66
2950;T001235;GM1895;2019;   18462;   11774;    6653;    5051;    1602;      35
2951;T001235;GM1895;2020;   18540;   11802;    6703;    5035;    1668;      35
2952;T001235;GM0269;2012;    8610;    5880;    2691;    2078;     613;      39
2953;T001235;GM0269;2013;    8766;    6029;    2713;    2050;     663;      24
2954;T001235;GM0269;2014;    8894;    6067;    2740;    2068;     672;      87
2955;T001235;GM0269;2015;    8982;    6129;    2765;    2152;     613;      88
2956;T001235;GM0269;2016;    9090;    6198;    2713;    2143;     570;     179
2957;T001235;GM0269;2017;    9163;    6254;    2770;    2132;     638;     139
2958;T001235;GM0269;2018;    9202;    6335;    2760;    2114;     646;     107
2959;T001235;GM0269;2019;    9265;    6320;    2920;    2177;     743;      25
2960;T001235;GM0269;2020;    9318;    6376;    2920;    2179;     741;      22
2961;T001235;GM0173;2012;   13948;    8570;    5352;    4373;     979;      26
2962;T001235;GM0173;2013;   13986;    8604;    5360;    4380;     980;      22
2963;T001235;GM0173;2014;   14204;    8576;    5395;    4344;    1051;     233
2964;T001235;GM0173;2015;   14227;    8641;    5357;    4332;    1025;     229
2965;T001235;GM0173;2016;   14284;    8613;    5416;    4340;    1076;     255
2966;T001235;GM0173;2017;   14311;    8581;    5459;    4332;    1127;     271
2967;T001235;GM0173;2018;   14402;    8833;    5389;    4317;    1072;     180
2968;T001235;GM0173;2019;   14434;    8900;    5518;    4314;    1204;      16
2969;T001235;GM0173;2020;   14614;    9032;    5569;    4310;    1259;      13
2970;T001235;GM1773;2012;    7066;    4860;    2169;    1658;     511;      37
2971;T001235;GM1773;2013;    7212;    4907;    2285;    1769;     516;      20
2972;T001235;GM1773;2014;    7200;    4937;    2242;    1723;     519;      21
2973;T001235;GM1773;2015;    7302;    5001;    2280;    1760;     520;      21
2974;T001235;GM1773;2016;    7448;    5040;    2300;    1738;     562;     108
2975;T001235;GM1773;2017;    7529;    5024;    2395;    1739;     656;     110
2976;T001235;GM1773;2018;    7613;    5169;    2424;    1779;     645;      20
2977;T001235;GM1773;2019;    7669;    5277;    2381;    1763;     618;      11
2978;T001235;GM1773;2020;    7724;    5324;    2394;    1757;     637;       6
2979;T001235;GM0175;2012;    8137;    5500;    2344;    1258;    1086;     293
2980;T001235;GM0175;2013;    8135;    5469;    2397;    1258;    1139;     269
2981;T001235;GM0175;2014;    6933;    4700;    2085;    1262;     823;     148
2982;T001235;GM0175;2015;    6831;    4704;    2080;    1253;     827;      47
2983;T001235;GM0175;2016;    7108;    4864;    2191;    1244;     947;      53
2984;T001235;GM0175;2017;    7184;    4929;    2201;    1231;     970;      54
2985;T001235;GM0175;2018;    7289;    5131;    2104;    1229;     875;      54
2986;T001235;GM0175;2019;    7429;    5204;    2193;    1362;     831;      32
2987;T001235;GM0175;2020;    7519;    5278;    2226;    1355;     871;      15
2988;T001235;GM0881;2012;    3658;    2608;     987;     655;     332;      63
2989;T001235;GM0881;2013;    3658;    2607;     992;     646;     346;      59
2990;T001235;GM0881;2014;    3636;    2626;     976;     635;     341;      34
2991;T001235;GM0881;2015;    3640;    2636;     966;     632;     334;      38
2992;T001235;GM0881;2016;    3645;    2637;     972;     631;     341;      36
2993;T001235;GM0881;2017;    3654;    2633;     987;     637;     350;      34
2994;T001235;GM0881;2018;    3655;    2649;     981;     637;     344;      25
2995;T001235;GM0881;2019;;;;;;
2996;T001235;GM0881;2020;;;;;;
2997;T001235;GM1586;2012;   12288;    9095;    3142;    1989;    1153;      51
2998;T001235;GM1586;2013;   12434;    9190;    3200;    2002;    1198;      44
2999;T001235;GM1586;2014;   12587;    9177;    3366;    1978;    1388;      44
3000;T001235;GM1586;2015;   12654;    9254;    3373;    1991;    1382;      27
3001;T001235;GM1586;2016;   12692;    9252;    3414;    1975;    1439;      26
3002;T001235;GM1586;2017;   12751;    9261;    3463;    1967;    1496;      27
3003;T001235;GM1586;2018;   12787;    9494;    3275;    1965;    1310;      18
3004;T001235;GM1586;2019;   12854;    9590;    3262;    1974;    1288;       2
3005;T001235;GM1586;2020;   12910;    9605;    3293;    1960;    1333;      12
3006;T001235;GM0826;2012;   23318;   13693;    9519;    7832;    1687;     106
3007;T001235;GM0826;2013;   23337;   13706;    9546;    7801;    1745;      85
3008;T001235;GM0826;2014;   23788;   13936;    9633;    7895;    1738;     219
3009;T001235;GM0826;2015;   24141;   14120;    9732;    7873;    1859;     289
3010;T001235;GM0826;2016;   24248;   14217;    9755;    7891;    1864;     276
3011;T001235;GM0826;2017;   24441;   14291;    9874;    7998;    1876;     276
3012;T001235;GM0826;2018;   24665;   14305;   10082;    7987;    2095;     278
3013;T001235;GM0826;2019;   25115;   15085;    9928;    8267;    1661;     102
3014;T001235;GM0826;2020;   25158;   15198;    9858;    8188;    1670;     102
3015;T001235;GM0580;2012;    4247;    2520;    1695;    1529;     166;      32
3016;T001235;GM0580;2013;;;;;;
3017;T001235;GM0580;2014;;;;;;
3018;T001235;GM0580;2015;;;;;;
3019;T001235;GM0580;2016;;;;;;
3020;T001235;GM0580;2017;;;;;;
3021;T001235;GM0580;2018;;;;;;
3022;T001235;GM0580;2019;;;;;;
3023;T001235;GM0580;2020;;;;;;
3024;T001235;GM0085;2012;   11137;    7225;    3872;    3182;     690;      40
3025;T001235;GM0085;2013;   11160;    7245;    3883;    3185;     698;      32
3026;T001235;GM0085;2014;   11158;    7212;    3920;    3171;     749;      26
3027;T001235;GM0085;2015;   11154;    7246;    3888;    3151;     737;      20
3028;T001235;GM0085;2016;   11172;    7280;    3875;    3117;     758;      17
3029;T001235;GM0085;2017;   11202;    7270;    3918;    3130;     788;      14
3030;T001235;GM0085;2018;   11247;    7388;    3833;    3122;     711;      26
3031;T001235;GM0085;2019;   11303;    7549;    3735;    3099;     636;      19
3032;T001235;GM0085;2020;   11253;    7567;    3663;    3046;     617;      23
3033;T001235;GM0431;2012;    3890;    2514;    1236;    1032;     204;     140
3034;T001235;GM0431;2013;    3981;    2533;    1303;    1097;     206;     145
3035;T001235;GM0431;2014;    3878;    2532;    1310;    1099;     211;      36
3036;T001235;GM0431;2015;    3932;    2541;    1355;    1141;     214;      36
3037;T001235;GM0431;2016;    4048;    2640;    1370;    1118;     252;      38
3038;T001235;GM0431;2017;    4068;    2652;    1380;    1132;     248;      36
3039;T001235;GM0431;2018;    4093;    2721;    1334;    1132;     202;      38
3040;T001235;GM0431;2019;    4099;    2757;    1341;    1138;     203;       1
3041;T001235;GM0431;2020;    4108;    2763;    1344;    1138;     206;       1
3042;T001235;GM0432;2012;    4562;    3423;    1129;      64;    1065;      10
3043;T001235;GM0432;2013;    4564;    3415;    1147;      64;    1083;       2
3044;T001235;GM0432;2014;    4606;    3420;    1147;      64;    1083;      39
3045;T001235;GM0432;2015;    4629;    3446;    1139;      64;    1075;      44
3046;T001235;GM0432;2016;    4680;    3456;    1177;      64;    1113;      47
3047;T001235;GM0432;2017;    4713;    3483;    1179;      64;    1115;      51
3048;T001235;GM0432;2018;    4747;    3551;    1149;      64;    1085;      47
3049;T001235;GM0432;2019;    4783;    3634;    1148;      68;    1080;       1
3050;T001235;GM0432;2020;    4852;    3691;    1160;      28;    1132;       1
3051;T001235;GM0086;2012;   12520;    8780;    3700;    3077;     623;      40
3052;T001235;GM0086;2013;   12460;    8842;    3607;    3011;     596;      11
3053;T001235;GM0086;2014;   12709;    8850;    3642;    3018;     624;     217
3054;T001235;GM0086;2015;   12716;    8876;    3622;    2991;     631;     218
3055;T001235;GM0086;2016;   12873;    8874;    3603;    2928;     675;     396
3056;T001235;GM0086;2017;   12926;    8880;    3648;    2918;     730;     398
3057;T001235;GM0086;2018;   13009;    8983;    3617;    2899;     718;     409
3058;T001235;GM0086;2019;   12987;    9128;    3837;    2941;     896;      22
3059;T001235;GM0086;2020;   13064;    9171;    3867;    2908;     959;      26
3060;T001235;GM0828;2012;   35396;   22380;   12887;   10306;    2581;     129
3061;T001235;GM0828;2013;   35747;   22519;   13141;   10411;    2730;      87
3062;T001235;GM0828;2014;   36290;   22587;   13296;   10398;    2898;     407
3063;T001235;GM0828;2015;   38519;   24082;   14004;   10730;    3274;     433
3064;T001235;GM0828;2016;   38831;   24262;   14129;   10879;    3250;     440
3065;T001235;GM0828;2017;   39130;   24284;   14376;   10889;    3487;     470
3066;T001235;GM0828;2018;   39505;   24815;   14171;   10944;    3227;     519
3067;T001235;GM0828;2019;   39955;   25184;   14741;   11269;    3472;      30
3068;T001235;GM0828;2020;   40325;   25430;   14815;   11267;    3548;      80
3069;T001235;GM0584;2012;    9515;    6324;    3168;    2619;     549;      23
3070;T001235;GM0584;2013;    9522;    6330;    3174;    2610;     564;      18
3071;T001235;GM0584;2014;    9745;    6395;    3329;    2770;     559;      21
3072;T001235;GM0584;2015;    9827;    6431;    3369;    2795;     574;      27
3073;T001235;GM0584;2016;    9940;    6558;    3336;    2797;     539;      46
3074;T001235;GM0584;2017;   10122;    6643;    3449;    2859;     590;      30
3075;T001235;GM0584;2018;   10187;    6794;    3355;    2843;     512;      38
3076;T001235;GM0584;2019;;;;;;
3077;T001235;GM0584;2020;;;;;;
3078;T001235;GM1509;2012;   16689;   11014;    5327;    4083;    1244;     348
3079;T001235;GM1509;2013;   17252;   11250;    5656;    4270;    1386;     346
3080;T001235;GM1509;2014;   17277;   11280;    5655;    4218;    1437;     342
3081;T001235;GM1509;2015;   17240;   11319;    5597;    4245;    1352;     324
3082;T001235;GM1509;2016;   17218;   11330;    5582;    4190;    1392;     306
3083;T001235;GM1509;2017;   17225;   11335;    5593;    4182;    1411;     297
3084;T001235;GM1509;2018;   17267;   11376;    5600;    4194;    1406;     291
3085;T001235;GM1509;2019;   17385;   11377;    5988;    4271;    1717;      20
3086;T001235;GM1509;2020;   17401;   11418;    5962;    4299;    1663;      21
3087;T001235;GM0437;2012;    5733;    3219;    2504;    1819;     685;      10
3088;T001235;GM0437;2013;    5752;    3222;    2515;    1824;     691;      15
3089;T001235;GM0437;2014;    5775;    3237;    2531;    1812;     719;       7
3090;T001235;GM0437;2015;    5781;    3268;    2498;    1808;     690;      15
3091;T001235;GM0437;2016;    5851;    3327;    2509;    1813;     696;      15
3092;T001235;GM0437;2017;    5851;    3334;    2501;    1811;     690;      16
3093;T001235;GM0437;2018;    5897;    3396;    2478;    1810;     668;      23
3094;T001235;GM0437;2019;    6155;    3464;    2682;    1987;     695;       9
3095;T001235;GM0437;2020;    6296;    3459;    2825;    1990;     835;      12
3096;T001235;GM0644;2012;    3188;    2155;    1018;     798;     220;      15
3097;T001235;GM0644;2013;    3249;    2205;    1039;     791;     248;       5
3098;T001235;GM0644;2014;    3265;    2243;    1020;     820;     200;       2
3099;T001235;GM0644;2015;;;;;;
3100;T001235;GM0644;2016;;;;;;
3101;T001235;GM0644;2017;;;;;;
3102;T001235;GM0644;2018;;;;;;
3103;T001235;GM0644;2019;;;;;;
3104;T001235;GM0644;2020;;;;;;
3105;T001235;GM0589;2012;    3989;    2839;    1145;     895;     250;       5
3106;T001235;GM0589;2013;    4073;    2881;    1186;     936;     250;       6
3107;T001235;GM0589;2014;    4147;    2876;    1206;     926;     280;      65
3108;T001235;GM0589;2015;    4177;    2890;    1224;     911;     313;      63
3109;T001235;GM0589;2016;    4270;    2907;    1301;     959;     342;      62
3110;T001235;GM0589;2017;    4322;    2969;    1288;     953;     335;      65
3111;T001235;GM0589;2018;    4315;    2999;    1242;     921;     321;      74
3112;T001235;GM0589;2019;    4338;    3000;    1330;     981;     349;       8
3113;T001235;GM0589;2020;    4372;    3005;    1361;    1011;     350;       6
3114;T001235;GM1734;2012;   18190;   12303;    5859;    4383;    1476;      28
3115;T001235;GM1734;2013;   18388;   12465;    5897;    4378;    1519;      26
3116;T001235;GM1734;2014;   18517;   12519;    5976;    4366;    1610;      22
3117;T001235;GM1734;2015;   18838;   12599;    6044;    4278;    1766;     195
3118;T001235;GM1734;2016;   19251;   12762;    6301;    4276;    2025;     188
3119;T001235;GM1734;2017;   19390;   12725;    6466;    4297;    2169;     199
3120;T001235;GM1734;2018;   19486;   12981;    6310;    4275;    2035;     195
3121;T001235;GM1734;2019;   19702;   13444;    6198;    4401;    1797;      60
3122;T001235;GM1734;2020;   19947;   13570;    6312;    4412;    1900;      65
3123;T001235;GM0590;2012;   13938;    8788;    5135;    4183;     952;      15
3124;T001235;GM0590;2013;   14036;    8876;    5153;    4169;     984;       7
3125;T001235;GM0590;2014;   14088;    8962;    5117;    4170;     947;       9
3126;T001235;GM0590;2015;   14181;    8973;    5125;    4184;     941;      83
3127;T001235;GM0590;2016;   14251;    9019;    5148;    4190;     958;      84
3128;T001235;GM0590;2017;   14289;    9049;    5158;    4183;     975;      82
3129;T001235;GM0590;2018;   14331;    9186;    5058;    4177;     881;      87
3130;T001235;GM0590;2019;   14383;    9304;    5007;    4170;     837;      72
3131;T001235;GM0590;2020;   14397;    9320;    5010;    4171;     839;      67
3132;T001235;GM1894;2012;   17198;   12366;    4691;    3621;    1070;     141
3133;T001235;GM1894;2013;   17410;   12348;    4920;    3650;    1270;     142
3134;T001235;GM1894;2014;   17796;   12583;    4866;    3693;    1173;     347
3135;T001235;GM1894;2015;   18001;   12620;    5009;    3769;    1240;     372
3136;T001235;GM1894;2016;   17898;   12664;    5033;    3805;    1228;     201
3137;T001235;GM1894;2017;   18059;   12783;    5095;    3827;    1268;     181
3138;T001235;GM1894;2018;   18151;   12953;    5031;    3546;    1485;     167
3139;T001235;GM1894;2019;   18302;   13268;    5002;    3772;    1230;      32
3140;T001235;GM1894;2020;   18399;   13383;    4983;    3681;    1302;      33
3141;T001235;GM0765;2012;    5648;    3689;    1926;    1512;     414;      33
3142;T001235;GM0765;2013;    5649;    3661;    1958;    1511;     447;      30
3143;T001235;GM0765;2014;    5776;    3691;    2057;    1503;     554;      28
3144;T001235;GM0765;2015;    5775;    3674;    2064;    1617;     447;      37
3145;T001235;GM0765;2016;    5777;    3637;    2103;    1520;     583;      37
3146;T001235;GM0765;2017;    5776;    3629;    2110;    1516;     594;      37
3147;T001235;GM0765;2018;    5755;    3594;    2132;    1523;     609;      29
3148;T001235;GM0765;2019;    5767;    3686;    2072;    1634;     438;       9
3149;T001235;GM0765;2020;    5774;    3652;    2118;    1641;     477;       4
3150;T001235;GM1926;2012;   19154;   13406;    5676;    4288;    1388;      72
3151;T001235;GM1926;2013;   19367;   13511;    5768;    4342;    1426;      88
3152;T001235;GM1926;2014;   19663;   13566;    5988;    4406;    1582;     109
3153;T001235;GM1926;2015;   19721;   13640;    5941;    4359;    1582;     140
3154;T001235;GM1926;2016;   20135;   13979;    6046;    4329;    1717;     110
3155;T001235;GM1926;2017;   20414;   14198;    6109;    4303;    1806;     107
3156;T001235;GM1926;2018;   20810;   14467;    6230;    4258;    1972;     113
3157;T001235;GM1926;2019;   21134;   15086;    6041;    4243;    1798;       7
3158;T001235;GM1926;2020;   21536;   15327;    6204;    4321;    1883;       5
3159;T001235;GM0439;2012;   34901;   20221;   14515;   12541;    1974;     165
3160;T001235;GM0439;2013;   34893;   20341;   14436;   12448;    1988;     116
3161;T001235;GM0439;2014;   35119;   20438;   14555;   12500;    2055;     126
3162;T001235;GM0439;2015;   35353;   20693;   14596;   12735;    1861;      64
3163;T001235;GM0439;2016;   35581;   20834;   14605;   12228;    2377;     142
3164;T001235;GM0439;2017;   35631;   20797;   14689;   12185;    2504;     145
3165;T001235;GM0439;2018;   35751;   20932;   14661;   12273;    2388;     158
3166;T001235;GM0439;2019;   36141;   21410;   14723;   12638;    2085;       8
3167;T001235;GM0439;2020;   36701;   21712;   14974;   12531;    2443;      15
3168;T001235;GM0273;2012;    9825;    6701;    2965;    1900;    1065;     159
3169;T001235;GM0273;2013;    9381;    6320;    2953;    1962;     991;     108
3170;T001235;GM0273;2014;    9494;    6338;    3030;    1964;    1066;     126
3171;T001235;GM0273;2015;    9569;    6378;    3070;    1998;    1072;     121
3172;T001235;GM0273;2016;    9628;    6429;    3077;    2012;    1065;     122
3173;T001235;GM0273;2017;    9649;    6435;    3098;    2015;    1083;     116
3174;T001235;GM0273;2018;    9655;    6462;    3080;    2053;    1027;     113
3175;T001235;GM0273;2019;    9670;    6517;    3118;    2098;    1020;      35
3176;T001235;GM0273;2020;    9727;    6532;    3161;    2095;    1066;      34
3177;T001235;GM0177;2012;   15227;   10185;    4941;    3594;    1347;     101
3178;T001235;GM0177;2013;   15384;   10312;    5010;    3605;    1405;      62
3179;T001235;GM0177;2014;   15464;   10348;    5051;    3615;    1436;      65
3180;T001235;GM0177;2015;   15231;   10191;    4974;    3721;    1253;      66
3181;T001235;GM0177;2016;   15301;   10335;    4903;    3721;    1182;      63
3182;T001235;GM0177;2017;   15359;   10310;    4991;    3702;    1289;      58
3183;T001235;GM0177;2018;   15589;   10526;    5015;    3721;    1294;      48
3184;T001235;GM0177;2019;   15759;   10839;    4892;    3821;    1071;      28
3185;T001235;GM0177;2020;   15902;   10965;    4904;    3803;    1101;      33
3186;T001235;GM0703;2012;    8662;    5909;    2726;    2167;     559;      27
3187;T001235;GM0703;2013;    8709;    5949;    2738;    2160;     578;      22
3188;T001235;GM0703;2014;    8889;    5963;    2755;    2170;     585;     171
3189;T001235;GM0703;2015;    8916;    6011;    2703;    2176;     527;     202
3190;T001235;GM0703;2016;    8996;    6056;    2737;    2182;     555;     203
3191;T001235;GM0703;2017;    8994;    6062;    2731;    2106;     625;     201
3192;T001235;GM0703;2018;    9049;    6183;    2674;    2092;     582;     192
3193;T001235;GM0703;2019;    9159;    6317;    2707;    2106;     601;     135
3194;T001235;GM0703;2020;    9298;    6404;    2751;    2095;     656;     143
3195;T001235;GM0274;2012;   14486;    9054;    5170;    3074;    2096;     262
3196;T001235;GM0274;2013;   14565;    9015;    5392;    3103;    2289;     158
3197;T001235;GM0274;2014;   14648;    9023;    5456;    3105;    2351;     169
3198;T001235;GM0274;2015;   14658;    8997;    5496;    3129;    2367;     165
3199;T001235;GM0274;2016;   14626;    8998;    5530;    3152;    2378;      98
3200;T001235;GM0274;2017;   14653;    8991;    5565;    3089;    2476;      97
3201;T001235;GM0274;2018;   14763;    9146;    5517;    3144;    2373;     100
3202;T001235;GM0274;2019;   14908;    9365;    5504;    3126;    2378;      39
3203;T001235;GM0274;2020;   14985;    9399;    5503;    3160;    2343;      83
3204;T001235;GM0339;2012;    1751;    1264;     462;       0;     462;      25
3205;T001235;GM0339;2013;    1826;    1328;     485;       0;     485;      13
3206;T001235;GM0339;2014;    1839;    1348;     482;       0;     482;       9
3207;T001235;GM0339;2015;    1837;    1356;     479;       0;     479;       2
3208;T001235;GM0339;2016;    1885;    1384;     500;       0;     500;       1
3209;T001235;GM0339;2017;    1904;    1394;     509;       0;     509;       1
3210;T001235;GM0339;2018;    1999;    1469;     529;       0;     529;       1
3211;T001235;GM0339;2019;    2017;    1500;     509;       0;     509;       8
3212;T001235;GM0339;2020;    2134;    1571;     555;       0;     555;       8
3213;T001235;GM1667;2012;    5021;    3909;    1099;     670;     429;      13
3214;T001235;GM1667;2013;    5086;    3948;    1130;     720;     410;       8
3215;T001235;GM1667;2014;    5178;    3966;    1175;     709;     466;      37
3216;T001235;GM1667;2015;    5255;    4043;    1173;     685;     488;      39
3217;T001235;GM1667;2016;    5275;    4085;    1112;     702;     410;      78
3218;T001235;GM1667;2017;    5344;    4124;    1139;     704;     435;      81
3219;T001235;GM1667;2018;    5385;    4197;    1106;     709;     397;      82
3220;T001235;GM1667;2019;    5422;    4213;    1205;     721;     484;       4
3221;T001235;GM1667;2020;    5484;    4264;    1214;     734;     480;       6
3222;T001235;GM0275;2012;   20190;   10990;    9061;    6154;    2907;     139
3223;T001235;GM0275;2013;   20335;   11029;    9171;    6235;    2936;     135
3224;T001235;GM0275;2014;   20909;   11008;    9380;    6061;    3319;     521
3225;T001235;GM0275;2015;   20931;   10996;    9415;    6004;    3411;     520
3226;T001235;GM0275;2016;   20970;   11021;    9379;    6086;    3293;     570
3227;T001235;GM0275;2017;   21117;   11012;    9524;    6250;    3274;     581
3228;T001235;GM0275;2018;   21088;   11342;    9168;    6193;    2975;     578
3229;T001235;GM0275;2019;   21189;   11611;    9326;    6199;    3127;     252
3230;T001235;GM0275;2020;   21212;   11641;    9303;    6170;    3133;     268
3231;T001235;GM0340;2012;    7491;    4749;    2715;    2098;     617;      27
3232;T001235;GM0340;2013;    7481;    4755;    2709;    2080;     629;      17
3233;T001235;GM0340;2014;    7602;    4756;    2765;    2110;     655;      81
3234;T001235;GM0340;2015;    7692;    4853;    2811;    2141;     670;      28
3235;T001235;GM0340;2016;    7755;    4881;    2839;    2158;     681;      35
3236;T001235;GM0340;2017;    7935;    5020;    2905;    2180;     725;      10
3237;T001235;GM0340;2018;    8034;    5131;    2877;    2203;     674;      26
3238;T001235;GM0340;2019;    8131;    5253;    2861;    2217;     644;      17
3239;T001235;GM0340;2020;    8225;    5332;    2872;    2221;     651;      21
3240;T001235;GM0597;2012;   19862;   10719;    9126;    7911;    1215;      17
3241;T001235;GM0597;2013;   20504;   10911;    9581;    8239;    1342;      12
3242;T001235;GM0597;2014;   20686;   10887;    9630;    8255;    1375;     169
3243;T001235;GM0597;2015;   20747;   10910;    9692;    8307;    1385;     145
3244;T001235;GM0597;2016;   20680;   11040;    9489;    8135;    1354;     151
3245;T001235;GM0597;2017;   20795;   11097;    9497;    8144;    1353;     201
3246;T001235;GM0597;2018;   21009;   11388;    9457;    8302;    1155;     164
3247;T001235;GM0597;2019;   21140;   11871;    9246;    8359;     887;      23
3248;T001235;GM0597;2020;   20960;   11891;    9045;    8141;     904;      24
3249;T001235;GM0196;2012;    4722;    2957;    1728;    1463;     265;      37
3250;T001235;GM0196;2013;    4726;    2942;    1754;    1460;     294;      30
3251;T001235;GM0196;2014;    4777;    2927;    1828;    1459;     369;      22
3252;T001235;GM0196;2015;    4790;    2920;    1845;    1460;     385;      25
3253;T001235;GM0196;2016;    4787;    2928;    1849;    1464;     385;      10
3254;T001235;GM0196;2017;    4795;    2949;    1835;    1459;     376;      11
3255;T001235;GM0196;2018;;;;;;
3256;T001235;GM0196;2019;;;;;;
3257;T001235;GM0196;2020;;;;;;
3258;T001235;GM1672;2012;    7399;    4864;    2497;    1789;     708;      38
3259;T001235;GM1672;2013;    7495;    4915;    2547;    1834;     713;      33
3260;T001235;GM1672;2014;;;;;;
3261;T001235;GM1672;2015;;;;;;
3262;T001235;GM1672;2016;;;;;;
3263;T001235;GM1672;2017;;;;;;
3264;T001235;GM1672;2018;;;;;;
3265;T001235;GM1672;2019;;;;;;
3266;T001235;GM1672;2020;;;;;;
3267;T001235;GM1742;2012;   13714;    9676;    4011;    3097;     914;      27
3268;T001235;GM1742;2013;   13855;    9739;    4011;    3096;     915;     105
3269;T001235;GM1742;2014;   14006;    9757;    4115;    3095;    1020;     134
3270;T001235;GM1742;2015;   14106;    9836;    4145;    3117;    1028;     125
3271;T001235;GM1742;2016;   14298;    9896;    4238;    3106;    1132;     164
3272;T001235;GM1742;2017;   14387;    9898;    4327;    3106;    1221;     162
3273;T001235;GM1742;2018;   14574;   10040;    4434;    3118;    1316;     100
3274;T001235;GM1742;2019;   14740;   10192;    4502;    3155;    1347;      46
3275;T001235;GM1742;2020;   14760;   10192;    4533;    3152;    1381;      35
3276;T001235;GM0603;2012;   24442;   11411;   12927;    8710;    4217;     104
3277;T001235;GM0603;2013;   24618;   11473;   13052;    8787;    4265;      93
3278;T001235;GM0603;2014;   24962;   11486;   13120;    8622;    4498;     356
3279;T001235;GM0603;2015;   25101;   11656;   13196;    8857;    4339;     249
3280;T001235;GM0603;2016;   25606;   11941;   13327;    8917;    4410;     338
3281;T001235;GM0603;2017;   25964;   12146;   13378;    8927;    4451;     440
3282;T001235;GM0603;2018;   26233;   12493;   13476;    8904;    4572;     264
3283;T001235;GM0603;2019;   26666;   13123;   13335;    9066;    4269;     208
3284;T001235;GM0603;2020;   26905;   13223;   13563;    9064;    4499;     119
3285;T001235;GM1669;2012;    9016;    6727;    2272;    1688;     584;      17
3286;T001235;GM1669;2013;    9203;    6850;    2324;    1679;     645;      29
3287;T001235;GM1669;2014;    9330;    6846;    2335;    1662;     673;     149
3288;T001235;GM1669;2015;    9382;    6896;    2332;    1657;     675;     154
3289;T001235;GM1669;2016;    9405;    6878;    2372;    1652;     720;     155
3290;T001235;GM1669;2017;    9410;    6861;    2399;    1631;     768;     150
3291;T001235;GM1669;2018;    9449;    6973;    2319;    1608;     711;     157
3292;T001235;GM1669;2019;    9463;    7008;    2438;    1637;     801;      17
3293;T001235;GM1669;2020;    9477;    7028;    2432;    1621;     811;      17
3294;T001235;GM0957;2012;   26531;   13967;   12348;    8721;    3627;     216
3295;T001235;GM0957;2013;   26670;   14018;   12518;    8767;    3751;     134
3296;T001235;GM0957;2014;   26832;   14368;   12282;    8764;    3518;     182
3297;T001235;GM0957;2015;   26992;   14440;   12369;    8839;    3530;     183
3298;T001235;GM0957;2016;   27111;   14448;   12535;    8832;    3703;     128
3299;T001235;GM0957;2017;   27140;   14523;   12497;    8791;    3706;     120
3300;T001235;GM0957;2018;   27276;   14605;   12552;    8599;    3953;     119
3301;T001235;GM0957;2019;   27465;   15046;   12341;    8569;    3772;      78
3302;T001235;GM0957;2020;   27649;   15152;   12351;    8458;    3893;     146
3303;T001235;GM0736;2012;   17836;   11496;    6179;    4379;    1800;     161
3304;T001235;GM0736;2013;   18048;   11689;    6229;    4344;    1885;     130
3305;T001235;GM0736;2014;   17586;   11352;    5981;    4335;    1646;     253
3306;T001235;GM0736;2015;   17570;   11428;    5937;    4304;    1633;     205
3307;T001235;GM0736;2016;   17608;   11467;    5944;    4285;    1659;     197
3308;T001235;GM0736;2017;   17786;   11397;    6121;    4231;    1890;     268
3309;T001235;GM0736;2018;   18145;   11807;    6121;    4319;    1802;     217
3310;T001235;GM0736;2019;   18332;   12108;    6201;    4407;    1794;      23
3311;T001235;GM0736;2020;   18517;   12207;    6287;    4405;    1882;      23
3312;T001235;GM1674;2012;   33879;   21395;   12308;    9748;    2560;     176
3313;T001235;GM1674;2013;   33869;   21537;   12213;    9687;    2526;     119
3314;T001235;GM1674;2014;   34091;   21425;   12550;    9753;    2797;     116
3315;T001235;GM1674;2015;   34437;   21483;   12849;    9976;    2873;     105
3316;T001235;GM1674;2016;   34718;   21463;   12926;    9910;    3016;     329
3317;T001235;GM1674;2017;   34962;   21460;   13183;    9964;    3219;     319
3318;T001235;GM1674;2018;   35103;   21302;   13453;    9855;    3598;     348
3319;T001235;GM1674;2019;   35188;   21993;   13105;    9902;    3203;      90
3320;T001235;GM1674;2020;   35363;   22046;   13195;    9914;    3281;     122
3321;T001235;GM0599;2012;  306222;  105656;  195971;  143228;   52743;    4595
3322;T001235;GM0599;2013;  307349;  106582;  197081;  141123;   55958;    3686
3323;T001235;GM0599;2014;  308291;  107487;  197292;  139462;   57830;    3512
3324;T001235;GM0599;2015;  311324;  108241;  198538;  142233;   56305;    4545
3325;T001235;GM0599;2016;  311168;  107648;  199316;  138394;   60922;    4204
3326;T001235;GM0599;2017;  309693;  107380;  198654;  137497;   61157;    3659
3327;T001235;GM0599;2018;  311336;  107053;  200096;  137873;   62223;    4187
3328;T001235;GM0599;2019;  311597;  110571;  199493;  139605;   59888;    1533
3329;T001235;GM0599;2020;  315561;  110803;  203207;  140226;   62981;    1551
3330;T001235;GM0277;2012;     628;     548;      79;      46;      33;       1
3331;T001235;GM0277;2013;     628;     544;      84;      46;      38;       0
3332;T001235;GM0277;2014;     627;     541;      86;      46;      40;       0
3333;T001235;GM0277;2015;     635;     545;      89;      46;      43;       1
3334;T001235;GM0277;2016;     635;     552;      82;      46;      36;       1
3335;T001235;GM0277;2017;     635;     550;      85;      46;      39;       0
3336;T001235;GM0277;2018;     662;     562;      79;      46;      33;      21
3337;T001235;GM0277;2019;     683;     596;      82;      46;      36;       5
3338;T001235;GM0277;2020;     688;     607;      77;      46;      31;       4
3339;T001235;GM0840;2012;    9194;    6090;    3082;    2744;     338;      22
3340;T001235;GM0840;2013;    9271;    6113;    3082;    2730;     352;      76
3341;T001235;GM0840;2014;    9513;    6250;    3152;    2752;     400;     111
3342;T001235;GM0840;2015;    9505;    6295;    3191;    2840;     351;      19
3343;T001235;GM0840;2016;    9534;    6312;    3141;    2715;     426;      81
3344;T001235;GM0840;2017;    9604;    6336;    3181;    2748;     433;      87
3345;T001235;GM0840;2018;    9605;    6300;    3263;    2830;     433;      42
3346;T001235;GM0840;2019;    9690;    6425;    3258;    2828;     430;       7
3347;T001235;GM0840;2020;    9822;    6487;    3324;    2843;     481;      11
3348;T001235;GM0441;2012;    8302;    5120;    3171;    2425;     746;      11
3349;T001235;GM0441;2013;   19439;   13174;    6143;    4519;    1624;     122
3350;T001235;GM0441;2014;   19565;   13203;    6173;    4502;    1671;     189
3351;T001235;GM0441;2015;   19770;   13437;    6145;    4452;    1693;     188
3352;T001235;GM0441;2016;   19814;   13541;    6084;    4421;    1663;     189
3353;T001235;GM0441;2017;   19993;   13645;    6162;    4407;    1755;     186
3354;T001235;GM0441;2018;   20103;   13740;    6161;    4435;    1726;     202
3355;T001235;GM0441;2019;   20287;   14072;    6040;    4489;    1551;     175
3356;T001235;GM0441;2020;   20334;   14102;    6045;    4478;    1567;     187
3357;T001235;GM0458;2012;    2169;    1602;     554;     380;     174;      13
3358;T001235;GM0458;2013;    2179;    1618;     550;     366;     184;      11
3359;T001235;GM0458;2014;    2182;    1613;     561;     365;     196;       8
3360;T001235;GM0458;2015;;;;;;
3361;T001235;GM0458;2016;;;;;;
3362;T001235;GM0458;2017;;;;;;
3363;T001235;GM0458;2018;;;;;;
3364;T001235;GM0458;2019;;;;;;
3365;T001235;GM0458;2020;;;;;;
3366;T001235;GM0279;2012;    3632;    2581;    1032;     658;     374;      19
3367;T001235;GM0279;2013;    3663;    2594;    1049;     659;     390;      20
3368;T001235;GM0279;2014;    3709;    2624;    1065;     656;     409;      20
3369;T001235;GM0279;2015;    3711;    2656;    1037;     632;     405;      18
3370;T001235;GM0279;2016;    3725;    2642;    1076;     635;     441;       7
3371;T001235;GM0279;2017;    3819;    2692;    1118;     658;     460;       9
3372;T001235;GM0279;2018;    3921;    2784;    1044;     652;     392;      93
3373;T001235;GM0279;2019;    3967;    2893;    1056;     665;     391;      18
3374;T001235;GM0279;2020;    4002;    2900;    1096;     694;     402;       6
3375;T001235;GM0606;2012;   35834;   17614;   18192;   12632;    5560;      28
3376;T001235;GM0606;2013;   36011;   17680;   18315;   12643;    5672;      16
3377;T001235;GM0606;2014;   36044;   17650;   18326;   12549;    5777;      68
3378;T001235;GM0606;2015;   36581;   17585;   18524;   12541;    5983;     472
3379;T001235;GM0606;2016;   36751;   17711;   18509;   12518;    5991;     531
3380;T001235;GM0606;2017;   36763;   17606;   18630;   12374;    6256;     527
3381;T001235;GM0606;2018;   36914;   17696;   18684;   12101;    6583;     534
3382;T001235;GM0606;2019;   36914;   18207;   18623;   11914;    6709;      84
3383;T001235;GM0606;2020;   37292;   18348;   18838;   11867;    6971;     106
3384;T001235;GM0088;2012;     590;     314;     249;     148;     101;      27
3385;T001235;GM0088;2013;     591;     314;     265;     147;     118;      12
3386;T001235;GM0088;2014;     581;     313;     250;     145;     105;      18
3387;T001235;GM0088;2015;     578;     313;     249;     143;     106;      16
3388;T001235;GM0088;2016;     583;     309;     259;     141;     118;      15
3389;T001235;GM0088;2017;     584;     308;     261;     141;     120;      15
3390;T001235;GM0088;2018;     582;     316;     254;     135;     119;      12
3391;T001235;GM0088;2019;     587;     322;     257;     142;     115;       8
3392;T001235;GM0088;2020;     587;     326;     253;     142;     111;       8
3393;T001235;GM0844;2012;    9223;    6222;    2867;    2273;     594;     134
3394;T001235;GM0844;2013;    9576;    6445;    3069;    2373;     696;      62
3395;T001235;GM0844;2014;    9705;    6540;    3049;    2357;     692;     116
3396;T001235;GM0844;2015;    9755;    6544;    3094;    2386;     708;     117
3397;T001235;GM0844;2016;    9862;    6591;    3163;    2448;     715;     108
3398;T001235;GM0844;2017;;;;;;
3399;T001235;GM0844;2018;;;;;;
3400;T001235;GM0844;2019;;;;;;
3401;T001235;GM0844;2020;;;;;;
3402;T001235;GM0962;2012;    5916;    4306;    1500;     932;     568;     110
3403;T001235;GM0962;2013;    5884;    4315;    1474;     926;     548;      95
3404;T001235;GM0962;2014;    5894;    4327;    1472;     918;     554;      95
3405;T001235;GM0962;2015;    5900;    4142;    1664;     990;     674;      94
3406;T001235;GM0962;2016;    5929;    4175;    1658;     991;     667;      96
3407;T001235;GM0962;2017;    5946;    4193;    1660;    1001;     659;      93
3408;T001235;GM0962;2018;    5952;    4332;    1521;     997;     524;      99
3409;T001235;GM0962;2019;;;;;;
3410;T001235;GM0962;2020;;;;;;
3411;T001235;GM0608;2012;    5039;    2940;    2065;    1669;     396;      34
3412;T001235;GM0608;2013;    5049;    2919;    2103;    1661;     442;      27
3413;T001235;GM0608;2014;    5179;    2972;    2183;    1711;     472;      24
3414;T001235;GM0608;2015;;;;;;
3415;T001235;GM0608;2016;;;;;;
3416;T001235;GM0608;2017;;;;;;
3417;T001235;GM0608;2018;;;;;;
3418;T001235;GM0608;2019;;;;;;
3419;T001235;GM0608;2020;;;;;;
3420;T001235;GM1676;2012;   16457;   10485;    5543;    4122;    1421;     429
3421;T001235;GM1676;2013;   16732;   10624;    5921;    4172;    1749;     187
3422;T001235;GM1676;2014;   16765;   10689;    5840;    4139;    1701;     236
3423;T001235;GM1676;2015;   16669;   10666;    5913;    4208;    1705;      90
3424;T001235;GM1676;2016;   16717;   10788;    5834;    4158;    1676;      95
3425;T001235;GM1676;2017;   16753;   10793;    5884;    4188;    1696;      76
3426;T001235;GM1676;2018;   16661;   10945;    5643;    4127;    1516;      73
3427;T001235;GM1676;2019;   16746;   11164;    5340;    4128;    1212;     242
3428;T001235;GM1676;2020;   16783;   11143;    5345;    4095;    1250;     295
3429;T001235;GM0965;2012;    5101;    3284;    1783;    1275;     508;      34
3430;T001235;GM0965;2013;    5123;    3289;    1816;    1282;     534;      18
3431;T001235;GM0965;2014;    5210;    3193;    1997;    1314;     683;      20
3432;T001235;GM0965;2015;    5211;    3195;    1992;    1259;     733;      24
3433;T001235;GM0965;2016;    5225;    3197;    2004;    1263;     741;      24
3434;T001235;GM0965;2017;    5201;    3186;    1995;    1263;     732;      20
3435;T001235;GM0965;2018;    5207;    3295;    1889;    1263;     626;      23
3436;T001235;GM0965;2019;    5320;    3381;    1913;    1243;     670;      26
3437;T001235;GM0965;2020;    5185;    3272;    1890;    1246;     644;      23
3438;T001235;GM1702;2012;    4617;    3532;    1021;     781;     240;      64
3439;T001235;GM1702;2013;    4600;    3529;    1043;     775;     268;      28
3440;T001235;GM1702;2014;    4726;    3567;    1074;     774;     300;      85
3441;T001235;GM1702;2015;    4725;    3568;    1072;     759;     313;      85
3442;T001235;GM1702;2016;    4746;    3576;    1080;     752;     328;      90
3443;T001235;GM1702;2017;    4765;    3576;    1104;     743;     361;      85
3444;T001235;GM1702;2018;    4807;    3581;    1124;     739;     385;     102
3445;T001235;GM1702;2019;    4810;    3646;    1163;     735;     428;       1
3446;T001235;GM1702;2020;    4863;    3676;    1180;     736;     444;       7
3447;T001235;GM0845;2012;   11310;    8533;    2628;    1786;     842;     149
3448;T001235;GM0845;2013;   11383;    8548;    2722;    1821;     901;     113
3449;T001235;GM0845;2014;   11463;    8579;    2781;    1835;     946;     103
3450;T001235;GM0845;2015;   11690;    8617;    2879;    1904;     975;     194
3451;T001235;GM0845;2016;   11738;    8687;    2860;    1919;     941;     191
3452;T001235;GM0845;2017;   11776;    8693;    2894;    1928;     966;     189
3453;T001235;GM0845;2018;   11985;    9005;    2811;    1968;     843;     169
3454;T001235;GM0845;2019;   12101;    9071;    2944;    1966;     978;      86
3455;T001235;GM0845;2020;   12183;    9121;    2973;    1967;    1006;      89
3456;T001235;GM0846;2012;    7422;    5285;    1932;    1348;     584;     205
3457;T001235;GM0846;2013;    7287;    5289;    1957;    1339;     618;      41
3458;T001235;GM0846;2014;    7318;    5265;    2007;    1352;     655;      46
3459;T001235;GM0846;2015;    7344;    5287;    2002;    1350;     652;      55
3460;T001235;GM0846;2016;    7395;    5329;    2009;    1346;     663;      57
3461;T001235;GM0846;2017;;;;;;
3462;T001235;GM0846;2018;;;;;;
3463;T001235;GM0846;2019;;;;;;
3464;T001235;GM0846;2020;;;;;;
3465;T001235;GM1883;2012;   44973;   26097;   18612;   13279;    5333;     264
3466;T001235;GM1883;2013;   45144;   26108;   18844;   13326;    5518;     192
3467;T001235;GM1883;2014;   45775;   26368;   18815;   13372;    5443;     592
3468;T001235;GM1883;2015;   46055;   26371;   19105;   13593;    5512;     579
3469;T001235;GM1883;2016;   46058;   26315;   19160;   13413;    5747;     583
3470;T001235;GM1883;2017;   46253;   26399;   19325;   13405;    5920;     529
3471;T001235;GM1883;2018;   46369;   26680;   19132;   13329;    5803;     557
3472;T001235;GM1883;2019;   46435;   27189;   19059;   13440;    5619;     187
3473;T001235;GM1883;2020;   46625;   27118;   19319;   13439;    5880;     188
3474;T001235;GM0051;2012;   12085;    8041;    3740;    2857;     883;     304
3475;T001235;GM0051;2013;   12094;    8153;    3796;    2848;     948;     145
3476;T001235;GM0051;2014;;;;;;
3477;T001235;GM0051;2015;;;;;;
3478;T001235;GM0051;2016;;;;;;
3479;T001235;GM0051;2017;;;;;;
3480;T001235;GM0051;2018;;;;;;
3481;T001235;GM0051;2019;;;;;;
3482;T001235;GM0051;2020;;;;;;
3483;T001235;GM0610;2012;   10413;    5574;    4786;    4050;     736;      53
3484;T001235;GM0610;2013;   10503;    5591;    4890;    4098;     792;      22
3485;T001235;GM0610;2014;   10464;    5650;    4793;    3888;     905;      21
3486;T001235;GM0610;2015;   10598;    5730;    4777;    3969;     808;      91
3487;T001235;GM0610;2016;   10722;    5828;    4803;    3911;     892;      91
3488;T001235;GM0610;2017;   10902;    5934;    4786;    3892;     894;     182
3489;T001235;GM0610;2018;   10846;    6043;    4617;    3864;     753;     186
3490;T001235;GM0610;2019;   11018;    6168;    4824;    3986;     838;      26
3491;T001235;GM0610;2020;   10898;    6225;    4664;    3800;     864;       9
3492;T001235;GM0040;2012;    6589;    4742;    1711;    1268;     443;     136
3493;T001235;GM0040;2013;    6670;    4824;    1708;    1257;     451;     138
3494;T001235;GM0040;2014;    6670;    4831;    1820;    1245;     575;      19
3495;T001235;GM0040;2015;    6689;    4830;    1838;    1236;     602;      21
3496;T001235;GM0040;2016;    6787;    4926;    1817;    1222;     595;      44
3497;T001235;GM0040;2017;    6480;    4676;    1766;    1218;     548;      38
3498;T001235;GM0040;2018;;;;;;
3499;T001235;GM0040;2019;;;;;;
3500;T001235;GM0040;2020;;;;;;
3501;T001235;GM1714;2012;   15755;   10770;    4936;    2523;    2413;      49
3502;T001235;GM1714;2013;   13611;    9295;    4284;    2495;    1789;      32
3503;T001235;GM1714;2014;   13986;    9224;    4442;    2488;    1954;     320
3504;T001235;GM1714;2015;   13974;    9148;    4556;    2460;    2096;     270
3505;T001235;GM1714;2016;   14051;    9155;    4609;    2448;    2161;     287
3506;T001235;GM1714;2017;   13952;    9050;    4690;    2443;    2247;     212
3507;T001235;GM1714;2018;   13960;    9086;    4663;    2435;    2228;     211
3508;T001235;GM1714;2019;   14138;    9504;    3942;    2408;    1534;     692
3509;T001235;GM1714;2020;   14200;    9363;    3957;    2401;    1556;     880
3510;T001235;GM0090;2012;   24316;   14636;    9616;    8029;    1587;      64
3511;T001235;GM0090;2013;   24469;   14658;    9744;    8121;    1623;      67
3512;T001235;GM0090;2014;   25063;   14708;    9985;    8229;    1756;     370
3513;T001235;GM0090;2015;   25256;   14702;   10198;    8263;    1935;     356
3514;T001235;GM0090;2016;   25391;   14755;   10135;    8102;    2033;     501
3515;T001235;GM0090;2017;   25377;   14886;   10021;    8016;    2005;     470
3516;T001235;GM0090;2018;   25454;   14979;    9973;    7895;    2078;     502
3517;T001235;GM0090;2019;   25675;   15383;   10256;    8028;    2228;      36
3518;T001235;GM0090;2020;   25768;   15401;   10330;    7959;    2371;      37
3519;T001235;GM0342;2012;   19835;   12374;    7395;    4709;    2686;      66
3520;T001235;GM0342;2013;   19910;   12399;    7472;    4670;    2802;      39
3521;T001235;GM0342;2014;   20057;   12447;    7563;    4661;    2902;      47
3522;T001235;GM0342;2015;   20281;   12525;    7518;    4595;    2923;     238
3523;T001235;GM0342;2016;   20282;   12635;    7399;    4507;    2892;     248
3524;T001235;GM0342;2017;   20361;   12669;    7437;    4479;    2958;     255
3525;T001235;GM0342;2018;   20479;   12864;    7359;    4510;    2849;     256
3526;T001235;GM0342;2019;   20567;   13197;    7349;    4506;    2843;      21
3527;T001235;GM0342;2020;   20699;   13268;    7079;    4585;    2494;     352
3528;T001235;GM0847;2012;    7236;    5095;    2126;    1528;     598;      15
3529;T001235;GM0847;2013;    7320;    5183;    2130;    1511;     619;       7
3530;T001235;GM0847;2014;    7516;    5247;    2231;    1577;     654;      38
3531;T001235;GM0847;2015;    7754;    5365;    2380;    1695;     685;       9
3532;T001235;GM0847;2016;    7783;    5396;    2348;    1647;     701;      39
3533;T001235;GM0847;2017;    7863;    5468;    2353;    1641;     712;      42
3534;T001235;GM0847;2018;    7964;    5665;    2242;    1652;     590;      57
3535;T001235;GM0847;2019;    8057;    5813;    2225;    1672;     553;      19
3536;T001235;GM0847;2020;    8113;    5855;    2242;    1670;     572;      16
3537;T001235;GM0848;2012;    6437;    4837;    1568;     963;     605;      32
3538;T001235;GM0848;2013;    6711;    4905;    1796;    1149;     647;      10
3539;T001235;GM0848;2014;    6725;    4912;    1807;    1140;     667;       6
3540;T001235;GM0848;2015;    6874;    4970;    1896;    1212;     684;       8
3541;T001235;GM0848;2016;    6906;    4934;    1957;    1205;     752;      15
3542;T001235;GM0848;2017;    6978;    4952;    1977;    1163;     814;      49
3543;T001235;GM0848;2018;    7067;    5185;    1844;    1154;     690;      38
3544;T001235;GM0848;2019;    7112;    5293;    1770;    1160;     610;      49
3545;T001235;GM0848;2020;    7192;    5357;    1795;    1157;     638;      40
3546;T001235;GM0612;2012;   33777;   18063;   15133;   13516;    1617;     581
3547;T001235;GM0612;2013;   32781;   17946;   14827;   13432;    1395;       8
3548;T001235;GM0612;2014;   33332;   18210;   15112;   13524;    1588;      10
3549;T001235;GM0612;2015;;;;;;
3550;T001235;GM0612;2016;;;;;;
3551;T001235;GM0612;2017;;;;;;
3552;T001235;GM0612;2018;;;;;;
3553;T001235;GM0612;2019;;;;;;
3554;T001235;GM0612;2020;;;;;;
3555;T001235;GM0037;2012;   14895;    8958;    5819;    4736;    1083;     118
3556;T001235;GM0037;2013;   14922;    8987;    5849;    4811;    1038;      86
3557;T001235;GM0037;2014;   15304;    9019;    5910;    4796;    1114;     375
3558;T001235;GM0037;2015;   15274;    9044;    5922;    4774;    1148;     308
3559;T001235;GM0037;2016;   15282;    9006;    5948;    4673;    1275;     328
3560;T001235;GM0037;2017;   15276;    9020;    5930;    4647;    1283;     326
3561;T001235;GM0037;2018;   15266;    8910;    6028;    4648;    1380;     328
3562;T001235;GM0037;2019;   15253;    9111;    5977;    4688;    1289;     165
3563;T001235;GM0037;2020;   15292;    9093;    6003;    4686;    1317;     196
3564;T001235;GM0180;2012;    5456;    4103;    1262;     597;     665;      91
3565;T001235;GM0180;2013;    5450;    4138;    1245;     597;     648;      67
3566;T001235;GM0180;2014;    5537;    4220;    1263;     608;     655;      54
3567;T001235;GM0180;2015;    5655;    4298;    1300;     620;     680;      57
3568;T001235;GM0180;2016;    5688;    4318;    1308;     625;     683;      62
3569;T001235;GM0180;2017;    5756;    4352;    1337;     623;     714;      67
3570;T001235;GM0180;2018;    5853;    4528;    1272;     645;     627;      53
3571;T001235;GM0180;2019;    5914;    4578;    1324;     644;     680;      12
3572;T001235;GM0180;2020;    5933;    4592;    1329;     644;     685;      12
3573;T001235;GM0532;2012;    8808;    6172;    2618;    2143;     475;      18
3574;T001235;GM0532;2013;    8850;    6199;    2621;    2129;     492;      30
3575;T001235;GM0532;2014;    8924;    6164;    2741;    2191;     550;      19
3576;T001235;GM0532;2015;    9000;    6217;    2748;    2328;     420;      35
3577;T001235;GM0532;2016;    9025;    6235;    2773;    2322;     451;      17
3578;T001235;GM0532;2017;    9049;    6243;    2786;    2313;     473;      20
3579;T001235;GM0532;2018;    9121;    6350;    2750;    2308;     442;      21
3580;T001235;GM0532;2019;    9207;    6431;    2768;    2375;     393;       8
3581;T001235;GM0532;2020;    9199;    6402;    2789;    2345;     444;       8
3582;T001235;GM0851;2012;   10015;    6636;    3340;    2366;     974;      39
3583;T001235;GM0851;2013;   10046;    6671;    3335;    2378;     957;      40
3584;T001235;GM0851;2014;   10067;    6676;    3356;    2373;     983;      35
3585;T001235;GM0851;2015;    9996;    6543;    3433;    2417;    1016;      20
3586;T001235;GM0851;2016;   10006;    6687;    3269;    2339;     930;      50
3587;T001235;GM0851;2017;   10178;    6720;    3384;    2377;    1007;      74
3588;T001235;GM0851;2018;   10258;    6992;    3223;    2425;     798;      43
3589;T001235;GM0851;2019;   10335;    7181;    3141;    2429;     712;      13
3590;T001235;GM0851;2020;   10433;    7267;    3154;    2399;     755;      12
3591;T001235;GM1708;2012;   19461;   12135;    7123;    5379;    1744;     203
3592;T001235;GM1708;2013;   19497;   12176;    7202;    5344;    1858;     119
3593;T001235;GM1708;2014;   19529;   12215;    7196;    5327;    1869;     118
3594;T001235;GM1708;2015;   19627;   12303;    7203;    5307;    1896;     121
3595;T001235;GM1708;2016;   19636;   12364;    7164;    5242;    1922;     108
3596;T001235;GM1708;2017;   19787;   12411;    7266;    5281;    1985;     110
3597;T001235;GM1708;2018;   19951;   12587;    7256;    5291;    1965;     108
3598;T001235;GM1708;2019;   20014;   12950;    7003;    5348;    1655;      61
3599;T001235;GM1708;2020;   20172;   13039;    7071;    5329;    1742;      62
3600;T001235;GM0971;2012;   11330;    8263;    3004;    2486;     518;      63
3601;T001235;GM0971;2013;   11347;    8273;    3011;    2475;     536;      63
3602;T001235;GM0971;2014;   11623;    8217;    3298;    2582;     716;     108
3603;T001235;GM0971;2015;   11572;    8203;    3266;    2457;     809;     103
3604;T001235;GM0971;2016;   11614;    8186;    3329;    2558;     771;      99
3605;T001235;GM0971;2017;   11669;    8189;    3410;    2527;     883;      70
3606;T001235;GM0971;2018;   11690;    8325;    3293;    2586;     707;      72
3607;T001235;GM0971;2019;   11768;    8423;    3310;    2598;     712;      35
3608;T001235;GM0971;2020;   11800;    8457;    3326;    2593;     733;      17
3609;T001235;GM1904;2012;   26618;   16868;    9269;    6522;    2747;     481
3610;T001235;GM1904;2013;   26732;   17070;    9277;    6444;    2833;     385
3611;T001235;GM1904;2014;   27284;   17257;    9593;    6291;    3302;     434
3612;T001235;GM1904;2015;   27368;   17455;    9526;    6297;    3229;     387
3613;T001235;GM1904;2016;   27561;   17660;    9579;    6331;    3248;     322
3614;T001235;GM1904;2017;   27858;   17925;    9633;    6316;    3317;     300
3615;T001235;GM1904;2018;   28121;   18175;    9633;    6364;    3269;     313
3616;T001235;GM1904;2019;   28206;   18402;    9671;    6370;    3301;     133
3617;T001235;GM1904;2020;   28549;   18539;    9914;    6361;    3553;      96
3618;T001235;GM0617;2012;    3849;    2532;    1297;    1133;     164;      20
3619;T001235;GM0617;2013;    3828;    2553;    1265;    1096;     169;      10
3620;T001235;GM0617;2014;    3848;    2585;    1253;    1069;     184;      10
3621;T001235;GM0617;2015;    3877;    2624;    1244;    1063;     181;       9
3622;T001235;GM0617;2016;    3908;    2646;    1253;    1082;     171;       9
3623;T001235;GM0617;2017;    3933;    2659;    1267;    1077;     190;       7
3624;T001235;GM0617;2018;    3951;    2694;    1251;    1064;     187;       6
3625;T001235;GM0617;2019;;;;;;
3626;T001235;GM0617;2020;;;;;;
3627;T001235;GM1900;2012;   36706;   23194;   13284;   10536;    2748;     228
3628;T001235;GM1900;2013;   37852;   23929;   13687;   10671;    3016;     236
3629;T001235;GM1900;2014;   38448;   24279;   13914;   10708;    3206;     255
3630;T001235;GM1900;2015;   38939;   24405;   13780;   10614;    3166;     754
3631;T001235;GM1900;2016;   39013;   24449;   13809;   10550;    3259;     755
3632;T001235;GM1900;2017;   39117;   24604;   13748;   10412;    3336;     765
3633;T001235;GM1900;2018;   41596;   26788;   14029;   10773;    3256;     779
3634;T001235;GM1900;2019;   41915;   27305;   14449;   11163;    3286;     161
3635;T001235;GM1900;2020;   42119;   27427;   14552;   11144;    3408;     140
3636;T001235;GM0715;2012;   25924;   17908;    7969;    5343;    2626;      47
3637;T001235;GM0715;2013;   26102;   17924;    8163;    5403;    2760;      15
3638;T001235;GM0715;2014;   26287;   17789;    8443;    5413;    3030;      55
3639;T001235;GM0715;2015;   26359;   17958;    8337;    5392;    2945;      64
3640;T001235;GM0715;2016;   26675;   17987;    8311;    5381;    2930;     377
3641;T001235;GM0715;2017;   26754;   17913;    8466;    5359;    3107;     375
3642;T001235;GM0715;2018;   26812;   18146;    8281;    5317;    2964;     385
3643;T001235;GM0715;2019;   26952;   18430;    8054;    5192;    2862;     468
3644;T001235;GM0715;2020;   26966;   18402;    7983;    5138;    2845;     581
3645;T001235;GM0093;2012;    2156;    1330;     736;     438;     298;      90
3646;T001235;GM0093;2013;    2210;    1334;     765;     454;     311;     111
3647;T001235;GM0093;2014;    2213;    1369;     756;     418;     338;      88
3648;T001235;GM0093;2015;    2222;    1376;     779;     425;     354;      67
3649;T001235;GM0093;2016;    2229;    1372;     791;       8;     783;      66
3650;T001235;GM0093;2017;    2243;    1384;     795;       9;     786;      64
3651;T001235;GM0093;2018;    2276;    1408;     780;     412;     368;      88
3652;T001235;GM0093;2019;    2281;    1466;     807;     430;     377;       8
3653;T001235;GM0093;2020;    2293;    1468;     823;     430;     393;       2
3654;T001235;GM0448;2012;    6249;    4167;    2045;    1351;     694;      37
3655;T001235;GM0448;2013;    6281;    4164;    2083;    1337;     746;      34
3656;T001235;GM0448;2014;    6401;    4184;    2082;    1323;     759;     135
3657;T001235;GM0448;2015;    6405;    4204;    2065;    1308;     757;     136
3658;T001235;GM0448;2016;    6470;    4254;    2079;    1308;     771;     137
3659;T001235;GM0448;2017;    6501;    4254;    2105;    1346;     759;     142
3660;T001235;GM0448;2018;    6552;    4349;    2049;    1378;     671;     154
3661;T001235;GM0448;2019;    6594;    4434;    2108;    1388;     720;      52
3662;T001235;GM0448;2020;    6651;    4456;    2136;    1397;     739;      59
3663;T001235;GM1525;2012;   14343;    9292;    4953;    3532;    1421;      98
3664;T001235;GM1525;2013;   14346;    9284;    4990;    3487;    1503;      72
3665;T001235;GM1525;2014;   14687;    9409;    5104;    3488;    1616;     174
3666;T001235;GM1525;2015;   14716;    9470;    5079;    3479;    1600;     167
3667;T001235;GM1525;2016;   14952;    9606;    5177;    3545;    1632;     169
3668;T001235;GM1525;2017;   15096;    9710;    5222;    3565;    1657;     164
3669;T001235;GM1525;2018;   15515;    9968;    5377;    3631;    1746;     170
3670;T001235;GM1525;2019;   15588;   10143;    5219;    3612;    1607;     226
3671;T001235;GM1525;2020;   16048;   10445;    5422;    3660;    1762;     181
3672;T001235;GM0716;2012;   10352;    7212;    3098;    2556;     542;      42
3673;T001235;GM0716;2013;   10413;    7231;    3164;    2587;     577;      18
3674;T001235;GM0716;2014;   10515;    7226;    3189;    2574;     615;     100
3675;T001235;GM0716;2015;   10597;    7240;    3253;    2583;     670;     104
3676;T001235;GM0716;2016;   10626;    7291;    3216;    2541;     675;     119
3677;T001235;GM0716;2017;   10729;    7344;    3275;    2557;     718;     110
3678;T001235;GM0716;2018;   10777;    7477;    3195;    2552;     643;     105
3679;T001235;GM0716;2019;   10888;    7628;    3208;    2613;     595;      52
3680;T001235;GM0716;2020;   10983;    7706;    3208;    2603;     605;      69
3681;T001235;GM0281;2012;   17320;    9340;    7764;    6659;    1105;     216
3682;T001235;GM0281;2013;   17446;    9472;    7788;    6657;    1131;     186
3683;T001235;GM0281;2014;   17533;    9513;    7805;    6618;    1187;     215
3684;T001235;GM0281;2015;   17654;    9601;    7778;    6622;    1156;     275
3685;T001235;GM0281;2016;   17682;    9776;    7665;    6412;    1253;     241
3686;T001235;GM0281;2017;   17839;    9700;    7906;    6463;    1443;     233
3687;T001235;GM0281;2018;   17902;    9729;    7971;    6456;    1515;     202
3688;T001235;GM0281;2019;   18011;   10118;    7868;    6435;    1433;      25
3689;T001235;GM0281;2020;   18080;   10252;    7792;    6296;    1496;      36
3690;T001235;GM0855;2012;   90696;   48316;   42310;   31184;   11126;      70
3691;T001235;GM0855;2013;   91011;   48376;   42584;   30984;   11600;      51
3692;T001235;GM0855;2014;   94071;   48599;   44792;   32266;   12526;     680
3693;T001235;GM0855;2015;   95263;   48822;   45841;   32695;   13146;     600
3694;T001235;GM0855;2016;   95779;   49217;   45934;   31752;   14182;     628
3695;T001235;GM0855;2017;   96235;   49248;   46391;   31697;   14694;     596
3696;T001235;GM0855;2018;   97584;   49474;   47457;   32121;   15336;     653
3697;T001235;GM0855;2019;   99004;   50323;   48411;   32627;   15784;     270
3698;T001235;GM0855;2020;  100418;   50660;   49184;   32763;   16421;     574
3699;T001235;GM0183;2012;    7866;    5717;    2033;     958;    1075;     116
3700;T001235;GM0183;2013;    8045;    5834;    2086;     986;    1100;     125
3701;T001235;GM0183;2014;    8113;    5834;    2147;    1007;    1140;     132
3702;T001235;GM0183;2015;    8167;    5887;    2142;    1009;    1133;     138
3703;T001235;GM0183;2016;    8247;    5902;    2209;    1026;    1183;     136
3704;T001235;GM0183;2017;    8348;    5958;    2221;    1025;    1196;     169
3705;T001235;GM0183;2018;    8490;    6239;    2028;    1024;    1004;     223
3706;T001235;GM0183;2019;    8525;    6083;    2401;    1047;    1354;      41
3707;T001235;GM0183;2020;    8604;    6143;    2394;    1059;    1335;      67
3708;T001235;GM1700;2012;   13097;    8505;    4433;    3599;     834;     159
3709;T001235;GM1700;2013;   13124;    8564;    4434;    3576;     858;     126
3710;T001235;GM1700;2014;   13488;    8687;    4516;    3553;     963;     285
3711;T001235;GM1700;2015;   13574;    8762;    4507;    3584;     923;     305
3712;T001235;GM1700;2016;   13609;    8798;    4502;    3485;    1017;     309
3713;T001235;GM1700;2017;   13621;    8790;    4519;    3480;    1039;     312
3714;T001235;GM1700;2018;   13664;    8907;    4452;    3518;     934;     305
3715;T001235;GM1700;2019;   13705;    8944;    4729;    3694;    1035;      32
3716;T001235;GM1700;2020;   13819;    9045;    4727;    3635;    1092;      47
3717;T001235;GM1730;2012;   14119;   10220;    3403;    2267;    1136;     496
3718;T001235;GM1730;2013;   13989;   10178;    3517;    2272;    1245;     294
3719;T001235;GM1730;2014;   13983;   10239;    3654;    2244;    1410;      90
3720;T001235;GM1730;2015;   13857;   10284;    3489;    2218;    1271;      84
3721;T001235;GM1730;2016;   13958;   10361;    3516;    2217;    1299;      81
3722;T001235;GM1730;2017;   14119;   10375;    3584;    2238;    1346;     160
3723;T001235;GM1730;2018;   14211;   10706;    3338;    2228;    1110;     167
3724;T001235;GM1730;2019;   14403;   11014;    3320;    2241;    1079;      69
3725;T001235;GM1730;2020;   14500;   11099;    3336;    2206;    1130;      65
3726;T001235;GM0737;2012;   13621;    9714;    3651;    2824;     827;     256
3727;T001235;GM0737;2013;   13252;    9618;    3616;    2830;     786;      18
3728;T001235;GM0737;2014;   13457;    9643;    3711;    2733;     978;     103
3729;T001235;GM0737;2015;   13553;    9688;    3689;    2785;     904;     176
3730;T001235;GM0737;2016;   13646;    9721;    3734;    2764;     970;     191
3731;T001235;GM0737;2017;   13730;    9801;    3730;    2739;     991;     199
3732;T001235;GM0737;2018;   13800;    9904;    3696;    2730;     966;     200
3733;T001235;GM0737;2019;   13943;   10071;    3865;    2721;    1144;       7
3734;T001235;GM0737;2020;   14044;   10097;    3927;    2723;    1204;      20
3735;T001235;GM0282;2012;    4066;    2645;    1419;    1132;     287;       2
3736;T001235;GM0282;2013;    4212;    2724;    1487;    1148;     339;       1
3737;T001235;GM0282;2014;    4283;    2707;    1534;    1169;     365;      42
3738;T001235;GM0282;2015;;;;;;
3739;T001235;GM0282;2016;;;;;;
3740;T001235;GM0282;2017;;;;;;
3741;T001235;GM0282;2018;;;;;;
3742;T001235;GM0282;2019;;;;;;
3743;T001235;GM0282;2020;;;;;;
3744;T001235;GM0856;2012;   17266;   10954;    6238;    4938;    1300;      74
3745;T001235;GM0856;2013;   17472;   11082;    6327;    4951;    1376;      63
3746;T001235;GM0856;2014;   17782;   11181;    6406;    4950;    1456;     195
3747;T001235;GM0856;2015;   17988;   11239;    6476;    4901;    1575;     273
3748;T001235;GM0856;2016;   18110;   11340;    6496;    4957;    1539;     274
3749;T001235;GM0856;2017;   18253;   11405;    6576;    4956;    1620;     272
3750;T001235;GM0856;2018;   18474;   11563;    6630;    5018;    1612;     281
3751;T001235;GM0856;2019;   18669;   11684;    6973;    5274;    1699;      12
3752;T001235;GM0856;2020;   19018;   11763;    7243;    5401;    1842;      12
3753;T001235;GM0450;2012;    5221;    3717;    1478;    1209;     269;      26
3754;T001235;GM0450;2013;    5327;    3781;    1525;    1238;     287;      21
3755;T001235;GM0450;2014;    5473;    3818;    1590;    1267;     323;      65
3756;T001235;GM0450;2015;    5520;    3867;    1589;    1266;     323;      64
3757;T001235;GM0450;2016;    5548;    3900;    1585;    1259;     326;      63
3758;T001235;GM0450;2017;    5606;    3952;    1562;    1225;     337;      92
3759;T001235;GM0450;2018;    5619;    4047;    1479;    1258;     221;      93
3760;T001235;GM0450;2019;    5633;    4074;    1548;    1259;     289;      11
3761;T001235;GM0450;2020;    5713;    4119;    1584;    1258;     326;      10
3762;T001235;GM0451;2012;   12275;    7033;    5175;    4144;    1031;      67
3763;T001235;GM0451;2013;   12389;    7139;    5183;    4173;    1010;      67
3764;T001235;GM0451;2014;   12571;    7229;    5330;    4167;    1163;      12
3765;T001235;GM0451;2015;   12603;    7256;    5331;    4163;    1168;      16
3766;T001235;GM0451;2016;   12837;    7407;    5412;    4212;    1200;      18
3767;T001235;GM0451;2017;   12771;    7387;    5366;    4098;    1268;      18
3768;T001235;GM0451;2018;   12948;    7565;    5362;    4176;    1186;      21
3769;T001235;GM0451;2019;   12856;    7646;    5203;    4122;    1081;       7
3770;T001235;GM0451;2020;   12836;    7715;    5116;    3991;    1125;       5
3771;T001235;GM0184;2012;    5375;    4393;     970;     709;     261;      12
3772;T001235;GM0184;2013;    5429;    4405;     994;     705;     289;      30
3773;T001235;GM0184;2014;    5996;    4710;    1168;     825;     343;     118
3774;T001235;GM0184;2015;    6110;    4758;    1227;     875;     352;     125
3775;T001235;GM0184;2016;    6198;    4838;    1238;     864;     374;     122
3776;T001235;GM0184;2017;    6309;    4888;    1299;     888;     411;     122
3777;T001235;GM0184;2018;    6381;    4943;    1321;     906;     415;     117
3778;T001235;GM0184;2019;    6472;    5058;    1378;     902;     476;      36
3779;T001235;GM0184;2020;    6663;    5200;    1428;     932;     496;      35
3780;T001235;GM0344;2012;  142976;   64729;   72953;   48416;   24537;    5294
3781;T001235;GM0344;2013;  145123;   65742;   76415;   48900;   27515;    2966
3782;T001235;GM0344;2014;  146329;   65400;   78296;   48654;   29642;    2633
3783;T001235;GM0344;2015;  147511;   65789;   78611;   50382;   28229;    3111
3784;T001235;GM0344;2016;  149322;   66495;   80114;   49940;   30174;    2713
3785;T001235;GM0344;2017;  151409;   67652;   80864;   49940;   30924;    2893
3786;T001235;GM0344;2018;  150831;   67217;   81097;   49531;   31566;    2517
3787;T001235;GM0344;2019;  153845;   70832;   82522;   50022;   32500;     491
3788;T001235;GM0344;2020;  156678;   71038;   85142;   50108;   35034;     498
3789;T001235;GM1581;2012;   21205;   13040;    7208;    4622;    2586;     957
3790;T001235;GM1581;2013;   21144;   13045;    7430;    4780;    2650;     669
3791;T001235;GM1581;2014;   21358;   13172;    7441;    4792;    2649;     745
3792;T001235;GM1581;2015;   21055;   13209;    7445;    4840;    2605;     401
3793;T001235;GM1581;2016;   21216;   13238;    7591;    4925;    2666;     387
3794;T001235;GM1581;2017;   21516;   13383;    7674;    4982;    2692;     459
3795;T001235;GM1581;2018;   21636;   13487;    7666;    5025;    2641;     483
3796;T001235;GM1581;2019;   21679;   13899;    7647;    5214;    2433;     133
3797;T001235;GM1581;2020;   21821;   13991;    7754;    5255;    2499;      76
3798;T001235;GM0981;2012;    5157;    2409;    2712;    1602;    1110;      36
3799;T001235;GM0981;2013;    5192;    2401;    2727;    1597;    1130;      64
3800;T001235;GM0981;2014;    5229;    2409;    2784;    1616;    1168;      36
3801;T001235;GM0981;2015;    5238;    2411;    2803;    1585;    1218;      24
3802;T001235;GM0981;2016;    5241;    2432;    2787;    1593;    1194;      22
3803;T001235;GM0981;2017;    5555;    2430;    3101;    1644;    1457;      24
3804;T001235;GM0981;2018;    5524;    2489;    3015;    1585;    1430;      20
3805;T001235;GM0981;2019;    5748;    2544;    3079;    1575;    1504;     125
3806;T001235;GM0981;2020;    5806;    2551;    3112;    1597;    1515;     143
3807;T001235;GM0994;2012;    7870;    4850;    2920;    1589;    1331;     100
3808;T001235;GM0994;2013;    7878;    4854;    2946;    1584;    1362;      78
3809;T001235;GM0994;2014;    8066;    4891;    3027;    1553;    1474;     148
3810;T001235;GM0994;2015;    8148;    4718;    3250;    1555;    1695;     180
3811;T001235;GM0994;2016;    8169;    4740;    3228;    1539;    1689;     201
3812;T001235;GM0994;2017;    8182;    4777;    3228;    1513;    1715;     177
3813;T001235;GM0994;2018;    8185;    4913;    3085;    1507;    1578;     187
3814;T001235;GM0994;2019;    8291;    5026;    3229;    1525;    1704;      36
3815;T001235;GM0994;2020;    8309;    5026;    3249;    1489;    1760;      34
3816;T001235;GM0858;2012;   13931;    8525;    5342;    4220;    1122;      64
3817;T001235;GM0858;2013;   13950;    8505;    5390;    4146;    1244;      55
3818;T001235;GM0858;2014;   14130;    8528;    5524;    4231;    1293;      78
3819;T001235;GM0858;2015;   14121;    8551;    5464;    4177;    1287;     106
3820;T001235;GM0858;2016;   14272;    8573;    5589;    4222;    1367;     110
3821;T001235;GM0858;2017;   14444;    8611;    5706;    4325;    1381;     127
3822;T001235;GM0858;2018;   14548;    8688;    5745;    4234;    1511;     115
3823;T001235;GM0858;2019;   14647;    8780;    5860;    4314;    1546;       7
3824;T001235;GM0858;2020;   14805;    8852;    5942;    4310;    1632;      11
3825;T001235;GM0047;2012;   12508;    8275;    4179;    3050;    1129;      54
3826;T001235;GM0047;2013;   12553;    8300;    4232;    3020;    1212;      21
3827;T001235;GM0047;2014;   12720;    8262;    4344;    3073;    1271;     114
3828;T001235;GM0047;2015;   12719;    8235;    4375;    3069;    1306;     109
3829;T001235;GM0047;2016;   12723;    8196;    4420;    3069;    1351;     107
3830;T001235;GM0047;2017;   12756;    8181;    4463;    3069;    1394;     112
3831;T001235;GM0047;2018;   12788;    8327;    4341;    3073;    1268;     120
3832;T001235;GM0047;2019;   12816;    8368;    4424;    3184;    1240;      24
3833;T001235;GM0047;2020;   12843;    8351;    4471;    3184;    1287;      21
3834;T001235;GM0345;2012;   24636;   14547;   10067;    8653;    1414;      22
3835;T001235;GM0345;2013;   25457;   14954;   10496;    8912;    1584;       7
3836;T001235;GM0345;2014;   25922;   15233;   10673;    8930;    1743;      16
3837;T001235;GM0345;2015;   26411;   15399;   11005;    8941;    2064;       7
3838;T001235;GM0345;2016;   26702;   15742;   10955;    8909;    2046;       5
3839;T001235;GM0345;2017;   27055;   15748;   11254;    8908;    2346;      53
3840;T001235;GM0345;2018;   27512;   15981;   11495;    8940;    2555;      36
3841;T001235;GM0345;2019;   27793;   16357;   11420;    8966;    2454;      16
3842;T001235;GM0345;2020;   28353;   16779;   11560;    9009;    2551;      14
3843;T001235;GM0717;2012;   10548;    7954;    2407;    1178;    1229;     187
3844;T001235;GM0717;2013;   10661;    8005;    2483;    1217;    1266;     173
3845;T001235;GM0717;2014;   10724;    8024;    2516;    1198;    1318;     184
3846;T001235;GM0717;2015;   10717;    8084;    2461;    1202;    1259;     172
3847;T001235;GM0717;2016;   10831;    8227;    2373;    1198;    1175;     231
3848;T001235;GM0717;2017;   10884;    8259;    2400;    1194;    1206;     225
3849;T001235;GM0717;2018;   10922;    8412;    2284;    1185;    1099;     226
3850;T001235;GM0717;2019;   10964;    8639;    2205;    1189;    1016;     120
3851;T001235;GM0717;2020;   10967;    8595;    2200;    1175;    1025;     172
3852;T001235;GM0860;2012;   15307;   10806;    4361;    3137;    1224;     140
3853;T001235;GM0860;2013;   15315;   10951;    4292;    3017;    1275;      72
3854;T001235;GM0860;2014;   15507;   10964;    4427;    3090;    1337;     116
3855;T001235;GM0860;2015;   15559;   11017;    4414;    2967;    1447;     128
3856;T001235;GM0860;2016;   15753;   11101;    4535;    3114;    1421;     117
3857;T001235;GM0860;2017;;;;;;
3858;T001235;GM0860;2018;;;;;;
3859;T001235;GM0860;2019;;;;;;
3860;T001235;GM0860;2020;;;;;;
3861;T001235;GM0861;2012;   18796;   12741;    5948;    4658;    1290;     107
3862;T001235;GM0861;2013;   19061;   12764;    6193;    4803;    1390;     104
3863;T001235;GM0861;2014;   19119;   12798;    6220;    4786;    1434;     101
3864;T001235;GM0861;2015;   19181;   12856;    6227;    4764;    1463;      98
3865;T001235;GM0861;2016;   19280;   12959;    6253;    4743;    1510;      68
3866;T001235;GM0861;2017;   19395;   13034;    6300;    4741;    1559;      61
3867;T001235;GM0861;2018;   19502;   13123;    6311;    4771;    1540;      68
3868;T001235;GM0861;2019;   19722;   13423;    6287;    4836;    1451;      12
3869;T001235;GM0861;2020;   19913;   13560;    6344;    4774;    1570;       9
3870;T001235;GM0453;2012;   29640;   16154;   13271;   10740;    2531;     215
3871;T001235;GM0453;2013;   29798;   16259;   13356;   10805;    2551;     183
3872;T001235;GM0453;2014;   30584;   16387;   14050;   10812;    3238;     147
3873;T001235;GM0453;2015;   30621;   16445;   14043;   10924;    3119;     133
3874;T001235;GM0453;2016;   30603;   16525;   13946;   10671;    3275;     132
3875;T001235;GM0453;2017;   30820;   16604;   13933;   10665;    3268;     283
3876;T001235;GM0453;2018;   30697;   17190;   13400;   10560;    2840;     107
3877;T001235;GM0453;2019;   30913;   17477;   13328;   11211;    2117;     108
3878;T001235;GM0453;2020;   31226;   17648;   13465;   11210;    2255;     113
3879;T001235;GM0983;2012;   46150;   26714;   19226;   13771;    5455;     210
3880;T001235;GM0983;2013;   46199;   26722;   19285;   13631;    5654;     192
3881;T001235;GM0983;2014;   46291;   27039;   19077;   13637;    5440;     175
3882;T001235;GM0983;2015;   46276;   27004;   19099;   13536;    5563;     173
3883;T001235;GM0983;2016;   46424;   27066;   19170;   13385;    5785;     188
3884;T001235;GM0983;2017;   46691;   27028;   19458;   13470;    5988;     205
3885;T001235;GM0983;2018;   46833;   27283;   19332;   13366;    5966;     218
3886;T001235;GM0983;2019;   47173;   27754;   19365;   13459;    5906;      54
3887;T001235;GM0983;2020;   47412;   27862;   19451;   13441;    6010;      99
3888;T001235;GM0984;2012;   18121;   11420;    6522;    4821;    1701;     179
3889;T001235;GM0984;2013;   18394;   11513;    6812;    4951;    1861;      69
3890;T001235;GM0984;2014;   18514;   11459;    6967;    5014;    1953;      88
3891;T001235;GM0984;2015;   18706;   11525;    7092;    5131;    1961;      89
3892;T001235;GM0984;2016;   18790;   11585;    7110;    5122;    1988;      95
3893;T001235;GM0984;2017;   18883;   11593;    7190;    5114;    2076;     100
3894;T001235;GM0984;2018;   18905;   11927;    6886;    5031;    1855;      92
3895;T001235;GM0984;2019;   19004;   12185;    6733;    4994;    1739;      86
3896;T001235;GM0984;2020;   19137;   12224;    6802;    5045;    1757;     111
3897;T001235;GM0620;2012;    8056;    5011;    3041;    2622;     419;       4
3898;T001235;GM0620;2013;    8117;    5069;    3044;    2623;     421;       4
3899;T001235;GM0620;2014;    8172;    5084;    3085;    2650;     435;       3
3900;T001235;GM0620;2015;    8182;    5102;    3074;    2644;     430;       6
3901;T001235;GM0620;2016;    8252;    5124;    3122;    2686;     436;       6
3902;T001235;GM0620;2017;    8346;    5147;    3195;    2746;     449;       4
3903;T001235;GM0620;2018;    8437;    5289;    3123;    2673;     450;      25
3904;T001235;GM0620;2019;;;;;;
3905;T001235;GM0620;2020;;;;;;
3906;T001235;GM1961;2012;;;;;;
3907;T001235;GM1961;2013;;;;;;
3908;T001235;GM1961;2014;;;;;;
3909;T001235;GM1961;2015;;;;;;
3910;T001235;GM1961;2016;;;;;;
3911;T001235;GM1961;2017;;;;;;
3912;T001235;GM1961;2018;;;;;;
3913;T001235;GM1961;2019;   23418;   14522;    8845;    7316;    1529;      51
3914;T001235;GM1961;2020;   23824;   14852;    8936;    7337;    1599;      36
3915;T001235;GM0622;2012;   34339;   15567;   18589;   16391;    2198;     183
3916;T001235;GM0622;2013;   34046;   15629;   18352;   16095;    2257;      65
3917;T001235;GM0622;2014;   34857;   15624;   18890;   16218;    2672;     343
3918;T001235;GM0622;2015;   34927;   15615;   18960;   16228;    2732;     352
3919;T001235;GM0622;2016;   34768;   15779;   18619;   15761;    2858;     370
3920;T001235;GM0622;2017;   34901;   15843;   18707;   15817;    2890;     351
3921;T001235;GM0622;2018;   35126;   16137;   18559;   15705;    2854;     430
3922;T001235;GM0622;2019;   35159;   16539;   18596;   15343;    3253;      24
3923;T001235;GM0622;2020;   35470;   16689;   18726;   15402;    3324;      55
3924;T001235;GM0048;2012;    7494;    5032;    2410;    1782;     628;      52
3925;T001235;GM0048;2013;    7503;    5032;    2438;    1761;     677;      33
3926;T001235;GM0048;2014;    7436;    4860;    2463;    1829;     634;     113
3927;T001235;GM0048;2015;    7643;    4913;    2471;    1819;     652;     259
3928;T001235;GM0048;2016;    7724;    4904;    2488;    1814;     674;     332
3929;T001235;GM0048;2017;    7856;    4860;    2534;    1806;     728;     462
3930;T001235;GM0048;2018;;;;;;
3931;T001235;GM0048;2019;;;;;;
3932;T001235;GM0048;2020;;;;;;
3933;T001235;GM0096;2012;     571;     253;     299;     203;      96;      19
3934;T001235;GM0096;2013;     570;     251;     302;     196;     106;      17
3935;T001235;GM0096;2014;     568;     259;     297;     195;     102;      12
3936;T001235;GM0096;2015;     527;     225;     287;     180;     107;      15
3937;T001235;GM0096;2016;     540;     228;     296;     187;     109;      16
3938;T001235;GM0096;2017;     542;     226;     297;     186;     111;      19
3939;T001235;GM0096;2018;     551;     218;     309;     188;     121;      24
3940;T001235;GM0096;2019;     564;     232;     323;     188;     135;       9
3941;T001235;GM0096;2020;     579;     224;     346;     187;     159;       9
3942;T001235;GM0718;2012;   21907;   12344;    9540;    7209;    2331;      23
3943;T001235;GM0718;2013;   22154;   12360;    9659;    7197;    2462;     135
3944;T001235;GM0718;2014;   22324;   12384;    9715;    7080;    2635;     225
3945;T001235;GM0718;2015;   22378;   12433;    9702;    7015;    2687;     243
3946;T001235;GM0718;2016;   22434;   12469;    9666;    6949;    2717;     299
3947;T001235;GM0718;2017;   22488;   12454;    9695;    6892;    2803;     339
3948;T001235;GM0718;2018;   22796;   12537;    9923;    6895;    3028;     336
3949;T001235;GM0718;2019;   22843;   12779;    9990;    6788;    3202;      74
3950;T001235;GM0718;2020;   22907;   12753;   10037;    6775;    3262;     117
3951;T001235;GM0623;2012;    3958;    2582;    1304;    1037;     267;      72
3952;T001235;GM0623;2013;    3954;    2617;    1305;    1024;     281;      32
3953;T001235;GM0623;2014;    3980;    2652;    1301;    1026;     275;      27
3954;T001235;GM0623;2015;;;;;;
3955;T001235;GM0623;2016;;;;;;
3956;T001235;GM0623;2017;;;;;;
3957;T001235;GM0623;2018;;;;;;
3958;T001235;GM0623;2019;;;;;;
3959;T001235;GM0623;2020;;;;;;
3960;T001235;GM0986;2012;    5439;    3862;    1543;    1122;     421;      34
3961;T001235;GM0986;2013;    5549;    3893;    1619;    1171;     448;      37
3962;T001235;GM0986;2014;    5618;    3909;    1612;    1162;     450;      97
3963;T001235;GM0986;2015;    5680;    3958;    1619;    1172;     447;     103
3964;T001235;GM0986;2016;    5733;    3942;    1641;    1171;     470;     150
3965;T001235;GM0986;2017;    5766;    3949;    1674;    1187;     487;     143
3966;T001235;GM0986;2018;    5759;    4051;    1563;    1162;     401;     145
3967;T001235;GM0986;2019;    5777;    4105;    1656;    1164;     492;      16
3968;T001235;GM0986;2020;    5819;    4100;    1703;    1191;     512;      16
3969;T001235;GM0626;2012;   10951;    6882;    4037;    2459;    1578;      32
3970;T001235;GM0626;2013;   10975;    6909;    4034;    2470;    1564;      32
3971;T001235;GM0626;2014;   11086;    6911;    4034;    2450;    1584;     141
3972;T001235;GM0626;2015;   11090;    7017;    3927;    2443;    1484;     146
3973;T001235;GM0626;2016;   11210;    7047;    3971;    2455;    1516;     192
3974;T001235;GM0626;2017;   11367;    7114;    4013;    2474;    1539;     240
3975;T001235;GM0626;2018;   11442;    7093;    4115;    2473;    1642;     234
3976;T001235;GM0626;2019;   11448;    7225;    4177;    2517;    1660;      46
3977;T001235;GM0626;2020;   11465;    7241;    4207;    2511;    1696;      17
3978;T001235;GM0285;2012;    9408;    6296;    3002;    2345;     657;     110
3979;T001235;GM0285;2013;    9443;    6347;    3053;    2357;     696;      43
3980;T001235;GM0285;2014;    9621;    6359;    3207;    2360;     847;      55
3981;T001235;GM0285;2015;    9791;    6442;    3320;    2449;     871;      29
3982;T001235;GM0285;2016;   10174;    6529;    3234;    2437;     797;     411
3983;T001235;GM0285;2017;   10447;    6682;    3277;    2437;     840;     488
3984;T001235;GM0285;2018;   10495;    6784;    3215;    2427;     788;     496
3985;T001235;GM0285;2019;   10545;    6944;    3588;    2524;    1064;      13
3986;T001235;GM0285;2020;   10641;    7065;    3564;    2487;    1077;      12
3987;T001235;GM0865;2012;   10619;    6507;    4078;    3072;    1006;      34
3988;T001235;GM0865;2013;   10800;    6586;    4186;    3145;    1041;      28
3989;T001235;GM0865;2014;   11058;    6567;    4405;    3011;    1394;      86
3990;T001235;GM0865;2015;   11179;    6686;    4404;    3022;    1382;      89
3991;T001235;GM0865;2016;   11257;    6809;    4361;    2992;    1369;      87
3992;T001235;GM0865;2017;   11349;    6879;    4385;    3066;    1319;      85
3993;T001235;GM0865;2018;   11394;    7043;    4267;    3044;    1223;      84
3994;T001235;GM0865;2019;   11491;    7177;    4311;    3070;    1241;       3
3995;T001235;GM0865;2020;   11519;    7194;    4322;    2954;    1368;       3
3996;T001235;GM1949;2012;;;;;;
3997;T001235;GM1949;2013;;;;;;
3998;T001235;GM1949;2014;;;;;;
3999;T001235;GM1949;2015;;;;;;
4000;T001235;GM1949;2016;;;;;;
4001;T001235;GM1949;2017;;;;;;
4002;T001235;GM1949;2018;   21006;   14148;    6710;    5143;    1567;     148
4003;T001235;GM1949;2019;   21112;   14253;    6829;    5336;    1493;      30
4004;T001235;GM1949;2020;   21228;   14289;    6907;    5306;    1601;      32
4005;T001235;GM0866;2012;    7030;    5418;    1579;    1158;     421;      33
4006;T001235;GM0866;2013;    7035;    5400;    1602;    1155;     447;      33
4007;T001235;GM0866;2014;    7436;    5537;    1876;    1286;     590;      23
4008;T001235;GM0866;2015;    7506;    5538;    1936;    1334;     602;      32
4009;T001235;GM0866;2016;    7556;    5612;    1922;    1330;     592;      22
4010;T001235;GM0866;2017;    7551;    5635;    1892;    1295;     597;      24
4011;T001235;GM0866;2018;    7564;    5680;    1864;    1289;     575;      20
4012;T001235;GM0866;2019;    7607;    5745;    1846;    1277;     569;      16
4013;T001235;GM0866;2020;    7765;    5812;    1948;    1258;     690;       5
4014;T001235;GM0867;2012;   20138;   12056;    8035;    6602;    1433;      47
4015;T001235;GM0867;2013;   20338;   12132;    8166;    6624;    1542;      40
4016;T001235;GM0867;2014;   20578;   12176;    8271;    6635;    1636;     131
4017;T001235;GM0867;2015;   20761;   12250;    8334;    6689;    1645;     177
4018;T001235;GM0867;2016;   20952;   12369;    8399;    6710;    1689;     184
4019;T001235;GM0867;2017;   21242;   12453;    8631;    6794;    1837;     158
4020;T001235;GM0867;2018;   21538;   12910;    8448;    6644;    1804;     180
4021;T001235;GM0867;2019;   21782;   13193;    8556;    6866;    1690;      33
4022;T001235;GM0867;2020;   21948;   13241;    8676;    6864;    1812;      31
4023;T001235;GM0627;2012;   10398;    6137;    4239;    3243;     996;      22
4024;T001235;GM0627;2013;   10529;    6235;    4282;    3267;    1015;      12
4025;T001235;GM0627;2014;   10784;    6356;    4338;    3317;    1021;      90
4026;T001235;GM0627;2015;   11021;    6470;    4458;    3354;    1104;      93
4027;T001235;GM0627;2016;   11248;    6615;    4545;    3433;    1112;      88
4028;T001235;GM0627;2017;   11339;    6752;    4493;    3418;    1075;      94
4029;T001235;GM0627;2018;   11746;    7105;    4544;    3439;    1105;      97
4030;T001235;GM0627;2019;   11970;    7440;    4524;    3455;    1069;       6
4031;T001235;GM0627;2020;   12332;    7783;    4540;    3448;    1092;       9
4032;T001235;GM0289;2012;   14486;    6725;    7040;    5294;    1746;     721
4033;T001235;GM0289;2013;   18578;    6958;   10216;    5351;    4865;    1404
4034;T001235;GM0289;2014;   19236;    6978;   11110;    5422;    5688;    1148
4035;T001235;GM0289;2015;   19530;    6998;   11403;    7522;    3881;    1129
4036;T001235;GM0289;2016;   19648;    7055;   11452;    7187;    4265;    1141
4037;T001235;GM0289;2017;   16836;    7044;    9520;    5718;    3802;     272
4038;T001235;GM0289;2018;   17181;    7155;    9804;    6408;    3396;     222
4039;T001235;GM0289;2019;   17483;    7475;    9983;    6998;    2985;      25
4040;T001235;GM0289;2020;   17721;    7579;   10126;    6998;    3128;      16
4041;T001235;GM0629;2012;   12078;    6505;    5422;    3176;    2246;     151
4042;T001235;GM0629;2013;   12100;    6461;    5491;    3164;    2327;     148
4043;T001235;GM0629;2014;   12152;    6506;    5461;    3127;    2334;     185
4044;T001235;GM0629;2015;   12192;    6626;    5472;    3227;    2245;      94
4045;T001235;GM0629;2016;   12213;    6715;    5401;    3201;    2200;      97
4046;T001235;GM0629;2017;   12220;    6680;    5450;    3194;    2256;      90
4047;T001235;GM0629;2018;   12176;    6698;    5370;    3142;    2228;     108
4048;T001235;GM0629;2019;   12191;    6839;    5222;    3165;    2057;     130
4049;T001235;GM0629;2020;   12222;    6895;    5195;    3189;    2006;     132
4050;T001235;GM0852;2012;    7026;    4654;    2286;    1862;     424;      86
4051;T001235;GM0852;2013;    7033;    4667;    2281;    1852;     429;      85
4052;T001235;GM0852;2014;    7076;    4708;    2283;    1827;     456;      85
4053;T001235;GM0852;2015;    7228;    4795;    2344;    1850;     494;      89
4054;T001235;GM0852;2016;    7280;    4855;    2346;    1884;     462;      79
4055;T001235;GM0852;2017;    7241;    4859;    2355;    1883;     472;      27
4056;T001235;GM0852;2018;    7260;    4969;    2258;    1882;     376;      33
4057;T001235;GM0852;2019;    7289;    5049;    2232;    1883;     349;       8
4058;T001235;GM0852;2020;    7319;    5067;    2246;    1869;     377;       6
4059;T001235;GM0988;2012;   21276;   14443;    6713;    4914;    1799;     120
4060;T001235;GM0988;2013;   21619;   14517;    6973;    5101;    1872;     129
4061;T001235;GM0988;2014;   22380;   14571;    7337;    5324;    2013;     472
4062;T001235;GM0988;2015;   22349;   14274;    7611;    5212;    2399;     464
4063;T001235;GM0988;2016;   22504;   14321;    7705;    5268;    2437;     478
4064;T001235;GM0988;2017;   22402;   14402;    7721;    5241;    2480;     279
4065;T001235;GM0988;2018;   22626;   14718;    7606;    5008;    2598;     302
4066;T001235;GM0988;2019;   22769;   15082;    7546;    5375;    2171;     141
4067;T001235;GM0988;2020;   22948;   15161;    7642;    5351;    2291;     145
4068;T001235;GM0457;2012;    8387;    4414;    3964;    3214;     750;       9
4069;T001235;GM0457;2013;    8421;    4445;    3968;    3205;     763;       8
4070;T001235;GM0457;2014;    8673;    4460;    4100;    3298;     802;     113
4071;T001235;GM0457;2015;    8715;    4553;    4047;    3246;     801;     115
4072;T001235;GM0457;2016;    8644;    4653;    3867;    3078;     789;     124
4073;T001235;GM0457;2017;    8748;    4660;    3901;    3046;     855;     187
4074;T001235;GM0457;2018;    8951;    4836;    3958;    3023;     935;     157
4075;T001235;GM0457;2019;    9008;    4951;    4015;    3028;     987;      42
4076;T001235;GM0457;2020;    9197;    5083;    4070;    3022;    1048;      44
4077;T001235;GM0870;2012;   10212;    6623;    3557;    2963;     594;      32
4078;T001235;GM0870;2013;   10200;    6633;    3534;    2933;     601;      33
4079;T001235;GM0870;2014;   10208;    6666;    3508;    2888;     620;      34
4080;T001235;GM0870;2015;   10415;    6816;    3566;    2905;     661;      33
4081;T001235;GM0870;2016;   10520;    6913;    3558;    2896;     662;      49
4082;T001235;GM0870;2017;   10594;    6995;    3575;    2885;     690;      24
4083;T001235;GM0870;2018;   10830;    7211;    3588;    2910;     678;      31
4084;T001235;GM0870;2019;;;;;;
4085;T001235;GM0870;2020;;;;;;
4086;T001235;GM1960;2012;;;;;;
4087;T001235;GM1960;2013;;;;;;
4088;T001235;GM1960;2014;;;;;;
4089;T001235;GM1960;2015;;;;;;
4090;T001235;GM1960;2016;;;;;;
4091;T001235;GM1960;2017;;;;;;
4092;T001235;GM1960;2018;;;;;;
4093;T001235;GM1960;2019;   20710;   14742;    5707;    4507;    1200;     261
4094;T001235;GM1960;2020;   20875;   14948;    5693;    4445;    1248;     234
4095;T001235;GM0668;2012;    7520;    5256;    2133;    1606;     527;     131
4096;T001235;GM0668;2013;    7647;    5300;    2230;    1647;     583;     117
4097;T001235;GM0668;2014;    7765;    5360;    2281;    1651;     630;     124
4098;T001235;GM0668;2015;    7871;    5437;    2315;    1671;     644;     119
4099;T001235;GM0668;2016;    7960;    5567;    2262;    1667;     595;     131
4100;T001235;GM0668;2017;    7959;    5520;    2304;    1658;     646;     135
4101;T001235;GM0668;2018;    8016;    5574;    2337;    1663;     674;     105
4102;T001235;GM0668;2019;    8100;    5756;    2327;    1669;     658;      17
4103;T001235;GM0668;2020;    8222;    5834;    2366;    1677;     689;      22
4104;T001235;GM1969;2012;;;;;;
4105;T001235;GM1969;2013;;;;;;
4106;T001235;GM1969;2014;;;;;;
4107;T001235;GM1969;2015;;;;;;
4108;T001235;GM1969;2016;;;;;;
4109;T001235;GM1969;2017;;;;;;
4110;T001235;GM1969;2018;;;;;;
4111;T001235;GM1969;2019;   27045;   19360;    7623;    5820;    1803;      62
4112;T001235;GM1969;2020;   27309;   19593;    7651;    5819;    1832;      65
4113;T001235;GM1701;2012;    8087;    5800;    2224;    1522;     702;      63
4114;T001235;GM1701;2013;    8235;    5880;    2266;    1508;     758;      89
4115;T001235;GM1701;2014;    8250;    5879;    2279;    1496;     783;      92
4116;T001235;GM1701;2015;    8257;    5893;    2338;    1519;     819;      26
4117;T001235;GM1701;2016;    8312;    5953;    2282;    1473;     809;      77
4118;T001235;GM1701;2017;    8395;    5955;    2295;    1449;     846;     145
4119;T001235;GM1701;2018;    8454;    6211;    2148;    1490;     658;      95
4120;T001235;GM1701;2019;    8515;    6322;    2182;    1535;     647;      11
4121;T001235;GM1701;2020;    8529;    6333;    2187;    1527;     660;       9
4122;T001235;GM0293;2012;    6414;    3676;    2736;    2184;     552;       2
4123;T001235;GM0293;2013;    6427;    3692;    2734;    2179;     555;       1
4124;T001235;GM0293;2014;    6453;    3687;    2765;    2193;     572;       1
4125;T001235;GM0293;2015;    6544;    3717;    2826;    2236;     590;       1
4126;T001235;GM0293;2016;    6578;    3756;    2822;    2236;     586;       0
4127;T001235;GM0293;2017;    6613;    3774;    2839;    2079;     760;       0
4128;T001235;GM0293;2018;    6662;    3849;    2810;    2082;     728;       3
4129;T001235;GM0293;2019;    6690;    3924;    2750;    2105;     645;      16
4130;T001235;GM0293;2020;    6723;    3953;    2755;    2105;     650;      15
4131;T001235;GM1950;2012;;;;;;
4132;T001235;GM1950;2013;;;;;;
4133;T001235;GM1950;2014;;;;;;
4134;T001235;GM1950;2015;;;;;;
4135;T001235;GM1950;2016;;;;;;
4136;T001235;GM1950;2017;;;;;;
4137;T001235;GM1950;2018;   11963;    7959;    3510;    2604;     906;     494
4138;T001235;GM1950;2019;   11969;    8036;    3606;    2667;     939;     327
4139;T001235;GM1950;2020;   11982;    8039;    3610;    2667;     943;     333
4140;T001235;GM1783;2012;   40761;   26822;   13572;   10686;    2886;     367
4141;T001235;GM1783;2013;   41185;   27166;   13715;   10632;    3083;     304
4142;T001235;GM1783;2014;   41692;   27276;   14137;   10804;    3333;     279
4143;T001235;GM1783;2015;   42339;   27782;   14298;   10732;    3566;     259
4144;T001235;GM1783;2016;   42622;   28241;   14051;   10733;    3318;     330
4145;T001235;GM1783;2017;   43187;   28575;   14296;   10748;    3548;     316
4146;T001235;GM1783;2018;   43636;   28885;   14454;   10720;    3734;     297
4147;T001235;GM1783;2019;   44441;   30364;   13856;   10829;    3027;     221
4148;T001235;GM1783;2020;   45063;   30896;   14030;   10843;    3187;     137
4149;T001235;GM0098;2012;   11210;    6833;    4353;    3416;     937;      24
4150;T001235;GM0098;2013;   11275;    6879;    4381;    3415;     966;      15
4151;T001235;GM0098;2014;   11358;    6910;    4436;    3420;    1016;      12
4152;T001235;GM0098;2015;   11410;    6962;    4436;    3423;    1013;      12
4153;T001235;GM0098;2016;   11495;    7018;    4458;    3426;    1032;      19
4154;T001235;GM0098;2017;   11536;    7061;    4456;    3402;    1054;      19
4155;T001235;GM0098;2018;   11599;    7347;    4223;    3379;     844;      29
4156;T001235;GM0098;2019;   11620;    7478;    4121;    3188;     933;      21
4157;T001235;GM0098;2020;   11711;    7562;    4125;    3225;     900;      24
4158;T001235;GM0614;2012;    6484;    4535;    1933;     339;    1594;      16
4159;T001235;GM0614;2013;    6509;    4522;    1975;     340;    1635;      12
4160;T001235;GM0614;2014;    6695;    4614;    2023;     339;    1684;      58
4161;T001235;GM0614;2015;    6708;    4732;    1911;     335;    1576;      65
4162;T001235;GM0614;2016;    6732;    4765;    1907;     331;    1576;      60
4163;T001235;GM0614;2017;    6747;    4793;    1893;     330;    1563;      61
4164;T001235;GM0614;2018;    6793;    4851;    1880;     360;    1520;      62
4165;T001235;GM0614;2019;    6831;    4946;    1868;     403;    1465;      17
4166;T001235;GM0614;2020;    6890;    5005;    1871;     401;    1470;      14
4167;T001235;GM0189;2012;    9326;    6777;    2495;    1778;     717;      54
4168;T001235;GM0189;2013;    9409;    6851;    2510;    1737;     773;      48
4169;T001235;GM0189;2014;    9542;    6899;    2596;    1727;     869;      47
4170;T001235;GM0189;2015;    9596;    6993;    2561;    1688;     873;      42
4171;T001235;GM0189;2016;    9456;    6964;    2454;    1640;     814;      38
4172;T001235;GM0189;2017;    9645;    7002;    2611;    1760;     851;      32
4173;T001235;GM0189;2018;    9660;    7088;    2548;    1716;     832;      24
4174;T001235;GM0189;2019;    9727;    7095;    2555;    1753;     802;      77
4175;T001235;GM0189;2020;    9860;    7152;    2606;    1709;     897;     102
4176;T001235;GM0296;2012;   16920;   11386;    5510;    4359;    1151;      24
4177;T001235;GM0296;2013;   17187;   11428;    5738;    4524;    1214;      21
4178;T001235;GM0296;2014;   17440;   11499;    5772;    4515;    1257;     169
4179;T001235;GM0296;2015;   17506;   11564;    5771;    4330;    1441;     171
4180;T001235;GM0296;2016;   17518;   11595;    5769;    4469;    1300;     154
4181;T001235;GM0296;2017;   17535;   11549;    5830;    4440;    1390;     156
4182;T001235;GM0296;2018;   17843;   11853;    5795;    4443;    1352;     195
4183;T001235;GM0296;2019;   17885;   12053;    5764;    4561;    1203;      68
4184;T001235;GM0296;2020;   18023;   12161;    5798;    4543;    1255;      64
4185;T001235;GM1696;2012;   10181;    6927;    3131;    2062;    1069;     123
4186;T001235;GM1696;2013;   10315;    6940;    3277;    2055;    1222;      98
4187;T001235;GM1696;2014;   10347;    6935;    3332;    2052;    1280;      80
4188;T001235;GM1696;2015;   10344;    6929;    3332;    2037;    1295;      83
4189;T001235;GM1696;2016;   10381;    6935;    3342;    2030;    1312;     104
4190;T001235;GM1696;2017;   10583;    6996;    3452;    2026;    1426;     135
4191;T001235;GM1696;2018;   10618;    7211;    3309;    2043;    1266;      98
4192;T001235;GM1696;2019;   10707;    7352;    3319;    2063;    1256;      36
4193;T001235;GM1696;2020;   10691;    7387;    3275;    2080;    1195;      29
4194;T001235;GM0352;2012;    9337;    6228;    3102;    2376;     726;       7
4195;T001235;GM0352;2013;    9461;    6325;    3113;    2349;     764;      23
4196;T001235;GM0352;2014;    9644;    6427;    3185;    2310;     875;      32
4197;T001235;GM0352;2015;    9753;    6522;    3193;    2433;     760;      38
4198;T001235;GM0352;2016;    9857;    6671;    3147;    2366;     781;      39
4199;T001235;GM0352;2017;    9934;    6726;    3146;    2392;     754;      62
4200;T001235;GM0352;2018;    9979;    6774;    3146;    2348;     798;      59
4201;T001235;GM0352;2019;    9968;    6979;    2963;    2378;     585;      26
4202;T001235;GM0352;2020;   10107;    7096;    2988;    2367;     621;      23
4203;T001235;GM0053;2012;    5825;    4113;    1704;    1455;     249;       8
4204;T001235;GM0053;2013;    5890;    4171;    1714;    1455;     259;       5
4205;T001235;GM0053;2014;    6017;    4180;    1835;    1480;     355;       2
4206;T001235;GM0053;2015;    6044;    4182;    1862;    1537;     325;       0
4207;T001235;GM0053;2016;    6029;    4181;    1848;    1469;     379;       0
4208;T001235;GM0053;2017;    6021;    4177;    1842;    1452;     390;       2
4209;T001235;GM0053;2018;    6026;    4160;    1863;    1449;     414;       3
4210;T001235;GM0053;2019;;;;;;
4211;T001235;GM0053;2020;;;;;;
4212;T001235;GM0294;2012;   12321;    8608;    3663;    2316;    1347;      50
4213;T001235;GM0294;2013;   12685;    8828;    3815;    2355;    1460;      42
4214;T001235;GM0294;2014;   12795;    8807;    3956;    2306;    1650;      32
4215;T001235;GM0294;2015;   12861;    8825;    3996;    2345;    1651;      40
4216;T001235;GM0294;2016;   12891;    8873;    3981;    2304;    1677;      37
4217;T001235;GM0294;2017;   12933;    8890;    4007;    2306;    1701;      36
4218;T001235;GM0294;2018;   12993;    9117;    3827;    2330;    1497;      49
4219;T001235;GM0294;2019;   13087;    9209;    3867;    2407;    1460;      11
4220;T001235;GM0294;2020;   13139;    9217;    3908;    2399;    1509;      14
4221;T001235;GM0873;2012;    9226;    6590;    2418;    1794;     624;     218
4222;T001235;GM0873;2013;    9295;    6739;    2511;    1798;     713;      45
4223;T001235;GM0873;2014;    9538;    6842;    2644;    1817;     827;      52
4224;T001235;GM0873;2015;    9647;    6875;    2742;    1822;     920;      30
4225;T001235;GM0873;2016;    9642;    6879;    2730;    1767;     963;      33
4226;T001235;GM0873;2017;    9779;    6894;    2808;    1781;    1027;      77
4227;T001235;GM0873;2018;    9837;    6937;    2853;    1837;    1016;      47
4228;T001235;GM0873;2019;    9844;    7088;    2708;    1881;     827;      48
4229;T001235;GM0873;2020;    9866;    7084;    2743;    1866;     877;      39
4230;T001235;GM0632;2012;   20524;   13720;    6760;    4613;    2147;      44
4231;T001235;GM0632;2013;   20720;   13832;    6855;    4954;    1901;      33
4232;T001235;GM0632;2014;   20995;   13912;    6934;    4976;    1958;     149
4233;T001235;GM0632;2015;   21272;   14022;    7043;    4996;    2047;     207
4234;T001235;GM0632;2016;   21403;   14108;    7089;    5009;    2080;     206
4235;T001235;GM0632;2017;   21625;   14266;    7142;    5002;    2140;     217
4236;T001235;GM0632;2018;   21756;   14488;    7066;    5003;    2063;     202
4237;T001235;GM0632;2019;   22002;   14669;    7296;    5056;    2240;      37
4238;T001235;GM0632;2020;   22106;   14707;    7391;    5056;    2335;       8
4239;T001235;GM1690;2012;    9573;    7148;    2386;    1692;     694;      39
4240;T001235;GM1690;2013;    9599;    7156;    2407;    1685;     722;      36
4241;T001235;GM1690;2014;    9908;    7232;    2407;    1673;     734;     269
4242;T001235;GM1690;2015;   10018;    7235;    2572;    1797;     775;     211
4243;T001235;GM1690;2016;   10093;    7308;    2416;    1629;     787;     369
4244;T001235;GM1690;2017;   10084;    7310;    2457;    1576;     881;     317
4245;T001235;GM1690;2018;   10149;    7455;    2383;    1639;     744;     311
4246;T001235;GM1690;2019;   10265;    7571;    2668;    1840;     828;      26
4247;T001235;GM1690;2020;   10370;    7663;    2681;    1848;     833;      26
4248;T001235;GM0880;2012;    6520;    4061;    2428;    2066;     362;      31
4249;T001235;GM0880;2013;    6512;    4070;    2417;    2047;     370;      25
4250;T001235;GM0880;2014;    6664;    4096;    2510;    2048;     462;      58
4251;T001235;GM0880;2015;    6696;    4125;    2537;    2068;     469;      34
4252;T001235;GM0880;2016;    6684;    4141;    2492;    1999;     493;      51
4253;T001235;GM0880;2017;    6764;    4214;    2501;    1990;     511;      49
4254;T001235;GM0880;2018;    6803;    4405;    2347;    1947;     400;      51
4255;T001235;GM0880;2019;    6962;    4474;    2453;    2079;     374;      35
4256;T001235;GM0880;2020;    6971;    4472;    2489;    2058;     431;      10
4257;T001235;GM0351;2012;    4662;    3249;    1391;    1061;     330;      22
4258;T001235;GM0351;2013;    4821;    3341;    1463;    1111;     352;      17
4259;T001235;GM0351;2014;    4826;    3354;    1460;    1114;     346;      12
4260;T001235;GM0351;2015;    4849;    3376;    1453;    1104;     349;      20
4261;T001235;GM0351;2016;    4893;    3410;    1449;    1077;     372;      34
4262;T001235;GM0351;2017;    4963;    3425;    1512;    1050;     462;      26
4263;T001235;GM0351;2018;    5006;    3476;    1507;    1083;     424;      23
4264;T001235;GM0351;2019;    5102;    3689;    1401;    1075;     326;      12
4265;T001235;GM0351;2020;    5188;    3739;    1444;    1084;     360;       5
4266;T001235;GM0874;2012;    5639;    3574;    2037;    1728;     309;      28
4267;T001235;GM0874;2013;    5704;    3647;    2033;    1718;     315;      24
4268;T001235;GM0874;2014;    5746;    3677;    2059;    1714;     345;      10
4269;T001235;GM0874;2015;    5888;    3792;    2082;    1723;     359;      14
4270;T001235;GM0874;2016;    5931;    3902;    2015;    1671;     344;      14
4271;T001235;GM0874;2017;    5995;    3936;    2011;    1647;     364;      48
4272;T001235;GM0874;2018;    6081;    4044;    2022;    1657;     365;      15
4273;T001235;GM0874;2019;;;;;;
4274;T001235;GM0874;2020;;;;;;
4275;T001235;GM0479;2012;   65099;   33889;   31117;   26664;    4453;      93
4276;T001235;GM0479;2013;   66110;   34492;   31517;   26698;    4819;     101
4277;T001235;GM0479;2014;   66585;   34824;   31601;   26388;    5213;     160
4278;T001235;GM0479;2015;   66549;   35145;   31351;   26044;    5307;      53
4279;T001235;GM0479;2016;   66961;   35598;   31171;   25896;    5275;     192
4280;T001235;GM0479;2017;   67476;   35907;   31385;   25828;    5557;     184
4281;T001235;GM0479;2018;   68025;   36848;   30953;   25818;    5135;     224
4282;T001235;GM0479;2019;   68402;   37412;   30904;   25871;    5033;      86
4283;T001235;GM0479;2020;   68947;   37692;   31137;   25784;    5353;     118
4284;T001235;GM0297;2012;   10096;    6917;    3109;    2516;     593;      70
4285;T001235;GM0297;2013;   10336;    7045;    3246;    2615;     631;      45
4286;T001235;GM0297;2014;   10654;    7129;    3433;    2634;     799;      92
4287;T001235;GM0297;2015;   10801;    7242;    3470;    2651;     819;      89
4288;T001235;GM0297;2016;   10985;    7317;    3572;    2635;     937;      96
4289;T001235;GM0297;2017;   11030;    7354;    3585;    2597;     988;      91
4290;T001235;GM0297;2018;   11216;    7462;    3638;    2640;     998;     116
4291;T001235;GM0297;2019;   11401;    7683;    3709;    2775;     934;       9
4292;T001235;GM0297;2020;   11623;    7826;    3788;    2767;    1021;       9
4293;T001235;GM0473;2012;    9204;    4684;    4431;    2893;    1538;      89
4294;T001235;GM0473;2013;    9304;    4671;    4515;    2900;    1615;     118
4295;T001235;GM0473;2014;    9280;    4685;    4517;    2897;    1620;      78
4296;T001235;GM0473;2015;    9403;    4763;    4489;    2827;    1662;     151
4297;T001235;GM0473;2016;    9450;    4867;    4431;    2844;    1587;     152
4298;T001235;GM0473;2017;    9517;    4897;    4471;    2842;    1629;     149
4299;T001235;GM0473;2018;    9523;    4921;    4419;    2841;    1578;     183
4300;T001235;GM0473;2019;    9557;    4973;    4332;    2919;    1413;     252
4301;T001235;GM0473;2020;    9708;    5077;    4348;    2916;    1432;     283
4302;T001235;GM0707;2012;    5279;    3692;    1558;    1194;     364;      29
4303;T001235;GM0707;2013;    5316;    3720;    1571;    1204;     367;      25
4304;T001235;GM0707;2014;    5463;    3768;    1612;    1249;     363;      83
4305;T001235;GM0707;2015;    5470;    3783;    1601;    1245;     356;      86
4306;T001235;GM0707;2016;    5500;    3819;    1592;    1233;     359;      89
4307;T001235;GM0707;2017;    5550;    3857;    1606;    1255;     351;      87
4308;T001235;GM0707;2018;    5588;    3918;    1581;    1259;     322;      89
4309;T001235;GM0707;2019;;;;;;
4310;T001235;GM0707;2020;;;;;;
4311;T001235;GM0478;2012;    2542;    1981;     557;     461;      96;       4
4312;T001235;GM0478;2013;    2548;    1984;     560;     461;      99;       4
4313;T001235;GM0478;2014;    2564;    1999;     562;     454;     108;       3
4314;T001235;GM0478;2015;    2573;    2004;     560;     447;     113;       9
4315;T001235;GM0478;2016;;;;;;
4316;T001235;GM0478;2017;;;;;;
4317;T001235;GM0478;2018;;;;;;
4318;T001235;GM0478;2019;;;;;;
4319;T001235;GM0478;2020;;;;;;
4320;T001235;GM0050;2012;    7913;    5279;    2589;    1996;     593;      45
4321;T001235;GM0050;2013;    7959;    5307;    2615;    1992;     623;      37
4322;T001235;GM0050;2014;    8020;    5323;    2660;    2005;     655;      37
4323;T001235;GM0050;2015;    8127;    5430;    2663;    1991;     672;      34
4324;T001235;GM0050;2016;    8166;    5480;    2650;    1984;     666;      36
4325;T001235;GM0050;2017;    8305;    5584;    2687;    2003;     684;      34
4326;T001235;GM0050;2018;    8340;    5671;    2635;    1992;     643;      34
4327;T001235;GM0050;2019;    8553;    6014;    2534;    2005;     529;       5
4328;T001235;GM0050;2020;    8678;    6120;    2552;    1984;     568;       6
4329;T001235;GM0355;2012;   26534;   13471;   12795;    9448;    3347;     268
4330;T001235;GM0355;2013;   26976;   13709;   12876;    9453;    3423;     391
4331;T001235;GM0355;2014;   27033;   13708;   12943;    9283;    3660;     382
4332;T001235;GM0355;2015;   27830;   13800;   13361;    9519;    3842;     669
4333;T001235;GM0355;2016;   27957;   14026;   13225;    8728;    4497;     706
4334;T001235;GM0355;2017;   28251;   14277;   13274;    8627;    4647;     700
4335;T001235;GM0355;2018;   28555;   14305;   13433;    8704;    4729;     817
4336;T001235;GM0355;2019;   28777;   14951;   13745;    8593;    5152;      81
4337;T001235;GM0355;2020;   29245;   15259;   13834;    8608;    5226;     152
4338;T001235;GM0299;2012;   14062;    8504;    5528;    4304;    1224;      30
4339;T001235;GM0299;2013;   14507;    8882;    5591;    4306;    1285;      34
4340;T001235;GM0299;2014;   14541;    8888;    5623;    4251;    1372;      30
4341;T001235;GM0299;2015;   14614;    8930;    5623;    4254;    1369;      61
4342;T001235;GM0299;2016;   14677;    8987;    5621;    4237;    1384;      69
4343;T001235;GM0299;2017;   14795;    9095;    5631;    4231;    1400;      69
4344;T001235;GM0299;2018;   19684;   12230;    7390;    5734;    1656;      64
4345;T001235;GM0299;2019;   19796;   12522;    7241;    5786;    1455;      33
4346;T001235;GM0299;2020;   19970;   12657;    7292;    5785;    1507;      21
4347;T001235;GM0476;2012;    4807;    3407;    1286;     889;     397;     114
4348;T001235;GM0476;2013;;;;;;
4349;T001235;GM0476;2014;;;;;;
4350;T001235;GM0476;2015;;;;;;
4351;T001235;GM0476;2016;;;;;;
4352;T001235;GM0476;2017;;;;;;
4353;T001235;GM0476;2018;;;;;;
4354;T001235;GM0476;2019;;;;;;
4355;T001235;GM0476;2020;;;;;;
4356;T001235;GM0637;2012;   53029;   27811;   25182;   19725;    5457;      36
4357;T001235;GM0637;2013;   53868;   28162;   25696;   20264;    5432;      10
4358;T001235;GM0637;2014;   54809;   28744;   25615;   20180;    5435;     450
4359;T001235;GM0637;2015;   55050;   29046;   25550;   20151;    5399;     454
4360;T001235;GM0637;2016;   55377;   29304;   25549;   19946;    5603;     524
4361;T001235;GM0637;2017;   55826;   29753;   25640;   20030;    5610;     433
4362;T001235;GM0637;2018;   55944;   30157;   25323;   19806;    5517;     464
4363;T001235;GM0637;2019;   56199;   30601;   25521;   20205;    5316;      77
4364;T001235;GM0637;2020;   56458;   30897;   25474;   20097;    5377;      87
4365;T001235;GM0638;2012;    3204;    2297;     840;     615;     225;      67
4366;T001235;GM0638;2013;    3250;    2355;     875;     604;     271;      20
4367;T001235;GM0638;2014;    3334;    2377;     888;     614;     274;      69
4368;T001235;GM0638;2015;    3359;    2433;     853;     608;     245;      73
4369;T001235;GM0638;2016;    3365;    2439;     844;     603;     241;      82
4370;T001235;GM0638;2017;    3527;    2544;     907;     621;     286;      76
4371;T001235;GM0638;2018;    3493;    2536;     925;     639;     286;      32
4372;T001235;GM0638;2019;    3493;    2596;     895;     638;     257;       2
4373;T001235;GM0638;2020;    3532;    2629;     899;     635;     264;       4
4374;T001235;GM0056;2012;    7476;    5574;    1845;    1379;     466;      57
4375;T001235;GM0056;2013;    7474;    5591;    1832;    1370;     462;      51
4376;T001235;GM0056;2014;    7710;    5683;    2000;    1474;     526;      27
4377;T001235;GM0056;2015;    7732;    5687;    2019;    1486;     533;      26
4378;T001235;GM0056;2016;    7789;    5741;    2021;    1446;     575;      27
4379;T001235;GM0056;2017;    7800;    5734;    2044;    1444;     600;      22
4380;T001235;GM0056;2018;    7883;    5917;    1941;    1429;     512;      25
4381;T001235;GM0056;2019;;;;;;
4382;T001235;GM0056;2020;;;;;;
4383;T001235;GM1892;2012;   16175;   10541;    5587;    4665;     922;      47
4384;T001235;GM1892;2013;   16350;   10698;    5613;    4795;     818;      39
4385;T001235;GM1892;2014;   16712;   10858;    5679;    4796;     883;     175
4386;T001235;GM1892;2015;   16707;   10957;    5579;    4722;     857;     171
4387;T001235;GM1892;2016;   16787;   11081;    5524;    4678;     846;     182
4388;T001235;GM1892;2017;   17034;   11279;    5571;    4730;     841;     184
4389;T001235;GM1892;2018;   17237;   11197;    5865;    4751;    1114;     175
4390;T001235;GM1892;2019;   17563;   11835;    5653;    4761;     892;      75
4391;T001235;GM1892;2020;   18031;   12197;    5758;    4848;     910;      76
4392;T001235;GM0879;2012;    8972;    6715;    2231;    1177;    1054;      26
4393;T001235;GM0879;2013;    9049;    6750;    2280;    1200;    1080;      19
4394;T001235;GM0879;2014;    9076;    6744;    2315;    1194;    1121;      17
4395;T001235;GM0879;2015;    9163;    6757;    2385;    1233;    1152;      21
4396;T001235;GM0879;2016;    9197;    6762;    2406;    1241;    1165;      29
4397;T001235;GM0879;2017;    9280;    6786;    2461;    1246;    1215;      33
4398;T001235;GM0879;2018;    9408;    6792;    2545;    1263;    1282;      71
4399;T001235;GM0879;2019;    9455;    7029;    2402;    1276;    1126;      24
4400;T001235;GM0879;2020;    9472;    7079;    2371;    1271;    1100;      22
4401;T001235;GM0301;2012;   20988;   11544;    9299;    6365;    2934;     145
4402;T001235;GM0301;2013;   21324;   11589;    9528;    6420;    3108;     207
4403;T001235;GM0301;2014;   21638;   11645;    9669;    6730;    2939;     324
4404;T001235;GM0301;2015;   21695;   11670;    9754;    6611;    3143;     271
4405;T001235;GM0301;2016;   21698;   11759;    9665;    7152;    2513;     274
4406;T001235;GM0301;2017;   21806;   11803;    9729;    7139;    2590;     274
4407;T001235;GM0301;2018;   21971;   12113;    9578;    6955;    2623;     280
4408;T001235;GM0301;2019;   22095;   12341;    9720;    7019;    2701;      34
4409;T001235;GM0301;2020;   22267;   12486;    9758;    7033;    2725;      23
4410;T001235;GM1896;2012;    8352;    5769;    2402;    1802;     600;     181
4411;T001235;GM1896;2013;    8376;    5824;    2451;    1793;     658;     101
4412;T001235;GM1896;2014;    8461;    5844;    2490;    1788;     702;     127
4413;T001235;GM1896;2015;    8574;    5926;    2495;    1769;     726;     153
4414;T001235;GM1896;2016;    8648;    5972;    2531;    1787;     744;     145
4415;T001235;GM1896;2017;    8711;    5986;    2599;    1811;     788;     126
4416;T001235;GM1896;2018;    8817;    6178;    2524;    1815;     709;     115
4417;T001235;GM1896;2019;    8903;    6358;    2516;    1870;     646;      29
4418;T001235;GM1896;2020;    8942;    6420;    2491;    1821;     670;      31
4419;T001235;GM0642;2012;   20154;   10894;    9230;    7952;    1278;      30
4420;T001235;GM0642;2013;   20195;   10916;    9256;    7947;    1309;      23
4421;T001235;GM0642;2014;   20355;   11008;    9205;    7897;    1308;     142
4422;T001235;GM0642;2015;   20356;   11078;    9151;    7829;    1322;     127
4423;T001235;GM0642;2016;   20411;   11135;    9141;    7726;    1415;     135
4424;T001235;GM0642;2017;   20451;   11196;    9163;    7739;    1424;      92
4425;T001235;GM0642;2018;   20394;   11301;    8973;    7598;    1375;     120
4426;T001235;GM0642;2019;   20454;   11545;    8879;    7610;    1269;      30
4427;T001235;GM0642;2020;   20537;   11615;    8903;    7587;    1316;      19
4428;T001235;GM0193;2012;   53314;   28210;   24829;   18136;    6693;     275
4429;T001235;GM0193;2013;   53978;   28457;   25280;   18330;    6950;     241
4430;T001235;GM0193;2014;   54274;   28639;   25357;   18278;    7079;     278
4431;T001235;GM0193;2015;   54761;   28919;   25554;   18543;    7011;     288
4432;T001235;GM0193;2016;   55473;   29097;   26041;   18611;    7430;     335
4433;T001235;GM0193;2017;   56066;   29451;   26354;   18700;    7654;     261
4434;T001235;GM0193;2018;   56595;   29621;   26693;   18832;    7861;     281
4435;T001235;GM0193;2019;   57730;   30761;   26886;   19179;    7707;      83
4436;T001235;GM0193;2020;   58492;   31046;   27236;   19226;    8010;     210
4437;A028725;NL01  ;2012; 6975208; 4017623; 2922982; 2190987;  731995;   34603
4438;A028725;NL01  ;2013; 7055105; 4059105; 2969143; 2197399;  771744;   26857
4439;A028725;NL01  ;2014; 7143163; 4087530; 3017118; 2200331;  816787;   38515
4440;A028725;NL01  ;2015; 7211229; 4119362; 3057052; 2234114;  822938;   34815
4441;A028725;NL01  ;2016; 7276184; 4158379; 3077223; 2218789;  858434;   40582
4442;A028725;NL01  ;2017; 7331144; 4189012; 3102723; 2211578;  891145;   39409
4443;A028725;NL01  ;2018; 7398054; 4260602; 3095275; 2207510;  887765;   42177
4444;A028725;NL01  ;2019; 7469356; 4348316; 3102561; 2225000;  877561;   18479
4445;A028725;NL01  ;2020; 7547587; 4380084; 3145536; 2224790;  920746;   21967
4446;A028725;LD01  ;2012;  723925;  446936;  273797;  209056;   64741;    3192
4447;A028725;LD01  ;2013;  730563;  450347;  278054;  209559;   68495;    2162
4448;A028725;LD01  ;2014;  740278;  452058;  283903;  210043;   73860;    4317
4449;A028725;LD01  ;2015;  745634;  453546;  287606;  213573;   74033;    4482
4450;A028725;LD01  ;2016;  750422;  455968;  289152;  212290;   76862;    5302
4451;A028725;LD01  ;2017;  755708;  458306;  292070;  211742;   80328;    5332
4452;A028725;LD01  ;2018;  760123;  465097;  289011;  210187;   78824;    6015
4453;A028725;LD01  ;2019;  765596;  472919;  290951;  212686;   78265;    1726
4454;A028725;LD01  ;2020;  772132;  475079;  294855;  211789;   83066;    2198
4455;A028725;LD02  ;2012; 1411081;  867552;  535264;  406487;  128777;    8265
4456;A028725;LD02  ;2013; 1431622;  877060;  546515;  408789;  137726;    8047
4457;A028725;LD02  ;2014; 1448261;  882741;  555826;  408390;  147436;    9694
4458;A028725;LD02  ;2015; 1462277;  889789;  564144;  418062;  146082;    8344
4459;A028725;LD02  ;2016; 1476503;  899148;  568279;  417084;  151195;    9076
4460;A028725;LD02  ;2017; 1486785;  904389;  573933;  415674;  158259;    8463
4461;A028725;LD02  ;2018; 1501981;  924111;  568896;  416656;  152240;    8974
4462;A028725;LD02  ;2019; 1519079;  944056;  571309;  421765;  149544;    3714
4463;A028725;LD02  ;2020; 1536743;  953503;  578886;  423131;  155755;    4354
4464;A028725;LD03  ;2012; 3356619; 1781182; 1556486; 1149230;  407256;   18951
4465;A028725;LD03  ;2013; 3391391; 1801432; 1576082; 1148714;  427368;   13877
4466;A028725;LD03  ;2014; 3432174; 1815914; 1597574; 1147338;  450236;   18686
4467;A028725;LD03  ;2015; 3465799; 1835107; 1614715; 1163822;  450893;   15977
4468;A028725;LD03  ;2016; 3499689; 1855935; 1624723; 1152196;  472527;   19031
4469;A028725;LD03  ;2017; 3526644; 1873574; 1635613; 1147508;  488105;   17457
4470;A028725;LD03  ;2018; 3557850; 1901574; 1637741; 1144565;  493176;   18535
4471;A028725;LD03  ;2019; 3591816; 1945805; 1636414; 1149017;  487397;    9597
4472;A028725;LD03  ;2020; 3630950; 1959292; 1660213; 1147993;  512220;   11445
4473;A028725;LD04  ;2012; 1483583;  921953;  557435;  426214;  131221;    4195
4474;A028725;LD04  ;2013; 1501529;  930266;  568492;  430337;  138155;    2771
4475;A028725;LD04  ;2014; 1522450;  936817;  579815;  434560;  145255;    5818
4476;A028725;LD04  ;2015; 1537519;  940920;  590587;  438657;  151930;    6012
4477;A028725;LD04  ;2016; 1549570;  947328;  595069;  437219;  157850;    7173
4478;A028725;LD04  ;2017; 1562007;  952743;  601107;  436654;  164453;    8157
4479;A028725;LD04  ;2018; 1578100;  969820;  599627;  436102;  163525;    8653
4480;A028725;LD04  ;2019; 1592865;  985536;  603887;  441532;  162355;    3442
4481;A028725;LD04  ;2020; 1607762;  992210;  611582;  441877;  169705;    3970
4482;A028725;PV20  ;2012;  250946;  142846;  106455;   77519;   28936;    1645
4483;A028725;PV20  ;2013;  253549;  143487;  109064;   78300;   30764;     998
4484;A028725;PV20  ;2014;  257294;  143726;  112217;   79069;   33148;    1351
4485;A028725;PV20  ;2015;  259458;  144116;  114295;   81739;   32556;    1047
4486;A028725;PV20  ;2016;  261641;  144866;  115489;   81304;   34185;    1286
4487;A028725;PV20  ;2017;  263918;  145709;  117099;   81093;   36006;    1110
4488;A028725;PV20  ;2018;  264623;  147923;  115213;   79438;   35775;    1487
4489;A028725;PV20  ;2019;  266736;  149799;  116393;   79966;   36427;     544
4490;A028725;PV20  ;2020;  269174;  150147;  118063;   79695;   38368;     964
4491;A028725;Friesland (PV)  ;2012;  270451;  169582;  100089;   79259;   20830;     780
4492;A028725;Friesland (PV)  ;2013;  273618;  171572;  101427;   79289;   22138;     619
4493;A028725;Friesland (PV)  ;2014;  276925;  172209;  102976;   79079;   23897;    1740
4494;A028725;Friesland (PV)  ;2015;  279129;  172920;  103974;   79906;   24068;    2235
4495;A028725;Friesland (PV)  ;2016;  280642;  173612;  104523;   78759;   25764;    2507
4496;A028725;Friesland (PV)  ;2017;  282194;  174594;  105066;   78342;   26724;    2534
4497;A028725;Friesland (PV)  ;2018;  284229;  177375;  104105;   78391;   25714;    2749
4498;A028725;Friesland (PV)  ;2019;  286136;  180547;  104845;   79338;   25507;     744
4499;A028725;Friesland (PV)  ;2020;  288553;  181414;  106445;   79013;   27432;     694
4500;A028725;Drenthe (PV)  ;2012;  202528;  134508;   67253;   52278;   14975;     767
4501;A028725;Drenthe (PV)  ;2013;  203396;  135288;   67563;   51970;   15593;     545
4502;A028725;Drenthe (PV)  ;2014;  206059;  136123;   68710;   51895;   16815;    1226
4503;A028725;Drenthe (PV)  ;2015;  207047;  136510;   69337;   51928;   17409;    1200
4504;A028725;Drenthe (PV)  ;2016;  208139;  137490;   69140;   52227;   16913;    1509
4505;A028725;Drenthe (PV)  ;2017;  209596;  138003;   69905;   52307;   17598;    1688
4506;A028725;Drenthe (PV)  ;2018;  211271;  139799;   69693;   52358;   17335;    1779
4507;A028725;Drenthe (PV)  ;2019;  212724;  142573;   69713;   53382;   16331;     438
4508;A028725;Drenthe (PV)  ;2020;  214405;  143518;   70347;   53081;   17266;     540
4509;A028725;Overijssel (PV)  ;2012;  457187;  278890;  175674;  134294;   41380;    2623
4510;A028725;Overijssel (PV)  ;2013;  461190;  281344;  177992;  134306;   43686;    1854
4511;A028725;Overijssel (PV)  ;2014;  464438;  282714;  179535;  133660;   45875;    2189
4512;A028725;Overijssel (PV)  ;2015;  468017;  284671;  181073;  136616;   44457;    2273
4513;A028725;Overijssel (PV)  ;2016;  472295;  286574;  182867;  134806;   48061;    2854
4514;A028725;Overijssel (PV)  ;2017;  476750;  287776;  186229;  136153;   50076;    2745
4515;A028725;Overijssel (PV)  ;2018;  480112;  294673;  182773;  135426;   47347;    2666
4516;A028725;Overijssel (PV)  ;2019;  484918;  299671;  184320;  136209;   48111;     927
4517;A028725;Overijssel (PV)  ;2020;  490153;  302099;  186869;  136564;   50305;    1185
4518;A028725;Flevoland (PV)  ;2012;  151636;   98817;   52413;   42043;   10370;     406
4519;A028725;Flevoland (PV)  ;2013;  153058;   99930;   52837;   41759;   11078;     291
4520;A028725;Flevoland (PV)  ;2014;  155257;  100792;   53876;   42069;   11807;     589
4521;A028725;Flevoland (PV)  ;2015;  156665;  101662;   54435;   42215;   12220;     568
4522;A028725;Flevoland (PV)  ;2016;  158004;  102688;   54816;   42472;   12344;     500
4523;A028725;Flevoland (PV)  ;2017;  159477;  103423;   55627;   42457;   13170;     427
4524;A028725;Flevoland (PV)  ;2018;  161787;  104558;   56705;   42468;   14237;     524
4525;A028725;Flevoland (PV)  ;2019;  164338;  108614;   55494;   43543;   11951;     230
4526;A028725;Flevoland (PV)  ;2020;  166839;  109965;   56643;   43933;   12710;     231
4527;A028725;Gelderland (PV)  ;2012;  802258;  489845;  307177;  230150;   77027;    5236
4528;A028725;Gelderland (PV)  ;2013;  817374;  495786;  315686;  232724;   82962;    5902
4529;A028725;Gelderland (PV)  ;2014;  828566;  499235;  322415;  232661;   89754;    6916
4530;A028725;Gelderland (PV)  ;2015;  837595;  503456;  328636;  239231;   89405;    5503
4531;A028725;Gelderland (PV)  ;2016;  846204;  509886;  330596;  239806;   90790;    5722
4532;A028725;Gelderland (PV)  ;2017;  850558;  513190;  332077;  237064;   95013;    5291
4533;A028725;Gelderland (PV)  ;2018;  860082;  524880;  329418;  238762;   90656;    5784
4534;A028725;Gelderland (PV)  ;2019;  869823;  535771;  331495;  242013;   89482;    2557
4535;A028725;Gelderland (PV)  ;2020;  879751;  541439;  335374;  242634;   92740;    2938
4536;A028725;Utrecht (PV)  ;2012;  501543;  293295;  203033;  148846;   54187;    5215
4537;A028725;Utrecht (PV)  ;2013;  508502;  297551;  208295;  149581;   58714;    2656
4538;A028725;Utrecht (PV)  ;2014;  514964;  299467;  212207;  148548;   63659;    3290
4539;A028725;Utrecht (PV)  ;2015;  520785;  302136;  214652;  151432;   63220;    3997
4540;A028725;Utrecht (PV)  ;2016;  525923;  305558;  216659;  150260;   66399;    3706
4541;A028725;Utrecht (PV)  ;2017;  531228;  309341;  217972;  149483;   68489;    3915
4542;A028725;Utrecht (PV)  ;2018;  535827;  312367;  219923;  150081;   69842;    3537
4543;A028725;Utrecht (PV)  ;2019;  556706;  330640;  224937;  156267;   68670;    1129
4544;A028725;Utrecht (PV)  ;2020;  564280;  333537;  229131;  156535;   72596;    1612
4545;A028725;Noord-Holland (PV)  ;2012; 1183925;  594092;  581968;  417590;  164378;    7865
4546;A028725;Noord-Holland (PV)  ;2013; 1194196;  601280;  586955;  415917;  171038;    5961
4547;A028725;Noord-Holland (PV)  ;2014; 1210593;  607408;  595358;  415901;  179457;    7827
4548;A028725;Noord-Holland (PV)  ;2015; 1222844;  614930;  602856;  422729;  180127;    5058
4549;A028725;Noord-Holland (PV)  ;2016; 1236224;  623410;  606288;  418043;  188245;    6526
4550;A028725;Noord-Holland (PV)  ;2017; 1244490;  629076;  609803;  415117;  194686;    5611
4551;A028725;Noord-Holland (PV)  ;2018; 1254690;  641594;  607500;  413256;  194244;    5596
4552;A028725;Noord-Holland (PV)  ;2019; 1268101;  653600;  611927;  414814;  197113;    2574
4553;A028725;Noord-Holland (PV)  ;2020; 1282812;  656796;  622572;  413628;  208944;    3444
4554;A028725;Zuid-Holland (PV)  ;2012; 1508405;  785318;  717519;  541605;  175914;    5568
4555;A028725;Zuid-Holland (PV)  ;2013; 1524334;  793046;  726228;  541877;  184351;    5060
4556;A028725;Zuid-Holland (PV)  ;2014; 1540552;  799601;  734228;  541490;  192738;    6723
4557;A028725;Zuid-Holland (PV)  ;2015; 1555103;  807674;  741509;  548151;  193358;    5920
4558;A028725;Zuid-Holland (PV)  ;2016; 1569603;  815972;  746038;  542413;  203625;    7593
4559;A028725;Zuid-Holland (PV)  ;2017; 1582126;  823952;  751565;  541559;  210006;    6609
4560;A028725;Zuid-Holland (PV)  ;2018; 1597559;  834254;  755206;  540061;  215145;    8099
4561;A028725;Zuid-Holland (PV)  ;2019; 1596204;  846157;  745212;  537194;  208018;    4835
4562;A028725;Zuid-Holland (PV)  ;2020; 1612387;  852924;  754303;  537531;  216772;    5160
4563;A028725;Zeeland (PV)  ;2012;  162746;  108477;   53966;   41189;   12777;     303
4564;A028725;Zeeland (PV)  ;2013;  164359;  109555;   54604;   41339;   13265;     200
4565;A028725;Zeeland (PV)  ;2014;  166065;  109438;   55781;   41399;   14382;     846
4566;A028725;Zeeland (PV)  ;2015;  167067;  110367;   55698;   41510;   14188;    1002
4567;A028725;Zeeland (PV)  ;2016;  167939;  110995;   55738;   41480;   14258;    1206
4568;A028725;Zeeland (PV)  ;2017;  168800;  111205;   56273;   41349;   14924;    1322
4569;A028725;Zeeland (PV)  ;2018;  169774;  113359;   55112;   41167;   13945;    1303
4570;A028725;Zeeland (PV)  ;2019;  170805;  115408;   54338;   40742;   13596;    1059
4571;A028725;Zeeland (PV)  ;2020;  171471;  116035;   54207;   40299;   13908;    1229
4572;A028725;Noord-Brabant (PV)  ;2012; 1004985;  626191;  375869;  293481;   82388;    2925
4573;A028725;Noord-Brabant (PV)  ;2013; 1018080;  633332;  382946;  296923;   86023;    1802
4574;A028725;Noord-Brabant (PV)  ;2014; 1033135;  637242;  392464;  300089;   92375;    3429
4575;A028725;Noord-Brabant (PV)  ;2015; 1043904;  641751;  398613;  302557;   96056;    3540
4576;A028725;Noord-Brabant (PV)  ;2016; 1053306;  647463;  401531;  301445;  100086;    4312
4577;A028725;Noord-Brabant (PV)  ;2017; 1062773;  651734;  406005;  301110;  104895;    5034
4578;A028725;Noord-Brabant (PV)  ;2018; 1075779;  663179;  407337;  302116;  105221;    5263
4579;A028725;Noord-Brabant (PV)  ;2019; 1088147;  674856;  411455;  306339;  105116;    1836
4580;A028725;Noord-Brabant (PV)  ;2020; 1100330;  680266;  417825;  306964;  110861;    2239
4581;A028725;Limburg (PV)  ;2012;  478598;  295762;  181566;  132733;   48833;    1270
4582;A028725;Limburg (PV)  ;2013;  483449;  296934;  185546;  133414;   52132;     969
4583;A028725;Limburg (PV)  ;2014;  489315;  299575;  187351;  134471;   52880;    2389
4584;A028725;Limburg (PV)  ;2015;  493615;  299169;  191974;  136100;   55874;    2472
4585;A028725;Limburg (PV)  ;2016;  496264;  299865;  193538;  135774;   57764;    2861
4586;A028725;Limburg (PV)  ;2017;  499234;  301009;  195102;  135544;   59558;    3123
4587;A028725;Limburg (PV)  ;2018;  502321;  306641;  192290;  133986;   58304;    3390
4588;A028725;Limburg (PV)  ;2019;  504718;  310680;  192432;  135193;   57239;    1606
4589;A028725;Limburg (PV)  ;2020;  507432;  311944;  193757;  134913;   58844;    1731
4590;A028725;CR01  ;2012;   64422;   42213;   21997;   17535;    4462;     212
4591;A028725;CR01  ;2013;   64777;   42322;   22373;   17582;    4791;      82
4592;A028725;CR01  ;2014;   65357;   42201;   22817;   17678;    5139;     339
4593;A028725;CR01  ;2015;   65595;   42221;   23065;   17894;    5171;     309
4594;A028725;CR01  ;2016;   65784;   42095;   23337;   17781;    5556;     352
4595;A028725;CR01  ;2017;   65965;   42156;   23470;   17753;    5717;     339
4596;A028725;CR01  ;2018;   60931;   39269;   21284;   16279;    5005;     378
4597;A028725;CR01  ;2019;   61129;   39760;   21262;   16437;    4825;     107
4598;A028725;CR01  ;2020;   61333;   39783;   21428;   16419;    5009;     122
4599;A028725;CR02  ;2012;   20896;   12815;    8073;    6718;    1355;       8
4600;A028725;CR02  ;2013;   20948;   12821;    8115;    6714;    1401;      12
4601;A028725;CR02  ;2014;   21231;   12806;    8418;    6840;    1578;       7
4602;A028725;CR02  ;2015;   21291;   12795;    8489;    6844;    1645;       7
4603;A028725;CR02  ;2016;   21285;   13018;    8168;    6790;    1378;      99
4604;A028725;CR02  ;2017;   21234;   12964;    8171;    6733;    1438;      99
4605;A028725;CR02  ;2018;   21268;   12991;    8251;    6752;    1499;      26
4606;A028725;CR02  ;2019;   21235;   13028;    8177;    6702;    1475;      30
4607;A028725;CR02  ;2020;   21270;   12971;    8283;    6701;    1582;      16
4608;A028725;CR03  ;2012;  165628;   87818;   76385;   53266;   23119;    1425
4609;A028725;CR03  ;2013;  167824;   88344;   78576;   54004;   24572;     904
4610;A028725;CR03  ;2014;  170706;   88719;   80982;   54551;   26431;    1005
4611;A028725;CR03  ;2015;  172572;   89100;   82741;   57001;   25740;     731
4612;A028725;CR03  ;2016;  174572;   89753;   83984;   56733;   27251;     835
4613;A028725;CR03  ;2017;  176719;   90589;   85458;   56607;   28851;     672
4614;A028725;CR03  ;2018;  182424;   95663;   85678;   56407;   29271;    1083
4615;A028725;CR03  ;2019;  184372;   97011;   86954;   56827;   30127;     407
4616;A028725;CR03  ;2020;  186571;   97393;   88352;   56575;   31777;     826
4617;A028725;CR04  ;2012;  140410;   86762;   53256;   40630;   12626;     392
4618;A028725;CR04  ;2013;  141942;   87469;   54128;   40712;   13416;     345
4619;A028725;CR04  ;2014;  140352;   85481;   53936;   39587;   14349;     935
4620;A028725;CR04  ;2015;  141416;   85656;   54705;   40225;   14480;    1055
4621;A028725;CR04  ;2016;  142223;   85966;   55166;   39503;   15663;    1091
4622;A028725;CR04  ;2017;  143093;   86325;   55692;   39306;   16386;    1076
4623;A028725;CR04  ;2018;  141972;   85804;   54949;   39111;   15838;    1219
4624;A028725;CR04  ;2019;  143041;   87250;   55322;   39650;   15672;     469
4625;A028725;CR04  ;2020;  144618;   87549;   56625;   39437;   17188;     444
4626;A028725;CR05  ;2012;   43571;   28080;   15385;   12792;    2593;     106
4627;A028725;CR05  ;2013;   44746;   28979;   15660;   12810;    2850;     107
4628;A028725;CR05  ;2014;   56904;   37092;   19602;   15793;    3809;     210
4629;A028725;CR05  ;2015;   57683;   37386;   19701;   15880;    3821;     596
4630;A028725;CR05  ;2016;   57959;   37581;   19707;   15702;    4005;     671
4631;A028725;CR05  ;2017;   58265;   37883;   19689;   15579;    4110;     693
4632;A028725;CR05  ;2018;   60922;   40416;   19792;   15955;    3837;     714
4633;A028725;CR05  ;2019;   61416;   41112;   20222;   16340;    3882;      82
4634;A028725;CR05  ;2020;   61696;   41424;   20217;   16196;    4021;      55
4635;A028725;CR06  ;2012;   86470;   54740;   31448;   25837;    5611;     282
4636;A028725;CR06  ;2013;   86930;   55124;   31639;   25767;    5872;     167
4637;A028725;CR06  ;2014;   79669;   49636;   29438;   23699;    5739;     595
4638;A028725;CR06  ;2015;   80030;   49878;   29568;   23801;    5767;     584
4639;A028725;CR06  ;2016;   80460;   50065;   29650;   23554;    6096;     745
4640;A028725;CR06  ;2017;   80836;   50386;   29685;   23457;    6228;     765
4641;A028725;CR06  ;2018;   81335;   51155;   29364;   23325;    6039;     816
4642;A028725;CR06  ;2019;   81679;   52185;   29301;   23348;    5953;     193
4643;A028725;CR06  ;2020;   82239;   52441;   29603;   23380;    6223;     195
4644;A028725;CR07  ;2012;   78731;   53256;   25175;   18655;    6520;     300
4645;A028725;CR07  ;2013;   78961;   53522;   25289;   18597;    6692;     150
4646;A028725;CR07  ;2014;   79764;   53745;   25691;   18524;    7167;     328
4647;A028725;CR07  ;2015;   80088;   53931;   25786;   18574;    7212;     371
4648;A028725;CR07  ;2016;   80595;   54267;   25853;   18808;    7045;     475
4649;A028725;CR07  ;2017;   81357;   54577;   26188;   18851;    7337;     592
4650;A028725;CR07  ;2018;   81941;   55527;   25792;   18624;    7168;     622
4651;A028725;CR07  ;2019;   82627;   56824;   25521;   18837;    6684;     282
4652;A028725;CR07  ;2020;   83503;   57274;   25939;   18905;    7034;     290
4653;A028725;CR08  ;2012;   70884;   46678;   23780;   19070;    4710;     426
4654;A028725;CR08  ;2013;   70868;   46751;   23803;   18893;    4910;     314
4655;A028725;CR08  ;2014;   71653;   46990;   24188;   18829;    5359;     475
4656;A028725;CR08  ;2015;   71875;   47005;   24446;   18962;    5484;     424
4657;A028725;CR08  ;2016;   72106;   47390;   24287;   18780;    5507;     429
4658;A028725;CR08  ;2017;   72288;   47370;   24477;   18868;    5609;     441
4659;A028725;CR08  ;2018;   72761;   47538;   24755;   18948;    5807;     468
4660;A028725;CR08  ;2019;   72997;   48334;   24590;   19301;    5289;      73
4661;A028725;CR08  ;2020;   73398;   48564;   24755;   19255;    5500;      79
4662;A028725;CR09  ;2012;   52913;   34574;   18298;   14553;    3745;      41
4663;A028725;CR09  ;2013;   53567;   35015;   18471;   14480;    3991;      81
4664;A028725;CR09  ;2014;   54642;   35388;   18831;   14542;    4289;     423
4665;A028725;CR09  ;2015;   55084;   35574;   19105;   14392;    4713;     405
4666;A028725;CR09  ;2016;   55438;   35833;   19000;   14639;    4361;     605
4667;A028725;CR09  ;2017;   55951;   36056;   19240;   14588;    4652;     655
4668;A028725;CR09  ;2018;   56569;   36734;   19146;   14786;    4360;     689
4669;A028725;CR09  ;2019;   57100;   37415;   19602;   15244;    4358;      83
4670;A028725;CR09  ;2020;   57504;   37680;   19653;   14921;    4732;     171
4671;A028725;CR10  ;2012;  140984;   88358;   52055;   38224;   13831;     571
4672;A028725;CR10  ;2013;  142572;   89329;   52800;   38385;   14415;     443
4673;A028725;CR10  ;2014;  143462;   89909;   53131;   38371;   14760;     422
4674;A028725;CR10  ;2015;  144909;   90610;   53796;   38892;   14904;     503
4675;A028725;CR10  ;2016;  146887;   91337;   54897;   38966;   15931;     653
4676;A028725;CR10  ;2017;  148476;   92317;   55600;   39062;   16538;     559
4677;A028725;CR10  ;2018;  150194;   94478;   55057;   39418;   15639;     659
4678;A028725;CR10  ;2019;  152261;   96958;   54806;   40052;   14754;     497
4679;A028725;CR10  ;2020;  154256;   98050;   55757;   40316;   15441;     449
4680;A028725;CR11  ;2012;   61704;   37368;   24186;   18345;    5841;     150
4681;A028725;CR11  ;2013;   61851;   37610;   24172;   18126;    6046;      69
4682;A028725;CR11  ;2014;   61862;   37888;   23919;   17701;    6218;      55
4683;A028725;CR11  ;2015;   62630;   38138;   24444;   18077;    6367;      48
4684;A028725;CR11  ;2016;   63504;   38609;   24849;   18243;    6606;      46
4685;A028725;CR11  ;2017;   65117;   38794;   26233;   18690;    7543;      90
4686;A028725;CR11  ;2018;   65726;   39588;   26063;   18606;    7457;      75
4687;A028725;CR11  ;2019;   66419;   40506;   25844;   18614;    7230;      69
4688;A028725;CR11  ;2020;   67289;   40785;   26293;   18795;    7498;     211
4689;A028725;CR12  ;2012;  254499;  153164;   99433;   77725;   21708;    1902
4690;A028725;CR12  ;2013;  256767;  154405;  101020;   77795;   23225;    1342
4691;A028725;CR12  ;2014;  259114;  154917;  102485;   77588;   24897;    1712
4692;A028725;CR12  ;2015;  260478;  155923;  102833;   79647;   23186;    1722
4693;A028725;CR12  ;2016;  261904;  156628;  103121;   77597;   25524;    2155
4694;A028725;CR12  ;2017;  263157;  156665;  104396;   78401;   25995;    2096
4695;A028725;CR12  ;2018;  264192;  160607;  101653;   77402;   24251;    1932
4696;A028725;CR12  ;2019;  266238;  162207;  103670;   77543;   26127;     361
4697;A028725;CR12  ;2020;  268608;  163264;  104819;   77453;   27366;     525
4698;A028725;CR13  ;2012;  251926;  160498;   89281;   67627;   21654;    2147
4699;A028725;CR13  ;2013;  258466;  162597;   93558;   68528;   25030;    2311
4700;A028725;CR13  ;2014;  262891;  163919;   96446;   68402;   28044;    2526
4701;A028725;CR13  ;2015;  265989;  165743;   97790;   70964;   26826;    2456
4702;A028725;CR13  ;2016;  269174;  168226;   98481;   70630;   27851;    2467
4703;A028725;CR13  ;2017;  270157;  169649;   98611;   69630;   28981;    1897
4704;A028725;CR13  ;2018;  273468;  173490;   97718;   70655;   27063;    2260
4705;A028725;CR13  ;2019;  277100;  176890;   99608;   72621;   26987;     602
4706;A028725;CR13  ;2020;  281318;  179504;  101285;   73058;   28227;     529
4707;A028725;CR14  ;2012;  162254;  106547;   54942;   40039;   14903;     765
4708;A028725;CR14  ;2013;  164781;  107874;   56222;   40396;   15826;     685
4709;A028725;CR14  ;2014;  166698;  108692;   57157;   40277;   16880;     849
4710;A028725;CR14  ;2015;  168073;  109430;   57798;   40813;   16985;     845
4711;A028725;CR14  ;2016;  169343;  110259;   58161;   41195;   16966;     923
4712;A028725;CR14  ;2017;  170381;  110868;   58556;   41186;   17370;     957
4713;A028725;CR14  ;2018;  171524;  113086;   57428;   41158;   16270;    1010
4714;A028725;CR14  ;2019;  172669;  114617;   57786;   41859;   15927;     266
4715;A028725;CR14  ;2020;  173626;  115243;   58179;   41886;   16293;     204
4716;A028725;CR15  ;2012;  299221;  164546;  132673;   98132;   34541;    2002
4717;A028725;CR15  ;2013;  304178;  166284;  135364;   99046;   36318;    2530
4718;A028725;CR15  ;2014;  307801;  166924;  137792;   99212;   38580;    3085
4719;A028725;CR15  ;2015;  311608;  167945;  141906;  102631;   39275;    1757
4720;A028725;CR15  ;2016;  314646;  169832;  142996;  103088;   39908;    1818
4721;A028725;CR15  ;2017;  315983;  170811;  143237;  101341;   41896;    1935
4722;A028725;CR15  ;2018;  319946;  175423;  142466;  101940;   40526;    2057
4723;A028725;CR15  ;2019;  323782;  179374;  143017;  102522;   40495;    1391
4724;A028725;CR15  ;2020;  327212;  180802;  144528;  102757;   41771;    1882
4725;A028725;CR16  ;2012;   88857;   58254;   30281;   24352;    5929;     322
4726;A028725;CR16  ;2013;   89949;   59031;   30542;   24754;    5788;     376
4727;A028725;CR16  ;2014;   91176;   59700;   31020;   24770;    6250;     456
4728;A028725;CR16  ;2015;   91925;   60338;   31142;   24823;    6319;     445
4729;A028725;CR16  ;2016;   93041;   61569;   30958;   24893;    6065;     514
4730;A028725;CR16  ;2017;   94037;   61862;   31673;   24907;    6766;     502
4731;A028725;CR16  ;2018;   95144;   62881;   31806;   25009;    6797;     457
4732;A028725;CR16  ;2019;   96272;   64890;   31084;   25011;    6073;     298
4733;A028725;CR16  ;2020;   97595;   65890;   31382;   24933;    6449;     323
4734;A028725;CR17  ;2012;  501543;  293295;  203033;  148846;   54187;    5215
4735;A028725;CR17  ;2013;  508502;  297551;  208295;  149581;   58714;    2656
4736;A028725;CR17  ;2014;  514964;  299467;  212207;  148548;   63659;    3290
4737;A028725;CR17  ;2015;  520785;  302136;  214652;  151432;   63220;    3997
4738;A028725;CR17  ;2016;  525923;  305558;  216659;  150260;   66399;    3706
4739;A028725;CR17  ;2017;  531228;  309341;  217972;  149483;   68489;    3915
4740;A028725;CR17  ;2018;  535827;  312367;  219923;  150081;   69842;    3537
4741;A028725;CR17  ;2019;  556706;  330640;  224937;  156267;   68670;    1129
4742;A028725;CR17  ;2020;  564280;  333537;  229131;  156535;   72596;    1612
4743;A028725;CR18  ;2012;  153310;   99876;   53146;   42472;   10674;     288
4744;A028725;CR18  ;2013;  154245;  100488;   53511;   42226;   11285;     246
4745;A028725;CR18  ;2014;  156443;  101075;   54580;   41896;   12684;     788
4746;A028725;CR18  ;2015;  157786;  101901;   54903;   41931;   12972;     982
4747;A028725;CR18  ;2016;  158708;  102709;   55129;   41662;   13467;     870
4748;A028725;CR18  ;2017;  159754;  103439;   55465;   41731;   13734;     850
4749;A028725;CR18  ;2018;  160670;  105043;   54714;   39538;   15176;     913
4750;A028725;CR18  ;2019;  161675;  107166;   54064;   41934;   12130;     445
4751;A028725;CR18  ;2020;  162769;  107817;   54508;   41737;   12771;     444
4752;A028725;CR19  ;2012;   97661;   63941;   33587;   25092;    8495;     133
4753;A028725;CR19  ;2013;   98173;   64359;   33708;   24451;    9257;     106
4754;A028725;CR19  ;2014;  100169;   64823;   34650;   25568;    9082;     696
4755;A028725;CR19  ;2015;  103613;   66995;   35881;   26094;    9787;     737
4756;A028725;CR19  ;2016;  104499;   67387;   36373;   26180;   10193;     739
4757;A028725;CR19  ;2017;  105473;   67723;   36965;   26168;   10797;     785
4758;A028725;CR19  ;2018;  106595;   69401;   36427;   26313;   10114;     767
4759;A028725;CR19  ;2019;  107495;   70789;   36633;   26685;    9948;      73
4760;A028725;CR19  ;2020;  108579;   71153;   37343;   26855;   10488;      83
4761;A028725;CR20  ;2012;   81651;   48959;   32532;   26673;    5859;     160
4762;A028725;CR20  ;2013;   82265;   49256;   32908;   26653;    6255;     101
4763;A028725;CR20  ;2014;   83258;   49561;   33517;   26681;    6836;     180
4764;A028725;CR20  ;2015;   83808;   49884;   33747;   26770;    6977;     177
4765;A028725;CR20  ;2016;   84398;   50311;   33893;   26607;    7286;     194
4766;A028725;CR20  ;2017;   85383;   50922;   34180;   26604;    7576;     281
4767;A028725;CR20  ;2018;   85761;   52364;   33194;   26484;    6710;     203
4768;A028725;CR20  ;2019;   86210;   53102;   32874;   27137;    5737;     234
4769;A028725;CR20  ;2020;   86883;   53587;   33098;   27038;    6060;     198
4770;A028725;CR21  ;2012;   97773;   55060;   41786;   30049;   11737;     927
4771;A028725;CR21  ;2013;   98776;   55514;   42700;   30219;   12481;     562
4772;A028725;CR21  ;2014;  100106;   56079;   43555;   30030;   13525;     472
4773;A028725;CR21  ;2015;  101161;   56750;   44077;   30079;   13998;     334
4774;A028725;CR21  ;2016;  102027;   57463;   44187;   29917;   14270;     377
4775;A028725;CR21  ;2017;  102698;   57997;   44181;   29662;   14519;     520
4776;A028725;CR21  ;2018;  103458;   59094;   43810;   29506;   14304;     554
4777;A028725;CR21  ;2019;  102069;   58324;   43352;   29555;   13797;     393
4778;A028725;CR21  ;2020;  103051;   58542;   44129;   29530;   14599;     380
4779;A028725;CR22  ;2012;   68687;   36676;   31982;   27692;    4290;      29
4780;A028725;CR22  ;2013;   69693;   37284;   32380;   27792;    4588;      29
4781;A028725;CR22  ;2014;   70586;   37844;   32630;   27541;    5089;     112
4782;A028725;CR22  ;2015;   70952;   38256;   32664;   27404;    5260;      32
4783;A028725;CR22  ;2016;   71561;   38771;   32635;   27292;    5343;     155
4784;A028725;CR22  ;2017;   72288;   39236;   32892;   27238;    5654;     160
4785;A028725;CR22  ;2018;   72820;   40401;   32227;   27139;    5088;     192
4786;A028725;CR22  ;2019;   73241;   40989;   32159;   27265;    4894;      93
4787;A028725;CR22  ;2020;   73584;   41202;   32285;   27076;    5209;      97
4788;A028725;CR23  ;2012;  580903;  227504;  347200;  234797;  112403;    6199
4789;A028725;CR23  ;2013;  585912;  231731;  349386;  233509;  115877;    4795
4790;A028725;CR23  ;2014;  593114;  235102;  353486;  233525;  119961;    4526
4791;A028725;CR23  ;2015;  597606;  237620;  358248;  239709;  118539;    1738
4792;A028725;CR23  ;2016;  606221;  242605;  360449;  235629;  124820;    3167
4793;A028725;CR23  ;2017;  608849;  244768;  362082;  233150;  128932;    1999
4794;A028725;CR23  ;2018;  614214;  249100;  363186;  233768;  129418;    1928
4795;A028725;CR23  ;2019;  625446;  255492;  368884;  231385;  137499;    1070
4796;A028725;CR23  ;2020;  635024;  256418;  376591;  230223;  146368;    2015
4797;A028725;CR24  ;2012;  103940;   62076;   41735;   30815;   10920;     129
4798;A028725;CR24  ;2013;  105132;   62648;   42362;   31067;   11295;     122
4799;A028725;CR24  ;2014;  106917;   62924;   42940;   30660;   12280;    1053
4800;A028725;CR24  ;2015;  107918;   63524;   43336;   30742;   12594;    1058
4801;A028725;CR24  ;2016;  108810;   64164;   43622;   30756;   12866;    1024
4802;A028725;CR24  ;2017;  110045;   64991;   44038;   30564;   13474;    1016
4803;A028725;CR24  ;2018;  111172;   66191;   43942;   30508;   13434;    1039
4804;A028725;CR24  ;2019;  111965;   67738;   43961;   30853;   13108;     266
4805;A028725;CR24  ;2020;  112922;   68077;   44618;   31169;   13449;     227
4806;A028725;CR25  ;2012;  166453;   98742;   66907;   48318;   18589;     804
4807;A028725;CR25  ;2013;  168807;   99590;   68614;   49282;   19332;     603
4808;A028725;CR25  ;2014;  171405;  100427;   69922;   49341;   20581;    1056
4809;A028725;CR25  ;2015;  172911;  102246;   69875;   49898;   19977;     790
4810;A028725;CR25  ;2016;  175520;  103524;   70927;   49775;   21152;    1069
4811;A028725;CR25  ;2017;  178278;  104936;   72184;   50020;   22164;    1158
4812;A028725;CR25  ;2018;  180686;  106074;   73430;   50030;   23400;    1182
4813;A028725;CR25  ;2019;  182457;  108164;   73601;   50330;   23271;     692
4814;A028725;CR25  ;2020;  184595;  109080;   74948;   50327;   24621;     567
4815;A028725;CR26  ;2012;  357148;  175361;  180157;  122112;   58045;    1630
4816;A028725;CR26  ;2013;  361364;  176485;  182850;  122521;   60329;    2029
4817;A028725;CR26  ;2014;  366610;  177512;  186545;  122658;   63887;    2553
4818;A028725;CR26  ;2015;  369918;  178870;  188938;  123331;   65607;    2110
4819;A028725;CR26  ;2016;  374207;  180472;  190977;  122177;   68800;    2758
4820;A028725;CR26  ;2017;  378116;  182692;  193352;  121607;   71745;    2072
4821;A028725;CR26  ;2018;  382944;  183725;  196315;  121911;   74404;    2904
4822;A028725;CR26  ;2019;  386307;  187525;  196930;  123017;   73913;    1852
4823;A028725;CR26  ;2020;  390570;  188558;  199865;  123596;   76269;    2147
4824;A028725;CR27  ;2012;   91268;   48019;   43037;   34358;    8679;     212
4825;A028725;CR27  ;2013;   92176;   48687;   43363;   34276;    9087;     126
4826;A028725;CR27  ;2014;   93144;   49176;   43826;   34397;    9429;     142
4827;A028725;CR27  ;2015;   94723;   50025;   44569;   35718;    8851;     129
4828;A028725;CR27  ;2016;   95666;   50859;   44615;   35774;    8841;     192
4829;A028725;CR27  ;2017;   96521;   51212;   45186;   35632;    9554;     123
4830;A028725;CR27  ;2018;   97394;   51818;   45398;   34333;   11065;     178
4831;A028725;CR27  ;2019;   98922;   53679;   44928;   34390;   10538;     315
4832;A028725;CR27  ;2020;   99959;   54282;   45322;   34311;   11011;     355
4833;A028725;CR28  ;2012;  117357;   73472;   43603;   33360;   10243;     282
4834;A028725;CR28  ;2013;  118646;   74272;   44166;   33616;   10550;     208
4835;A028725;CR28  ;2014;  120092;   75022;   44782;   34049;   10733;     288
4836;A028725;CR28  ;2015;  130566;   81866;   48391;   37002;   11389;     309
4837;A028725;CR28  ;2016;  131903;   82876;   48647;   36968;   11679;     380
4838;A028725;CR28  ;2017;  133627;   84044;   49132;   36993;   12139;     451
4839;A028725;CR28  ;2018;  135746;   85808;   49534;   37093;   12441;     404
4840;A028725;CR28  ;2019;  137804;   88128;   49559;   36992;   12567;     117
4841;A028725;CR28  ;2020;  139241;   89022;   50091;   37148;   12943;     128
4842;A028725;CR29  ;2012;  613637;  295249;  316111;  247892;   68219;    2277
4843;A028725;CR29  ;2013;  619526;  298627;  319072;  246672;   72400;    1827
4844;A028725;CR29  ;2014;  624046;  301024;  320716;  245832;   74884;    2306
4845;A028725;CR29  ;2015;  620898;  297404;  321275;  246946;   74329;    2219
4846;A028725;CR29  ;2016;  625322;  300047;  322580;  243186;   79394;    2695
4847;A028725;CR29  ;2017;  627795;  301973;  323490;  243183;   80307;    2332
4848;A028725;CR29  ;2018;  631986;  305577;  323535;  242884;   80651;    2874
4849;A028725;CR29  ;2019;  634895;  314147;  319187;  243278;   75909;    1561
4850;A028725;CR29  ;2020;  640993;  316598;  322674;  243301;   79373;    1721
4851;A028725;CR30  ;2012;  162542;   94475;   67704;   55565;   12139;     363
4852;A028725;CR30  ;2013;  163815;   95385;   68163;   55510;   12653;     267
4853;A028725;CR30  ;2014;  165255;   96440;   68437;   55213;   13224;     378
4854;A028725;CR30  ;2015;  166087;   97263;   68461;   55256;   13205;     363
4855;A028725;CR30  ;2016;  166985;   98194;   68292;   54533;   13759;     499
4856;A028725;CR30  ;2017;  167789;   99095;   68221;   54124;   14097;     473
4857;A028725;CR30  ;2018;  168803;  101252;   66994;   53810;   13184;     557
4858;A028725;CR30  ;2019;  155819;   94514;   61007;   49187;   11820;     298
4859;A028725;CR30  ;2020;  157029;   95384;   61403;   48848;   12555;     242
4860;A028725;CR31  ;2012;   46768;   33067;   13664;    9829;    3835;      37
4861;A028725;CR31  ;2013;   47320;   33493;   13817;    9873;    3944;      10
4862;A028725;CR31  ;2014;   47616;   33162;   14296;    9858;    4438;     158
4863;A028725;CR31  ;2015;   47905;   33548;   14113;    9865;    4248;     244
4864;A028725;CR31  ;2016;   48261;   33692;   14118;    9856;    4262;     451
4865;A028725;CR31  ;2017;   48414;   33622;   14336;    9856;    4480;     456
4866;A028725;CR31  ;2018;   48514;   34317;   13753;    9738;    4015;     444
4867;A028725;CR31  ;2019;   48688;   34641;   13397;    9592;    3805;     650
4868;A028725;CR31  ;2020;   48693;   34631;   13320;    9465;    3855;     742
4869;A028725;CR32  ;2012;  115978;   75410;   40302;   31360;    8942;     266
4870;A028725;CR32  ;2013;  117039;   76062;   40787;   31466;    9321;     190
4871;A028725;CR32  ;2014;  118449;   76276;   41485;   31541;    9944;     688
4872;A028725;CR32  ;2015;  119162;   76819;   41585;   31645;    9940;     758
4873;A028725;CR32  ;2016;  119678;   77303;   41620;   31624;    9996;     755
4874;A028725;CR32  ;2017;  120386;   77583;   41937;   31493;   10444;     866
4875;A028725;CR32  ;2018;  121260;   79042;   41359;   31429;    9930;     859
4876;A028725;CR32  ;2019;  122117;   80767;   40941;   31150;    9791;     409
4877;A028725;CR32  ;2020;  122778;   81404;   40887;   30834;   10053;     487
4878;A028725;CR33  ;2012;  255555;  159005;   96076;   75035;   21041;     474
4879;A028725;CR33  ;2013;  258867;  160837;   97706;   76134;   21572;     324
4880;A028725;CR33  ;2014;  262440;  161709;  100131;   77461;   22670;     600
4881;A028725;CR33  ;2015;  264749;  162508;  101733;   78138;   23595;     508
4882;A028725;CR33  ;2016;  266482;  163706;  102033;   77811;   24222;     743
4883;A028725;CR33  ;2017;  268671;  164558;  103352;   77594;   25758;     761
4884;A028725;CR33  ;2018;  271577;  166012;  104692;   77939;   26753;     873
4885;A028725;CR33  ;2019;  273665;  170580;  102437;   78433;   24004;     648
4886;A028725;CR33  ;2020;  275576;  171587;  103381;   78230;   25151;     608
4887;A028725;CR34  ;2012;  187080;  113523;   72962;   56162;   16800;     595
4888;A028725;CR34  ;2013;  189425;  114961;   74234;   56446;   17788;     230
4889;A028725;CR34  ;2014;  192572;  115717;   76535;   57685;   18850;     320
4890;A028725;CR34  ;2015;  194596;  116489;   77747;   58197;   19550;     360
4891;A028725;CR34  ;2016;  196517;  117549;   78417;   57655;   20762;     551
4892;A028725;CR34  ;2017;  198354;  118279;   79431;   57775;   21656;     644
4893;A028725;CR34  ;2018;  201057;  120670;   79655;   58176;   21479;     732
4894;A028725;CR34  ;2019;  203879;  122669;   80803;   58622;   22181;     407
4895;A028725;CR34  ;2020;  206392;  123579;   82060;   58714;   23346;     753
4896;A028725;CR35  ;2012;  255466;  164650;   90086;   71100;   18986;     730
4897;A028725;CR35  ;2013;  258982;  166680;   91793;   72279;   19514;     509
4898;A028725;CR35  ;2014;  262904;  167779;   93672;   72012;   21660;    1453
4899;A028725;CR35  ;2015;  265721;  169139;   94933;   72514;   22419;    1649
4900;A028725;CR35  ;2016;  268240;  170967;   95642;   72742;   22900;    1631
4901;A028725;CR35  ;2017;  270506;  172304;   96455;   72556;   23899;    1747
4902;A028725;CR35  ;2018;  274033;  175680;   96219;   73242;   22977;    2134
4903;A028725;CR35  ;2019;  277230;  177906;   98965;   74271;   24694;     359
4904;A028725;CR35  ;2020;  281033;  179903;  100728;   74555;   26173;     402
4905;A028725;CR36  ;2012;  306884;  189013;  116745;   91184;   25561;    1126
4906;A028725;CR36  ;2013;  310806;  190854;  119213;   92064;   27149;     739
4907;A028725;CR36  ;2014;  315219;  192037;  122126;   92931;   29195;    1056
4908;A028725;CR36  ;2015;  318838;  193615;  124200;   93708;   30492;    1023
4909;A028725;CR36  ;2016;  322067;  195241;  125439;   93237;   32202;    1387
4910;A028725;CR36  ;2017;  325242;  196593;  126767;   93185;   33582;    1882
4911;A028725;CR36  ;2018;  329112;  200817;  126771;   92759;   34012;    1524
4912;A028725;CR36  ;2019;  333373;  203701;  129250;   95013;   34237;     422
4913;A028725;CR36  ;2020;  337329;  205197;  131656;   95465;   36191;     476
4914;A028725;CR37  ;2012;  113921;   75762;   37974;   29056;    8918;     185
4915;A028725;CR37  ;2013;  114898;   75997;   38793;   29321;    9472;     108
4916;A028725;CR37  ;2014;  116216;   76800;   39026;   29504;    9522;     390
4917;A028725;CR37  ;2015;  117123;   76964;   39856;   29763;   10093;     303
4918;A028725;CR37  ;2016;  117831;   77363;   40168;   29757;   10411;     300
4919;A028725;CR37  ;2017;  118758;   77729;   40688;   29786;   10902;     341
4920;A028725;CR37  ;2018;  119597;   79013;   40209;   29299;   10910;     375
4921;A028725;CR37  ;2019;  120265;   80182;   39875;   29630;   10245;     208
4922;A028725;CR37  ;2020;  121102;   80640;   40235;   29723;   10512;     227
4923;A028725;CR38  ;2012;   98257;   67201;   30846;   22376;    8470;     210
4924;A028725;CR38  ;2013;   99219;   67698;   31338;   22496;    8842;     183
4925;A028725;CR38  ;2014;  100469;   68647;   31504;   22723;    8781;     318
4926;A028725;CR38  ;2015;  101114;   68471;   32309;   22867;    9442;     334
4927;A028725;CR38  ;2016;  101989;   68486;   32848;   22865;    9983;     655
4928;A028725;CR38  ;2017;  102694;   68808;   33176;   22965;   10211;     710
4929;A028725;CR38  ;2018;  103213;   69923;   32572;   22492;   10080;     718
4930;A028725;CR38  ;2019;  103706;   70847;   32691;   22975;    9716;     168
4931;A028725;CR38  ;2020;  104504;   71297;   32977;   22794;   10183;     230
4932;A028725;CR39  ;2012;  266420;  152799;  112746;   81301;   31445;     875
4933;A028725;CR39  ;2013;  269332;  153239;  115415;   81597;   33818;     678
4934;A028725;CR39  ;2014;  272630;  154128;  116821;   82244;   34577;    1681
4935;A028725;CR39  ;2015;  275378;  153734;  119809;   83470;   36339;    1835
4936;A028725;CR39  ;2016;  276444;  154016;  120522;   83152;   37370;    1906
4937;A028725;CR39  ;2017;  277782;  154472;  121238;   82793;   38445;    2072
4938;A028725;CR39  ;2018;  279511;  157705;  119509;   82195;   37314;    2297
4939;A028725;CR39  ;2019;  280747;  159651;  119866;   82588;   37278;    1230
4940;A028725;CR39  ;2020;  281826;  160007;  120545;   82396;   38149;    1274
4941;A028725;CR40  ;2012;  151636;   98817;   52413;   42043;   10370;     406
4942;A028725;CR40  ;2013;  153058;   99930;   52837;   41759;   11078;     291
4943;A028725;CR40  ;2014;  155257;  100792;   53876;   42069;   11807;     589
4944;A028725;CR40  ;2015;  156665;  101662;   54435;   42215;   12220;     568
4945;A028725;CR40  ;2016;  158004;  102688;   54816;   42472;   12344;     500
4946;A028725;CR40  ;2017;  159477;  103423;   55627;   42457;   13170;     427
4947;A028725;CR40  ;2018;  161787;  104558;   56705;   42468;   14237;     524
4948;A028725;CR40  ;2019;  164338;  108614;   55494;   43543;   11951;     230
4949;A028725;CR40  ;2020;  166839;  109965;   56643;   43933;   12710;     231
4950;A028725;GM1680;2012;   10526;    7640;    2845;    1926;     919;      41
4951;A028725;GM1680;2013;   10412;    7595;    2785;    1929;     856;      32
4952;A028725;GM1680;2014;   10552;    7578;    2853;    1864;     989;     121
4953;A028725;GM1680;2015;   10550;    7565;    2910;    2000;     910;      75
4954;A028725;GM1680;2016;   10589;    7633;    2862;    1922;     940;      94
4955;A028725;GM1680;2017;   10602;    7606;    2896;    1917;     979;     100
4956;A028725;GM1680;2018;   10605;    7883;    2627;    1916;     711;      95
4957;A028725;GM1680;2019;   10676;    8042;    2622;    2085;     537;      12
4958;A028725;GM1680;2020;   10761;    8108;    2648;    2098;     550;       5
4959;A028725;GM0738;2012;    4477;    3248;    1228;     955;     273;       1
4960;A028725;GM0738;2013;    4546;    3292;    1252;     964;     288;       2
4961;A028725;GM0738;2014;    4623;    3333;    1290;     971;     319;       0
4962;A028725;GM0738;2015;    4691;    3353;    1338;     925;     413;       0
4963;A028725;GM0738;2016;    4708;    3407;    1298;     874;     424;       3
4964;A028725;GM0738;2017;    4759;    3449;    1307;     868;     439;       3
4965;A028725;GM0738;2018;    4824;    3549;    1268;     891;     377;       7
4966;A028725;GM0738;2019;;;;;;
4967;A028725;GM0738;2020;;;;;;
4968;A028725;GM0358;2012;   11616;    7525;    4078;    2997;    1081;      13
4969;A028725;GM0358;2013;   11711;    7599;    4098;    3004;    1094;      14
4970;A028725;GM0358;2014;   12032;    7727;    4117;    3046;    1071;     188
4971;A028725;GM0358;2015;   12149;    7805;    4208;    3128;    1080;     136
4972;A028725;GM0358;2016;   12305;    7847;    4281;    3099;    1182;     177
4973;A028725;GM0358;2017;   12362;    7931;    4251;    3066;    1185;     180
4974;A028725;GM0358;2018;   12417;    8064;    4148;    3028;    1120;     205
4975;A028725;GM0358;2019;   12569;    8220;    4347;    3048;    1299;       2
4976;A028725;GM0358;2020;   12682;    8300;    4378;    3036;    1342;       4
4977;A028725;GM0197;2012;   10816;    7613;    3194;    2363;     831;       9
4978;A028725;GM0197;2013;   10924;    7701;    3213;    2348;     865;      10
4979;A028725;GM0197;2014;   11043;    7770;    3195;    2290;     905;      78
4980;A028725;GM0197;2015;   11192;    7863;    3232;    2259;     973;      97
4981;A028725;GM0197;2016;   11298;    7940;    3266;    2230;    1036;      92
4982;A028725;GM0197;2017;   11354;    8016;    3250;    2231;    1019;      88
4983;A028725;GM0197;2018;   11387;    8071;    3243;    2242;    1001;      73
4984;A028725;GM0197;2019;   11486;    8233;    3237;    2242;     995;      16
4985;A028725;GM0197;2020;   11591;    8274;    3286;    2264;    1022;      31
4986;A028725;GM0059;2012;   11277;    7254;    4020;    3561;     459;       3
4987;A028725;GM0059;2013;   11354;    7304;    4028;    3560;     468;      22
4988;A028725;GM0059;2014;   11520;    7287;    4064;    3546;     518;     169
4989;A028725;GM0059;2015;   11573;    7343;    4062;    3515;     547;     168
4990;A028725;GM0059;2016;   11635;    7382;    4086;    3426;     660;     167
4991;A028725;GM0059;2017;   11667;    7360;    4139;    3430;     709;     168
4992;A028725;GM0059;2018;   11729;    7535;    4017;    3508;     509;     177
4993;A028725;GM0059;2019;   11757;    7548;    4195;    3675;     520;      14
4994;A028725;GM0059;2020;   11789;    7546;    4236;    3650;     586;       7
4995;A028725;GM0482;2012;    7720;    4560;    3156;    2737;     419;       4
4996;A028725;GM0482;2013;    7799;    4609;    3186;    2726;     460;       4
4997;A028725;GM0482;2014;    7838;    4637;    3198;    2721;     477;       3
4998;A028725;GM0482;2015;    7869;    4696;    3171;    2704;     467;       2
4999;A028725;GM0482;2016;    7939;    4810;    3110;    2648;     462;      19
5000;A028725;GM0482;2017;    7963;    4774;    3188;    2670;     518;       1
5001;A028725;GM0482;2018;    8011;    4892;    3117;    2685;     432;       2
5002;A028725;GM0482;2019;    8048;    4953;    3088;    2682;     406;       7
5003;A028725;GM0482;2020;    8090;    4981;    3101;    2670;     431;       8
5004;A028725;GM0613;2012;    9448;    6420;    3020;    2549;     471;       8
5005;A028725;GM0613;2013;    9739;    6634;    3101;    2590;     511;       4
5006;A028725;GM0613;2014;    9778;    6653;    3121;    2568;     553;       4
5007;A028725;GM0613;2015;    9816;    6666;    3147;    2576;     571;       3
5008;A028725;GM0613;2016;    9875;    6711;    3161;    2621;     540;       3
5009;A028725;GM0613;2017;    9935;    6774;    3158;    2610;     548;       3
5010;A028725;GM0613;2018;    9970;    6873;    3092;    2605;     487;       5
5011;A028725;GM0613;2019;   10022;    6991;    3028;    2612;     416;       3
5012;A028725;GM0613;2020;   10161;    7102;    3022;    2599;     423;      37
5013;A028725;GM0361;2012;   42100;   24067;   18022;   13973;    4049;      11
5014;A028725;GM0361;2013;   42290;   24249;   18019;   13360;    4659;      22
5015;A028725;GM0361;2014;   43098;   24505;   18306;   13956;    4350;     287
5016;A028725;GM0361;2015;   48102;   28172;   19587;   14713;    4874;     343
5017;A028725;GM0361;2016;   48422;   28348;   19735;   14754;    4981;     339
5018;A028725;GM0361;2017;   48757;   28357;   20055;   14715;    5340;     345
5019;A028725;GM0361;2018;   49168;   28854;   19945;   14803;    5142;     369
5020;A028725;GM0361;2019;   49408;   29371;   20000;   14829;    5171;      37
5021;A028725;GM0361;2020;   49723;   29334;   20349;   14927;    5422;      40
5022;A028725;GM0141;2012;   30372;   17122;   13196;   11262;    1934;      54
5023;A028725;GM0141;2013;   30599;   17210;   13362;   11330;    2032;      27
5024;A028725;GM0141;2014;   30591;   17199;   13370;   11165;    2205;      22
5025;A028725;GM0141;2015;   30709;   17243;   13423;   11119;    2304;      43
5026;A028725;GM0141;2016;   30871;   17226;   13535;   11058;    2477;     110
5027;A028725;GM0141;2017;   31239;   17112;   14033;   11167;    2866;      94
5028;A028725;GM0141;2018;   31556;   17466;   13999;   11288;    2711;      91
5029;A028725;GM0141;2019;   32018;   17769;   14226;   11314;    2912;      23
5030;A028725;GM0141;2020;   32102;   17816;   14255;   11202;    3053;      31
5031;A028725;GM0034;2012;   74544;   47485;   26996;   21215;    5781;      63
5032;A028725;GM0034;2013;   75346;   48237;   27071;   20984;    6087;      38
5033;A028725;GM0034;2014;   76329;   48770;   27479;   21201;    6278;      80
5034;A028725;GM0034;2015;   77058;   49321;   27656;   21244;    6412;      81
5035;A028725;GM0034;2016;   77991;   49967;   27943;   21456;    6487;      81
5036;A028725;GM0034;2017;   78913;   50575;   28259;   21506;    6753;      79
5037;A028725;GM0034;2018;   80543;   51326;   29076;   21509;    7567;     141
5038;A028725;GM0034;2019;   82288;   53275;   28855;   22422;    6433;     158
5039;A028725;GM0034;2020;   83832;   54031;   29647;   22765;    6882;     154
5040;A028725;GM0484;2012;   29947;   18818;   11052;    8116;    2936;      77
5041;A028725;GM0484;2013;   30290;   19049;   11170;    8140;    3030;      71
5042;A028725;GM0484;2014;   43952;   27869;   15992;   11978;    4014;      91
5043;A028725;GM0484;2015;   44424;   28061;   16282;   12211;    4071;      81
5044;A028725;GM0484;2016;   44695;   28296;   16318;   12221;    4097;      81
5045;A028725;GM0484;2017;   45296;   28636;   16537;   12198;    4339;     123
5046;A028725;GM0484;2018;   45792;   29102;   16595;   12207;    4388;      95
5047;A028725;GM0484;2019;   46522;   29749;   16753;   12290;    4463;      20
5048;A028725;GM0484;2020;   46959;   29899;   17035;   12426;    4609;      25
5049;A028725;GM1723;2012;    3587;    2856;     705;     426;     279;      26
5050;A028725;GM1723;2013;    3679;    2896;     758;     514;     244;      25
5051;A028725;GM1723;2014;    3755;    2921;     825;     535;     290;       9
5052;A028725;GM1723;2015;    3860;    2990;     852;     551;     301;      18
5053;A028725;GM1723;2016;    3944;    3032;     890;     561;     329;      22
5054;A028725;GM1723;2017;    3978;    3055;     898;     556;     342;      25
5055;A028725;GM1723;2018;    4005;    3116;     870;     552;     318;      19
5056;A028725;GM1723;2019;    4065;    3150;     912;     567;     345;       3
5057;A028725;GM1723;2020;    4111;    3172;     931;     564;     367;       8
5058;A028725;GM1959;2012;;;;;;
5059;A028725;GM1959;2013;;;;;;
5060;A028725;GM1959;2014;;;;;;
5061;A028725;GM1959;2015;;;;;;
5062;A028725;GM1959;2016;;;;;;
5063;A028725;GM1959;2017;;;;;;
5064;A028725;GM1959;2018;;;;;;
5065;A028725;GM1959;2019;   21328;   14658;    6598;    5380;    1218;      72
5066;A028725;GM1959;2020;   21591;   14859;    6657;    5397;    1260;      75
5067;A028725;GM0060;2012;    1362;     942;     409;       0;     409;      11
5068;A028725;GM0060;2013;    1385;     972;     403;       0;     403;      10
5069;A028725;GM0060;2014;    1446;     998;     415;       0;     415;      33
5070;A028725;GM0060;2015;    1452;     999;     415;       0;     415;      38
5071;A028725;GM0060;2016;    1451;    1004;     413;       0;     413;      34
5072;A028725;GM0060;2017;    1478;    1000;     440;       0;     440;      38
5073;A028725;GM0060;2018;    1496;    1030;     427;       0;     427;      39
5074;A028725;GM0060;2019;    1505;    1051;     442;       0;     442;      12
5075;A028725;GM0060;2020;    1510;    1048;     448;       0;     448;      14
5076;A028725;GM0307;2012;   60364;   34757;   25372;   19627;    5745;     235
5077;A028725;GM0307;2013;   61364;   35544;   25611;   19141;    6470;     209
5078;A028725;GM0307;2014;   62127;   36040;   25957;   19179;    6778;     130
5079;A028725;GM0307;2015;   62846;   36488;   26197;   19513;    6684;     161
5080;A028725;GM0307;2016;   63444;   37051;   26169;   19388;    6781;     224
5081;A028725;GM0307;2017;   63977;   37461;   26340;   19177;    7163;     176
5082;A028725;GM0307;2018;   64631;   38007;   26422;   19055;    7367;     202
5083;A028725;GM0307;2019;   65563;   38737;   26695;   19446;    7249;     131
5084;A028725;GM0307;2020;   66130;   38972;   27013;   19453;    7560;     145
5085;A028725;GM0362;2012;   38728;   18100;   17979;   10868;    7111;    2649
5086;A028725;GM0362;2013;   39166;   18311;   19809;   11324;    8485;    1046
5087;A028725;GM0362;2014;   39607;   18505;   19796;   11327;    8469;    1306
5088;A028725;GM0362;2015;   40292;   18707;   21137;   13963;    7174;     448
5089;A028725;GM0362;2016;   40830;   18742;   20878;   12171;    8707;    1210
5090;A028725;GM0362;2017;   38959;   18777;   19800;   12224;    7576;     382
5091;A028725;GM0362;2018;   38927;   18989;   19630;   12227;    7403;     308
5092;A028725;GM0362;2019;   39422;   19132;   20250;   12350;    7900;      40
5093;A028725;GM0362;2020;   39604;   19028;   20501;   12321;    8180;      75
5094;A028725;GM0363;2012;  378307;  105876;  269854;  178812;   91042;    2577
5095;A028725;GM0363;2013;  381998;  109080;  269963;  177410;   92553;    2955
5096;A028725;GM0363;2014;  386213;  111198;  272711;  176756;   95955;    2304
5097;A028725;GM0363;2015;  390430;  114350;  275077;  179218;   95859;    1003
5098;A028725;GM0363;2016;  396944;  118137;  277792;  178072;   99720;    1015
5099;A028725;GM0363;2017;  400716;  119376;  280174;  175677;  104497;    1166
5100;A028725;GM0363;2018;  404626;  121142;  282459;  176190;  106269;    1025
5101;A028725;GM0363;2019;  411565;  123699;  286988;  172850;  114138;     878
5102;A028725;GM0363;2020;  418356;  123751;  292822;  171662;  121160;    1783
5103;A028725;GM0200;2012;   64410;   38650;   25520;   19873;    5647;     240
5104;A028725;GM0200;2013;   64967;   38921;   25928;   20067;    5861;     118
5105;A028725;GM0200;2014;   66402;   39333;   26963;   19899;    7064;     106
5106;A028725;GM0200;2015;   66935;   39744;   27104;   19793;    7311;      87
5107;A028725;GM0200;2016;   67733;   40485;   27172;   19726;    7446;      76
5108;A028725;GM0200;2017;   68180;   40578;   27516;   19604;    7912;      86
5109;A028725;GM0200;2018;   68869;   41742;   26890;   19774;    7116;     237
5110;A028725;GM0200;2019;   69717;   42485;   27163;   20237;    6926;      69
5111;A028725;GM0200;2020;   70605;   42994;   27546;   20301;    7245;      65
5112;A028725;GM0003;2012;    5427;    2724;    2701;    2340;     361;       2
5113;A028725;GM0003;2013;    5429;    2740;    2684;    2324;     360;       5
5114;A028725;GM0003;2014;    5518;    2744;    2774;    2397;     377;       0
5115;A028725;GM0003;2015;    5574;    2757;    2817;    2420;     397;       0
5116;A028725;GM0003;2016;    5622;    2813;    2807;    2464;     343;       2
5117;A028725;GM0003;2017;    5647;    2810;    2835;    2477;     358;       2
5118;A028725;GM0003;2018;    5638;    2816;    2821;    2467;     354;       1
5119;A028725;GM0003;2019;    5621;    2835;    2784;    2426;     358;       2
5120;A028725;GM0003;2020;    5639;    2823;    2815;    2420;     395;       1
5121;A028725;GM0202;2012;   66270;   29997;   35514;   25109;   10405;     759
5122;A028725;GM0202;2013;   67029;   30294;   36393;   25394;   10999;     342
5123;A028725;GM0202;2014;   67721;   30388;   37032;   25606;   11426;     301
5124;A028725;GM0202;2015;   68511;   30555;   37656;   26230;   11426;     300
5125;A028725;GM0202;2016;   69371;   31085;   38010;   26170;   11840;     276
5126;A028725;GM0202;2017;   70382;   31160;   38806;   26086;   12720;     416
5127;A028725;GM0202;2018;   71524;   31627;   39447;   26338;   13109;     450
5128;A028725;GM0202;2019;   72794;   32370;   39978;   26474;   13504;     446
5129;A028725;GM0202;2020;   73862;   32580;   40518;   26530;   13988;     764
5130;A028725;GM0106;2012;   28781;   17304;   11364;    8810;    2554;     113
5131;A028725;GM0106;2013;   28903;   17355;   11529;    8773;    2756;      19
5132;A028725;GM0106;2014;   29216;   17407;   11776;    8831;    2945;      33
5133;A028725;GM0106;2015;   29413;   17472;   11813;    8792;    3021;     128
5134;A028725;GM0106;2016;   29662;   17606;   11833;    8769;    3064;     223
5135;A028725;GM0106;2017;   29945;   17689;   11991;    8767;    3224;     265
5136;A028725;GM0106;2018;   30211;   17896;   12040;    8553;    3487;     275
5137;A028725;GM0106;2019;   30565;   18440;   12008;    8639;    3369;     117
5138;A028725;GM0106;2020;   31093;   18623;   12352;    8713;    3639;     118
5139;A028725;GM0743;2012;    6127;    4478;    1633;    1374;     259;      16
5140;A028725;GM0743;2013;    6238;    4581;    1647;    1369;     278;      10
5141;A028725;GM0743;2014;    6441;    4638;    1796;    1420;     376;       7
5142;A028725;GM0743;2015;    6530;    4670;    1851;    1450;     401;       9
5143;A028725;GM0743;2016;    6568;    4656;    1901;    1430;     471;      11
5144;A028725;GM0743;2017;    6618;    4698;    1914;    1427;     487;       6
5145;A028725;GM0743;2018;    6635;    4727;    1895;    1428;     467;      13
5146;A028725;GM0743;2019;    6684;    4804;    1875;    1451;     424;       5
5147;A028725;GM0743;2020;    6717;    4802;    1908;    1443;     465;       7
5148;A028725;GM0744;2012;    2491;    1792;     696;     317;     379;       3
5149;A028725;GM0744;2013;    2496;    1777;     709;     328;     381;      10
5150;A028725;GM0744;2014;    2497;    1775;     718;     318;     400;       4
5151;A028725;GM0744;2015;    2523;    1795;     726;     336;     390;       2
5152;A028725;GM0744;2016;    2529;    1789;     738;     326;     412;       2
5153;A028725;GM0744;2017;    2546;    1793;     751;     324;     427;       2
5154;A028725;GM0744;2018;    2619;    1841;     774;     324;     450;       4
5155;A028725;GM0744;2019;    2655;    1875;     734;     328;     406;      46
5156;A028725;GM0744;2020;    2684;    1879;     747;     327;     420;      58
5157;A028725;GM0308;2012;   10334;    6428;    3737;    2648;    1089;     169
5158;A028725;GM0308;2013;   10311;    6450;    3773;    2581;    1192;      88
5159;A028725;GM0308;2014;   10449;    6441;    3990;    2661;    1329;      18
5160;A028725;GM0308;2015;   10615;    6490;    4088;    2713;    1375;      37
5161;A028725;GM0308;2016;   10684;    6532;    4080;    2710;    1370;      72
5162;A028725;GM0308;2017;   10706;    6550;    4062;    2693;    1369;      94
5163;A028725;GM0308;2018;   10786;    6764;    3929;    2749;    1180;      93
5164;A028725;GM0308;2019;   10872;    6869;    3980;    2786;    1194;      23
5165;A028725;GM0308;2020;   10960;    6904;    4034;    2848;    1186;      22
5166;A028725;GM0489;2012;   17869;   12041;    5826;    4016;    1810;       2
5167;A028725;GM0489;2013;   18192;   12301;    5890;    4071;    1819;       1
5168;A028725;GM0489;2014;   18218;   12339;    5877;    3896;    1981;       2
5169;A028725;GM0489;2015;   18333;   12373;    5958;    4067;    1891;       2
5170;A028725;GM0489;2016;   18469;   12659;    5808;    3942;    1866;       2
5171;A028725;GM0489;2017;   18682;   12823;    5843;    4062;    1781;      16
5172;A028725;GM0489;2018;   18776;   13023;    5736;    4058;    1678;      17
5173;A028725;GM0489;2019;   18855;   13239;    5588;    4147;    1441;      28
5174;A028725;GM0489;2020;   18965;   13272;    5667;    4190;    1477;      26
5175;A028725;GM0203;2012;   18718;   12629;    5846;    3991;    1855;     243
5176;A028725;GM0203;2013;   18886;   12751;    5928;    3988;    1940;     207
5177;A028725;GM0203;2014;   19157;   12933;    5988;    3878;    2110;     236
5178;A028725;GM0203;2015;   19619;   13278;    6126;    3951;    2175;     215
5179;A028725;GM0203;2016;   20057;   13594;    6298;    3988;    2310;     165
5180;A028725;GM0203;2017;   20443;   13746;    6477;    4006;    2471;     220
5181;A028725;GM0203;2018;   20978;   14290;    6381;    4081;    2300;     307
5182;A028725;GM0203;2019;   21289;   14601;    6654;    4207;    2447;      34
5183;A028725;GM0203;2020;   21870;   14939;    6909;    4271;    2638;      22
5184;A028725;GM0005;2012;    4252;    2946;    1300;     978;     322;       6
5185;A028725;GM0005;2013;    4282;    2982;    1292;     982;     310;       8
5186;A028725;GM0005;2014;    4320;    2991;    1323;     976;     347;       6
5187;A028725;GM0005;2015;    4328;    3014;    1307;    1015;     292;       7
5188;A028725;GM0005;2016;    4375;    3031;    1336;    1034;     302;       8
5189;A028725;GM0005;2017;    4424;    3062;    1353;    1043;     310;       9
5190;A028725;GM0005;2018;    4452;    3117;    1322;    1005;     317;      13
5191;A028725;GM0005;2019;;;;;;
5192;A028725;GM0005;2020;;;;;;
5193;A028725;GM0888;2012;    7119;    4965;    2136;    1576;     560;      18
5194;A028725;GM0888;2013;    7102;    4937;    2147;    1562;     585;      18
5195;A028725;GM0888;2014;    7115;    5004;    2100;    1568;     532;      11
5196;A028725;GM0888;2015;    7157;    4973;    2174;    1603;     571;      10
5197;A028725;GM0888;2016;    7163;    4954;    2200;    1589;     611;       9
5198;A028725;GM0888;2017;    7153;    4959;    2188;    1569;     619;       6
5199;A028725;GM0888;2018;    7166;    5032;    2124;    1560;     564;      10
5200;A028725;GM0888;2019;    7228;    5094;    2126;    1572;     554;       8
5201;A028725;GM0888;2020;    7203;    5069;    2124;    1550;     574;      10
5202;A028725;GM1954;2012;;;;;;
5203;A028725;GM1954;2013;;;;;;
5204;A028725;GM1954;2014;;;;;;
5205;A028725;GM1954;2015;;;;;;
5206;A028725;GM1954;2016;;;;;;
5207;A028725;GM1954;2017;;;;;;
5208;A028725;GM1954;2018;;;;;;
5209;A028725;GM1954;2019;   15678;   11630;    4010;    2872;    1138;      38
5210;A028725;GM1954;2020;   15771;   11661;    4078;    2916;    1162;      32
5211;A028725;GM0370;2012;    3298;    2435;     861;     685;     176;       2
5212;A028725;GM0370;2013;    3324;    2455;     869;     692;     177;       0
5213;A028725;GM0370;2014;    3503;    2577;     912;     724;     188;      14
5214;A028725;GM0370;2015;    3514;    2613;     895;     720;     175;       6
5215;A028725;GM0370;2016;    3539;    2620;     918;     719;     199;       1
5216;A028725;GM0370;2017;    3658;    2732;     925;     718;     207;       1
5217;A028725;GM0370;2018;    3718;    2787;     926;     722;     204;       5
5218;A028725;GM0370;2019;    3815;    2892;     921;     737;     184;       2
5219;A028725;GM0370;2020;    3898;    2982;     914;     737;     177;       2
5220;A028725;GM0889;2012;    5719;    3834;    1867;    1699;     168;      18
5221;A028725;GM0889;2013;    5703;    3849;    1848;    1674;     174;       6
5222;A028725;GM0889;2014;    5720;    3869;    1848;    1664;     184;       3
5223;A028725;GM0889;2015;    5706;    3778;    1925;    1637;     288;       3
5224;A028725;GM0889;2016;    5711;    3795;    1909;    1604;     305;       7
5225;A028725;GM0889;2017;    5735;    3811;    1919;    1600;     319;       5
5226;A028725;GM0889;2018;    5788;    3899;    1882;    1634;     248;       7
5227;A028725;GM0889;2019;    5821;    3948;    1871;    1631;     240;       2
5228;A028725;GM0889;2020;    5830;    3957;    1872;    1618;     254;       1
5229;A028725;GM0007;2012;    3880;    2840;    1012;     778;     234;      28
5230;A028725;GM0007;2013;    3893;    2842;    1027;     772;     255;      24
5231;A028725;GM0007;2014;    3888;    2825;    1039;     779;     260;      24
5232;A028725;GM0007;2015;    3881;    2820;    1037;     768;     269;      24
5233;A028725;GM0007;2016;    3879;    2800;    1055;     768;     287;      24
5234;A028725;GM0007;2017;    3897;    2785;    1088;     776;     312;      24
5235;A028725;GM0007;2018;;;;;;
5236;A028725;GM0007;2019;;;;;;
5237;A028725;GM0007;2020;;;;;;
5238;A028725;GM1945;2012;;;;;;
5239;A028725;GM1945;2013;;;;;;
5240;A028725;GM1945;2014;;;;;;
5241;A028725;GM1945;2015;;;;;;
5242;A028725;GM1945;2016;   14619;    8850;    5751;    4408;    1343;      18
5243;A028725;GM1945;2017;   14832;    8896;    5915;    4452;    1463;      21
5244;A028725;GM1945;2018;   14984;    9208;    5739;    4436;    1303;      37
5245;A028725;GM1945;2019;   15075;    9328;    5700;    4493;    1207;      47
5246;A028725;GM1945;2020;   15280;    9402;    5799;    4521;    1278;      79
5247;A028725;GM0491;2012;    3675;    2506;    1162;     972;     190;       7
5248;A028725;GM0491;2013;    3799;    2601;    1195;     993;     202;       3
5249;A028725;GM0491;2014;    3892;    2616;    1273;    1073;     200;       3
5250;A028725;GM0491;2015;;;;;;
5251;A028725;GM0491;2016;;;;;;
5252;A028725;GM0491;2017;;;;;;
5253;A028725;GM0491;2018;;;;;;
5254;A028725;GM0491;2019;;;;;;
5255;A028725;GM0491;2020;;;;;;
5256;A028725;GM1724;2012;    7057;    5622;    1419;    1020;     399;      16
5257;A028725;GM1724;2013;    7166;    5696;    1454;    1016;     438;      16
5258;A028725;GM1724;2014;    7250;    5723;    1513;    1022;     491;      14
5259;A028725;GM1724;2015;    7318;    5764;    1532;    1023;     509;      22
5260;A028725;GM1724;2016;    7371;    5798;    1537;    1006;     531;      36
5261;A028725;GM1724;2017;    7443;    5829;    1576;    1020;     556;      38
5262;A028725;GM1724;2018;    7495;    5930;    1524;    1015;     509;      41
5263;A028725;GM1724;2019;    7540;    5915;    1619;    1038;     581;       6
5264;A028725;GM1724;2020;    7638;    5971;    1659;    1045;     614;       8
5265;A028725;GM0893;2012;    5278;    3699;    1570;    1306;     264;       9
5266;A028725;GM0893;2013;    5286;    3690;    1596;    1304;     292;       0
5267;A028725;GM0893;2014;    5343;    3765;    1577;    1275;     302;       1
5268;A028725;GM0893;2015;    5366;    3727;    1638;    1335;     303;       1
5269;A028725;GM0893;2016;    5402;    3711;    1686;    1348;     338;       5
5270;A028725;GM0893;2017;    5448;    3762;    1683;    1346;     337;       3
5271;A028725;GM0893;2018;    5469;    3831;    1631;    1333;     298;       7
5272;A028725;GM0893;2019;    5525;    3925;    1590;    1328;     262;      10
5273;A028725;GM0893;2020;    5543;    3935;    1603;    1318;     285;       5
5274;A028725;GM0373;2012;   12871;    8808;    4028;    2668;    1360;      35
5275;A028725;GM0373;2013;   12881;    8802;    4057;    2638;    1419;      22
5276;A028725;GM0373;2014;   13253;    8814;    4204;    2664;    1540;     235
5277;A028725;GM0373;2015;   13276;    8833;    4219;    2656;    1563;     224
5278;A028725;GM0373;2016;   13366;    8842;    4295;    2672;    1623;     229
5279;A028725;GM0373;2017;   13409;    8885;    4296;    2673;    1623;     228
5280;A028725;GM0373;2018;   13517;    9199;    4076;    2670;    1406;     242
5281;A028725;GM0373;2019;   13610;    9333;    4266;    2729;    1537;      11
5282;A028725;GM0373;2020;   13735;    9352;    4366;    2744;    1622;      17
5283;A028725;GM0748;2012;   27846;   16228;   11590;    9153;    2437;      28
5284;A028725;GM0748;2013;   28143;   16372;   11731;    9265;    2466;      40
5285;A028725;GM0748;2014;   28301;   16436;   11812;    9262;    2550;      53
5286;A028725;GM0748;2015;   28386;   16424;   11887;    9269;    2618;      75
5287;A028725;GM0748;2016;   28424;   16480;   11883;    9234;    2649;      61
5288;A028725;GM0748;2017;   28503;   16676;   11763;    9133;    2630;      64
5289;A028725;GM0748;2018;   28748;   16609;   12051;    9131;    2920;      88
5290;A028725;GM0748;2019;   29048;   17370;   11646;    9151;    2495;      32
5291;A028725;GM0748;2020;   29498;   17597;   11879;    9227;    2652;      22
5292;A028725;GM1859;2012;   17944;   11995;    5723;    4226;    1497;     226
5293;A028725;GM1859;2013;   18181;   12150;    5832;    4189;    1643;     199
5294;A028725;GM1859;2014;   18292;   12229;    5930;    4199;    1731;     133
5295;A028725;GM1859;2015;   18452;   12329;    6050;    4352;    1698;      73
5296;A028725;GM1859;2016;   18590;   12433;    6026;    4175;    1851;     131
5297;A028725;GM1859;2017;   18639;   12468;    6023;    4132;    1891;     148
5298;A028725;GM1859;2018;   18741;   12798;    5801;    4182;    1619;     142
5299;A028725;GM1859;2019;   18790;   12865;    5911;    4509;    1402;      14
5300;A028725;GM1859;2020;   18833;   12912;    5912;    4480;    1432;       9
5301;A028725;GM1721;2012;   10882;    8043;    2830;    2264;     566;       9
5302;A028725;GM1721;2013;   10966;    8091;    2867;    2274;     593;       8
5303;A028725;GM1721;2014;   11321;    8221;    3020;    2198;     822;      80
5304;A028725;GM1721;2015;   11363;    8282;    3009;    2211;     798;      72
5305;A028725;GM1721;2016;   11451;    8379;    3004;    2231;     773;      68
5306;A028725;GM1721;2017;   11534;    8406;    3057;    2227;     830;      71
5307;A028725;GM1721;2018;   11764;    8594;    3101;    2296;     805;      69
5308;A028725;GM1721;2019;   11928;    8660;    3242;    2318;     924;      26
5309;A028725;GM1721;2020;   12238;    8807;    3426;    2376;    1050;       5
5310;A028725;GM0568;2012;    5103;    3576;    1524;    1325;     199;       3
5311;A028725;GM0568;2013;    5156;    3617;    1535;    1328;     207;       4
5312;A028725;GM0568;2014;    5183;    3624;    1558;    1335;     223;       1
5313;A028725;GM0568;2015;;;;;;
5314;A028725;GM0568;2016;;;;;;
5315;A028725;GM0568;2017;;;;;;
5316;A028725;GM0568;2018;;;;;;
5317;A028725;GM0568;2019;;;;;;
5318;A028725;GM0568;2020;;;;;;
5319;A028725;GM0753;2012;   11310;    8371;    2930;    2328;     602;       9
5320;A028725;GM0753;2013;   11403;    8453;    2943;    2349;     594;       7
5321;A028725;GM0753;2014;   11519;    8501;    3012;    2365;     647;       6
5322;A028725;GM0753;2015;   11641;    8561;    3075;    2414;     661;       5
5323;A028725;GM0753;2016;   11749;    8625;    3120;    2433;     687;       4
5324;A028725;GM0753;2017;   11895;    8641;    3247;    2422;     825;       7
5325;A028725;GM0753;2018;   12026;    8751;    3270;    2448;     822;       5
5326;A028725;GM0753;2019;   12206;    8903;    3275;    2480;     795;      28
5327;A028725;GM0753;2020;   12372;    8946;    3402;    2550;     852;      24
5328;A028725;GM0209;2012;   10062;    6887;    3171;    2411;     760;       4
5329;A028725;GM0209;2013;   10092;    6936;    3154;    2408;     746;       2
5330;A028725;GM0209;2014;   10222;    6964;    3257;    2476;     781;       1
5331;A028725;GM0209;2015;   10294;    6984;    3308;    2504;     804;       2
5332;A028725;GM0209;2016;   10370;    7041;    3290;    2480;     810;      39
5333;A028725;GM0209;2017;   10484;    7077;    3397;    2481;     916;      10
5334;A028725;GM0209;2018;   10737;    7396;    3317;    2511;     806;      24
5335;A028725;GM0209;2019;   10811;    7597;    3205;    2491;     714;       9
5336;A028725;GM0209;2020;   10892;    7606;    3277;    2491;     786;       9
5337;A028725;GM0375;2012;   17352;    9343;    7989;    6981;    1008;      20
5338;A028725;GM0375;2013;   17457;    9431;    8020;    6949;    1071;       6
5339;A028725;GM0375;2014;   17745;    9436;    8303;    6999;    1304;       6
5340;A028725;GM0375;2015;   17790;    9441;    8324;    6927;    1397;      25
5341;A028725;GM0375;2016;   17952;    9521;    8404;    6897;    1507;      27
5342;A028725;GM0375;2017;   18185;    9681;    8477;    7053;    1424;      27
5343;A028725;GM0375;2018;   18270;    9937;    8308;    6987;    1321;      25
5344;A028725;GM0375;2019;   18327;   10153;    8171;    6882;    1289;       3
5345;A028725;GM0375;2020;   18536;   10310;    8220;    6886;    1334;       6
5346;A028725;GM0063;2012;    4268;    2792;    1475;    1251;     224;       1
5347;A028725;GM0063;2013;    4234;    2806;    1427;    1204;     223;       1
5348;A028725;GM0063;2014;    4258;    2866;    1391;    1161;     230;       1
5349;A028725;GM0063;2015;    4413;    2919;    1418;    1182;     236;      76
5350;A028725;GM0063;2016;    4478;    2938;    1458;    1212;     246;      82
5351;A028725;GM0063;2017;    4498;    2953;    1468;    1223;     245;      77
5352;A028725;GM0063;2018;;;;;;
5353;A028725;GM0063;2019;;;;;;
5354;A028725;GM0063;2020;;;;;;
5355;A028725;GM0310;2012;   18147;   10970;    6810;    4909;    1901;     367
5356;A028725;GM0310;2013;   18233;   11014;    7022;    4911;    2111;     197
5357;A028725;GM0310;2014;   18234;   10888;    7124;    4907;    2217;     222
5358;A028725;GM0310;2015;   18375;   10874;    7279;    4928;    2351;     222
5359;A028725;GM0310;2016;   18467;   10922;    7318;    4933;    2385;     227
5360;A028725;GM0310;2017;   18646;   11071;    7347;    4954;    2393;     228
5361;A028725;GM0310;2018;   18696;   11249;    7367;    5026;    2341;      80
5362;A028725;GM0310;2019;   18682;   11444;    7201;    5211;    1990;      37
5363;A028725;GM0310;2020;   18792;   11462;    7239;    5252;    1987;      91
5364;A028725;GM0585;2012;   11865;    8052;    3801;    3338;     463;      12
5365;A028725;GM0585;2013;   11921;    8135;    3773;    3309;     464;      13
5366;A028725;GM0585;2014;   12014;    8219;    3783;    3286;     497;      12
5367;A028725;GM0585;2015;   12055;    8270;    3772;    3247;     525;      13
5368;A028725;GM0585;2016;   12126;    8407;    3706;    3230;     476;      13
5369;A028725;GM0585;2017;   12229;    8395;    3819;    3246;     573;      15
5370;A028725;GM0585;2018;   12314;    8592;    3701;    3208;     493;      21
5371;A028725;GM0585;2019;;;;;;
5372;A028725;GM0585;2020;;;;;;
5373;A028725;GM1728;2012;    7664;    5874;    1773;    1263;     510;      17
5374;A028725;GM1728;2013;    7739;    5888;    1838;    1269;     569;      13
5375;A028725;GM1728;2014;    7952;    5947;    1949;    1313;     636;      56
5376;A028725;GM1728;2015;    8029;    6003;    1981;    1301;     680;      45
5377;A028725;GM1728;2016;    8099;    6109;    1956;    1335;     621;      34
5378;A028725;GM1728;2017;    8191;    6159;    1989;    1305;     684;      43
5379;A028725;GM1728;2018;    8239;    6279;    1922;    1305;     617;      38
5380;A028725;GM1728;2019;    8288;    6275;    2005;    1300;     705;       8
5381;A028725;GM1728;2020;    8403;    6343;    2030;    1274;     756;      30
5382;A028725;GM0376;2012;    3659;    2523;    1132;     805;     327;       4
5383;A028725;GM0376;2013;    3847;    2597;    1247;     907;     340;       3
5384;A028725;GM0376;2014;    3909;    2627;    1278;     937;     341;       4
5385;A028725;GM0376;2015;    4051;    2703;    1344;     953;     391;       4
5386;A028725;GM0376;2016;    4134;    2788;    1345;     946;     399;       1
5387;A028725;GM0376;2017;    4390;    2928;    1461;    1006;     455;       1
5388;A028725;GM0376;2018;    4611;    3173;    1433;    1016;     417;       5
5389;A028725;GM0376;2019;    4718;    3266;    1441;    1061;     380;      11
5390;A028725;GM0376;2020;    4811;    3355;    1446;    1067;     379;      10
5391;A028725;GM0377;2012;    8890;    6329;    2531;    1629;     902;      30
5392;A028725;GM0377;2013;    9049;    6353;    2692;    1696;     996;       4
5393;A028725;GM0377;2014;    9096;    6348;    2747;    1690;    1057;       1
5394;A028725;GM0377;2015;    9184;    6420;    2762;    1677;    1085;       2
5395;A028725;GM0377;2016;    9188;    6476;    2708;    1649;    1059;       4
5396;A028725;GM0377;2017;    9276;    6579;    2693;    1644;    1049;       4
5397;A028725;GM0377;2018;    9385;    6760;    2590;    1638;     952;      35
5398;A028725;GM0377;2019;    9501;    6815;    2552;    1735;     817;     134
5399;A028725;GM0377;2020;    9542;    6857;    2538;    1731;     807;     147
5400;A028725;GM0055;2012;    7921;    5395;    2523;    2147;     376;       3
5401;A028725;GM0055;2013;    8025;    5420;    2603;    2213;     390;       2
5402;A028725;GM0055;2014;;;;;;
5403;A028725;GM0055;2015;;;;;;
5404;A028725;GM0055;2016;;;;;;
5405;A028725;GM0055;2017;;;;;;
5406;A028725;GM0055;2018;;;;;;
5407;A028725;GM0055;2019;;;;;;
5408;A028725;GM0055;2020;;;;;;
5409;A028725;GM1901;2012;   12493;    8981;    3438;    2716;     722;      74
5410;A028725;GM1901;2013;   12730;    9076;    3586;    2773;     813;      68
5411;A028725;GM1901;2014;   12831;    9133;    3621;    2809;     812;      77
5412;A028725;GM1901;2015;   12989;    9284;    3625;    2913;     712;      80
5413;A028725;GM1901;2016;   13159;    9413;    3664;    2941;     723;      82
5414;A028725;GM1901;2017;   13329;    9534;    3716;    2979;     737;      79
5415;A028725;GM1901;2018;   13440;    9647;    3748;    2991;     757;      45
5416;A028725;GM1901;2019;   13678;    9917;    3751;    2833;     918;      10
5417;A028725;GM1901;2020;   13852;   10034;    3811;    2830;     981;       7
5418;A028725;GM0755;2012;    3497;    2700;     792;     585;     207;       5
5419;A028725;GM0755;2013;    3624;    2769;     852;     593;     259;       3
5420;A028725;GM0755;2014;    3706;    2799;     857;     596;     261;      50
5421;A028725;GM0755;2015;    3711;    2798;     861;     585;     276;      52
5422;A028725;GM0755;2016;    3797;    2868;     875;     573;     302;      54
5423;A028725;GM0755;2017;    3882;    2908;     920;     597;     323;      54
5424;A028725;GM0755;2018;    3928;    2986;     888;     589;     299;      54
5425;A028725;GM0755;2019;    3995;    3005;     990;     661;     329;       0
5426;A028725;GM0755;2020;    4076;    3071;    1004;     647;     357;       1
5427;A028725;GM0009;2012;    2862;    2291;     571;     480;      91;       0
5428;A028725;GM0009;2013;    2871;    2278;     593;     488;     105;       0
5429;A028725;GM0009;2014;    2924;    2276;     648;     533;     115;       0
5430;A028725;GM0009;2015;    2939;    2286;     653;     538;     115;       0
5431;A028725;GM0009;2016;    2919;    2266;     652;     525;     127;       1
5432;A028725;GM0009;2017;    2938;    2284;     653;     516;     137;       1
5433;A028725;GM0009;2018;    2939;    2292;     646;     511;     135;       1
5434;A028725;GM0009;2019;;;;;;
5435;A028725;GM0009;2020;;;;;;
5436;A028725;GM1681;2012;   10626;    7553;    3065;    2451;     614;       8
5437;A028725;GM1681;2013;   10619;    7554;    3063;    2413;     650;       2
5438;A028725;GM1681;2014;   10722;    7620;    3099;    2276;     823;       3
5439;A028725;GM1681;2015;   10740;    7680;    3055;    2253;     802;       5
5440;A028725;GM1681;2016;   10757;    7699;    3055;    2234;     821;       3
5441;A028725;GM1681;2017;   10645;    7724;    2918;    2225;     693;       3
5442;A028725;GM1681;2018;   10704;    7878;    2816;    2226;     590;      10
5443;A028725;GM1681;2019;   10736;    7983;    2742;    2209;     533;      11
5444;A028725;GM1681;2020;   10824;    8059;    2754;    2197;     557;      11
5445;A028725;GM0147;2012;    8551;    5736;    2809;    2214;     595;       6
5446;A028725;GM0147;2013;    8779;    5827;    2937;    2265;     672;      15
5447;A028725;GM0147;2014;    8916;    5955;    2959;    2249;     710;       2
5448;A028725;GM0147;2015;    8997;    6032;    2963;    2256;     707;       2
5449;A028725;GM0147;2016;    9064;    6106;    2956;    2233;     723;       2
5450;A028725;GM0147;2017;    9275;    6256;    3005;    2218;     787;      14
5451;A028725;GM0147;2018;    9510;    6496;    2975;    2216;     759;      39
5452;A028725;GM0147;2019;    9598;    6674;    2913;    2210;     703;      11
5453;A028725;GM0147;2020;    9660;    6744;    2907;    2200;     707;       9
5454;A028725;GM0654;2012;    9022;    6501;    2519;    1969;     550;       2
5455;A028725;GM0654;2013;    9144;    6564;    2579;    1997;     582;       1
5456;A028725;GM0654;2014;    9174;    6550;    2624;    1990;     634;       0
5457;A028725;GM0654;2015;    9198;    6633;    2563;    1968;     595;       2
5458;A028725;GM0654;2016;    9258;    6673;    2581;    1993;     588;       4
5459;A028725;GM0654;2017;    9303;    6719;    2577;    2001;     576;       7
5460;A028725;GM0654;2018;    9353;    6853;    2476;    2000;     476;      24
5461;A028725;GM0654;2019;    9399;    6983;    2402;    1985;     417;      14
5462;A028725;GM0654;2020;    9374;    7007;    2348;    1946;     402;      19
5463;A028725;GM0499;2012;    5905;    3683;    2217;    1901;     316;       5
5464;A028725;GM0499;2013;    6002;    3760;    2237;    1917;     320;       5
5465;A028725;GM0499;2014;;;;;;
5466;A028725;GM0499;2015;;;;;;
5467;A028725;GM0499;2016;;;;;;
5468;A028725;GM0499;2017;;;;;;
5469;A028725;GM0499;2018;;;;;;
5470;A028725;GM0499;2019;;;;;;
5471;A028725;GM0499;2020;;;;;;
5472;A028725;GM0756;2012;   11034;    7711;    3314;    2657;     657;       9
5473;A028725;GM0756;2013;   11112;    7756;    3347;    2651;     696;       9
5474;A028725;GM0756;2014;   11293;    7766;    3518;    2754;     764;       9
5475;A028725;GM0756;2015;   11347;    7810;    3528;    2731;     797;       9
5476;A028725;GM0756;2016;   11453;    7908;    3539;    2711;     828;       6
5477;A028725;GM0756;2017;   11650;    7961;    3683;    2805;     878;       6
5478;A028725;GM0756;2018;   11846;    8208;    3625;    2841;     784;      13
5479;A028725;GM0756;2019;   12028;    8313;    3710;    2827;     883;       5
5480;A028725;GM0756;2020;   12228;    8397;    3816;    2850;     966;      15
5481;A028725;GM0757;2012;   12106;    7545;    4519;    3717;     802;      42
5482;A028725;GM0757;2013;   12321;    7626;    4650;    3813;     837;      45
5483;A028725;GM0757;2014;   12451;    7693;    4716;    3810;     906;      42
5484;A028725;GM0757;2015;   12552;    7719;    4792;    3889;     903;      41
5485;A028725;GM0757;2016;   12687;    7854;    4795;    3909;     886;      38
5486;A028725;GM0757;2017;   12749;    7865;    4846;    3916;     930;      38
5487;A028725;GM0757;2018;   12831;    7934;    4828;    3851;     977;      69
5488;A028725;GM0757;2019;   12876;    7974;    4877;    3905;     972;      25
5489;A028725;GM0757;2020;   12910;    7974;    4909;    3845;    1064;      27
5490;A028725;GM0758;2012;   73744;   42103;   31574;   22631;    8943;      67
5491;A028725;GM0758;2013;   75382;   42778;   32558;   23174;    9384;      46
5492;A028725;GM0758;2014;   77131;   43075;   33954;   24351;    9603;     102
5493;A028725;GM0758;2015;   78056;   43351;   34609;   24781;    9828;      96
5494;A028725;GM0758;2016;   78593;   43778;   34676;   24601;   10075;     139
5495;A028725;GM0758;2017;   79485;   43933;   35449;   24374;   11075;     103
5496;A028725;GM0758;2018;   80726;   44903;   35681;   24462;   11219;     142
5497;A028725;GM0758;2019;   81181;   45509;   35274;   24390;   10884;     398
5498;A028725;GM0758;2020;   81718;   45562;   35772;   24170;   11602;     384
5499;A028725;GM0501;2012;    6621;    4235;    2384;    1905;     479;       2
5500;A028725;GM0501;2013;    6892;    4339;    2550;    2079;     471;       3
5501;A028725;GM0501;2014;    6924;    4439;    2484;    1984;     500;       1
5502;A028725;GM0501;2015;    7040;    4544;    2482;    1820;     662;      14
5503;A028725;GM0501;2016;    7098;    4677;    2419;    1852;     567;       2
5504;A028725;GM0501;2017;    7255;    4766;    2485;    1841;     644;       4
5505;A028725;GM0501;2018;    7374;    4928;    2445;    1827;     618;       1
5506;A028725;GM0501;2019;    7464;    5054;    2408;    1827;     581;       2
5507;A028725;GM0501;2020;    7506;    5079;    2425;    1826;     599;       2
5508;A028725;GM1876;2012;   14732;   10313;    4390;    2803;    1587;      29
5509;A028725;GM1876;2013;   14865;   10367;    4471;    2807;    1664;      27
5510;A028725;GM1876;2014;   15138;   10416;    4565;    2550;    2015;     157
5511;A028725;GM1876;2015;   15234;   10495;    4596;    2801;    1795;     143
5512;A028725;GM1876;2016;   15248;   10560;    4601;    2785;    1816;      87
5513;A028725;GM1876;2017;   15296;   10595;    4605;    2771;    1834;      96
5514;A028725;GM1876;2018;   15399;   10958;    4334;    2809;    1525;     107
5515;A028725;GM1876;2019;   15416;   10993;    4384;    2917;    1467;      39
5516;A028725;GM1876;2020;   15437;   11007;    4398;    2879;    1519;      32
5517;A028725;GM0213;2012;    8701;    5113;    3569;    2923;     646;      19
5518;A028725;GM0213;2013;    8757;    5175;    3566;    2912;     654;      16
5519;A028725;GM0213;2014;    8795;    5250;    3538;    2869;     669;       7
5520;A028725;GM0213;2015;    8967;    5303;    3557;    2892;     665;     107
5521;A028725;GM0213;2016;    8987;    5329;    3555;    2864;     691;     103
5522;A028725;GM0213;2017;    8967;    5357;    3510;    2823;     687;     100
5523;A028725;GM0213;2018;    8996;    5552;    3343;    2810;     533;     101
5524;A028725;GM0213;2019;    8991;    5608;    3376;    2867;     509;       7
5525;A028725;GM0213;2020;    9063;    5642;    3415;    2884;     531;       6
5526;A028725;GM0899;2012;   13265;    8202;    5038;    4045;     993;      25
5527;A028725;GM0899;2013;   13353;    8206;    5146;    4012;    1134;       1
5528;A028725;GM0899;2014;   13372;    8255;    5116;    4015;    1101;       1
5529;A028725;GM0899;2015;   13346;    8240;    5099;    3976;    1123;       7
5530;A028725;GM0899;2016;   13392;    8263;    5124;    3940;    1184;       5
5531;A028725;GM0899;2017;   13425;    8235;    5188;    3901;    1287;       2
5532;A028725;GM0899;2018;   13475;    8379;    5086;    3857;    1229;      10
5533;A028725;GM0899;2019;   13464;    8451;    4991;    3832;    1159;      22
5534;A028725;GM0899;2020;   13415;    8487;    4901;    3728;    1173;      27
5535;A028725;GM0312;2012;    5734;    4268;    1461;     952;     509;       5
5536;A028725;GM0312;2013;    5865;    4347;    1515;     969;     546;       3
5537;A028725;GM0312;2014;    5901;    4384;    1513;     971;     542;       4
5538;A028725;GM0312;2015;    6000;    4428;    1563;     967;     596;       9
5539;A028725;GM0312;2016;    6059;    4476;    1574;     975;     599;       9
5540;A028725;GM0312;2017;    6165;    4550;    1606;     970;     636;       9
5541;A028725;GM0312;2018;    6206;    4612;    1574;     972;     602;      20
5542;A028725;GM0312;2019;    6197;    4692;    1493;     975;     518;      12
5543;A028725;GM0312;2020;    6192;    4677;    1505;     973;     532;      10
5544;A028725;GM0313;2012;    7225;    5650;    1564;    1023;     541;      11
5545;A028725;GM0313;2013;    7335;    5726;    1607;    1033;     574;       2
5546;A028725;GM0313;2014;    7584;    5808;    1682;    1040;     642;      94
5547;A028725;GM0313;2015;    7671;    5866;    1709;    1036;     673;      96
5548;A028725;GM0313;2016;    7752;    5762;    1891;    1068;     823;      99
5549;A028725;GM0313;2017;    7828;    5790;    1940;    1066;     874;      98
5550;A028725;GM0313;2018;    7952;    5916;    1930;    1096;     834;     106
5551;A028725;GM0313;2019;    8111;    6118;    1894;    1142;     752;      99
5552;A028725;GM0313;2020;    8214;    6204;    1925;    1129;     796;      85
5553;A028725;GM0214;2012;    9502;    7109;    2379;    1925;     454;      14
5554;A028725;GM0214;2013;    9521;    7167;    2342;    1895;     447;      12
5555;A028725;GM0214;2014;    9725;    7279;    2436;    1992;     444;      10
5556;A028725;GM0214;2015;    9844;    7290;    2544;    2070;     474;      10
5557;A028725;GM0214;2016;    9940;    7371;    2555;    2075;     480;      14
5558;A028725;GM0214;2017;   10047;    7432;    2598;    2070;     528;      17
5559;A028725;GM0214;2018;   10148;    7575;    2555;    2077;     478;      18
5560;A028725;GM0214;2019;   10227;    7680;    2522;    2075;     447;      25
5561;A028725;GM0214;2020;   10390;    7802;    2568;    2089;     479;      20
5562;A028725;GM0381;2012;   14035;    8736;    5291;    3365;    1926;       8
5563;A028725;GM0381;2013;   14247;    8775;    5457;    3466;    1991;      15
5564;A028725;GM0381;2014;   14673;    8768;    5597;    3309;    2288;     308
5565;A028725;GM0381;2015;   14857;    8909;    5619;    3408;    2211;     329
5566;A028725;GM0381;2016;;;;;;
5567;A028725;GM0381;2017;;;;;;
5568;A028725;GM0381;2018;;;;;;
5569;A028725;GM0381;2019;;;;;;
5570;A028725;GM0381;2020;;;;;;
5571;A028725;GM0502;2012;   28990;   14871;   14107;   11551;    2556;      12
5572;A028725;GM0502;2013;   29176;   15011;   14164;   11504;    2660;       1
5573;A028725;GM0502;2014;   29478;   15095;   14267;   11496;    2771;     116
5574;A028725;GM0502;2015;   29643;   15186;   14345;   11415;    2930;     112
5575;A028725;GM0502;2016;   29737;   15348;   14287;   11285;    3002;     102
5576;A028725;GM0502;2017;   29807;   15418;   14287;   11215;    3072;     102
5577;A028725;GM0502;2018;   29949;   15891;   14010;   11151;    2859;      48
5578;A028725;GM0502;2019;   30072;   16362;   13695;   11081;    2614;      15
5579;A028725;GM0502;2020;   30344;   16479;   13847;   10963;    2884;      18
5580;A028725;GM0383;2012;   14270;   10899;    3352;    2367;     985;      19
5581;A028725;GM0383;2013;   14518;   10926;    3586;    2390;    1196;       6
5582;A028725;GM0383;2014;   14591;   10937;    3644;    2395;    1249;      10
5583;A028725;GM0383;2015;   14743;   10992;    3715;    2434;    1281;      36
5584;A028725;GM0383;2016;   14890;   11080;    3772;    2418;    1354;      38
5585;A028725;GM0383;2017;   15151;   11304;    3821;    2460;    1361;      26
5586;A028725;GM0383;2018;   15326;   11546;    3749;    2463;    1286;      31
5587;A028725;GM0383;2019;   15425;   11635;    3659;    2509;    1150;     131
5588;A028725;GM0383;2020;   15495;   11743;    3670;    2491;    1179;      82
5589;A028725;GM0109;2012;   14619;   10222;    4324;    3483;     841;      73
5590;A028725;GM0109;2013;   14499;   10162;    4272;    3508;     764;      65
5591;A028725;GM0109;2014;   14669;   10201;    4350;    3491;     859;     118
5592;A028725;GM0109;2015;   14664;   10219;    4328;    3488;     840;     117
5593;A028725;GM0109;2016;   14638;   10271;    4251;    3413;     838;     116
5594;A028725;GM0109;2017;   14616;   10215;    4284;    3380;     904;     117
5595;A028725;GM0109;2018;   14809;   10164;    4500;    3424;    1076;     145
5596;A028725;GM0109;2019;   14849;   10434;    4390;    3494;     896;      25
5597;A028725;GM0109;2020;   14914;   10489;    4398;    3501;     897;      27
5598;A028725;GM1706;2012;    8207;    6183;    1997;    1525;     472;      27
5599;A028725;GM1706;2013;    8235;    6216;    1997;    1510;     487;      22
5600;A028725;GM1706;2014;    8325;    6231;    2053;    1526;     527;      41
5601;A028725;GM1706;2015;    8426;    6283;    2097;    1525;     572;      46
5602;A028725;GM1706;2016;    8476;    6328;    2100;    1517;     583;      48
5603;A028725;GM1706;2017;    8520;    6360;    2143;    1499;     644;      17
5604;A028725;GM1706;2018;    8557;    6391;    2147;    1496;     651;      19
5605;A028725;GM1706;2019;    8624;    6387;    2231;    1493;     738;       6
5606;A028725;GM1706;2020;    8684;    6425;    2255;    1490;     765;       4
5607;A028725;GM0611;2012;    5312;    3734;    1573;    1324;     249;       5
5608;A028725;GM0611;2013;    5269;    3726;    1541;    1279;     262;       2
5609;A028725;GM0611;2014;    5296;    3729;    1564;    1307;     257;       3
5610;A028725;GM0611;2015;    5384;    3776;    1607;    1334;     273;       1
5611;A028725;GM0611;2016;    5389;    3813;    1576;    1329;     247;       0
5612;A028725;GM0611;2017;    5425;    3790;    1633;    1331;     302;       2
5613;A028725;GM0611;2018;    5436;    3864;    1567;    1315;     252;       5
5614;A028725;GM0611;2019;;;;;;
5615;A028725;GM0611;2020;;;;;;
5616;A028725;GM1684;2012;    9905;    6306;    3578;    2932;     646;      21
5617;A028725;GM1684;2013;   10071;    6388;    3657;    3005;     652;      26
5618;A028725;GM1684;2014;   10188;    6431;    3738;    3003;     735;      19
5619;A028725;GM1684;2015;   10192;    6482;    3686;    2948;     738;      24
5620;A028725;GM1684;2016;   10314;    6580;    3716;    2970;     746;      18
5621;A028725;GM1684;2017;   10393;    6656;    3708;    2942;     766;      29
5622;A028725;GM1684;2018;   10606;    6755;    3819;    3035;     784;      32
5623;A028725;GM1684;2019;   10627;    6815;    3789;    2958;     831;      23
5624;A028725;GM1684;2020;   10764;    6879;    3866;    2987;     879;      19
5625;A028725;GM0216;2012;   10944;    6736;    4172;    2939;    1233;      36
5626;A028725;GM0216;2013;   11100;    6836;    4180;    3283;     897;      84
5627;A028725;GM0216;2014;   11141;    6909;    4196;    3243;     953;      36
5628;A028725;GM0216;2015;   11111;    6941;    4141;    3148;     993;      29
5629;A028725;GM0216;2016;   11395;    7111;    4190;    3312;     878;      94
5630;A028725;GM0216;2017;   11596;    7158;    4333;    3346;     987;     105
5631;A028725;GM0216;2018;   11802;    7237;    4463;    3346;    1117;     102
5632;A028725;GM0216;2019;   11962;    7635;    4248;    3301;     947;      79
5633;A028725;GM0216;2020;   12199;    7774;    4345;    3305;    1040;      80
5634;A028725;GM0148;2012;   10394;    7897;    2489;    1776;     713;       8
5635;A028725;GM0148;2013;   10539;    7999;    2536;    1826;     710;       4
5636;A028725;GM0148;2014;   10686;    8089;    2593;    1857;     736;       4
5637;A028725;GM0148;2015;   10803;    8158;    2640;    1869;     771;       5
5638;A028725;GM0148;2016;   10928;    8027;    2891;    1868;    1023;      10
5639;A028725;GM0148;2017;   11067;    8079;    2979;    1874;    1105;       9
5640;A028725;GM0148;2018;   11120;    8204;    2893;    1873;    1020;      23
5641;A028725;GM0148;2019;   11314;    8544;    2752;    1911;     841;      18
5642;A028725;GM0148;2020;   11466;    8582;    2866;    1995;     871;      18
5643;A028725;GM1891;2012;    7536;    4783;    2726;    2533;     193;      27
5644;A028725;GM1891;2013;    7548;    4802;    2722;    2508;     214;      24
5645;A028725;GM1891;2014;    7741;    4837;    2791;    2522;     269;     113
5646;A028725;GM1891;2015;    7782;    4855;    2856;    2552;     304;      71
5647;A028725;GM1891;2016;    7814;    4907;    2792;    2508;     284;     115
5648;A028725;GM1891;2017;    7813;    4892;    2806;    2495;     311;     115
5649;A028725;GM1891;2018;    7862;    4975;    2753;    2462;     291;     134
5650;A028725;GM1891;2019;    7913;    5022;    2865;    2554;     311;      26
5651;A028725;GM1891;2020;    7953;    5027;    2903;    2562;     341;      23
5652;A028725;GM0503;2012;   45523;   17087;   28288;   22383;    5905;     148
5653;A028725;GM0503;2013;   45787;   17342;   28354;   22280;    6074;      91
5654;A028725;GM0503;2014;   46126;   17520;   28505;   22307;    6198;     101
5655;A028725;GM0503;2015;   46737;   17724;   28913;   23649;    5264;     100
5656;A028725;GM0503;2016;   47219;   17978;   29137;   23636;    5501;     104
5657;A028725;GM0503;2017;   47469;   17867;   29501;   23517;    5984;     101
5658;A028725;GM0503;2018;   47610;   17947;   29552;   22160;    7392;     111
5659;A028725;GM0503;2019;   48247;   18398;   29650;   22118;    7532;     199
5660;A028725;GM0503;2020;   48654;   18536;   29836;   21987;    7849;     282
5661;A028725;GM0010;2012;   11203;    7177;    4020;    3242;     778;       6
5662;A028725;GM0010;2013;   11210;    7158;    4045;    3227;     818;       7
5663;A028725;GM0010;2014;   11394;    7140;    4248;    3281;     967;       6
5664;A028725;GM0010;2015;   11367;    7125;    4236;    3227;    1009;       6
5665;A028725;GM0010;2016;   11323;    7289;    3955;    3154;     801;      79
5666;A028725;GM0010;2017;   11257;    7266;    3913;    3069;     844;      78
5667;A028725;GM0010;2018;   11350;    7279;    4064;    3139;     925;       7
5668;A028725;GM0010;2019;   11331;    7271;    4047;    3118;     929;      13
5669;A028725;GM0010;2020;   11332;    7212;    4107;    3116;     991;      13
5670;A028725;GM0762;2012;   12358;    8155;    4200;    3239;     961;       3
5671;A028725;GM0762;2013;   12486;    8247;    4237;    3243;     994;       2
5672;A028725;GM0762;2014;   12578;    8322;    4253;    3234;    1019;       3
5673;A028725;GM0762;2015;   12841;    8428;    4325;    3270;    1055;      88
5674;A028725;GM0762;2016;   12995;    8508;    4353;    3282;    1071;     134
5675;A028725;GM0762;2017;   13085;    8563;    4394;    3285;    1109;     128
5676;A028725;GM0762;2018;   13231;    8783;    4300;    3310;     990;     148
5677;A028725;GM0762;2019;   13424;    8926;    4491;    3369;    1122;       7
5678;A028725;GM0762;2020;   13516;    8980;    4530;    3367;    1163;       6
5679;A028725;GM0150;2012;   40678;   23015;   17594;   13297;    4297;      69
5680;A028725;GM0150;2013;   40565;   23054;   17476;   13007;    4469;      35
5681;A028725;GM0150;2014;   40425;   23250;   17142;   12506;    4636;      33
5682;A028725;GM0150;2015;   40881;   23361;   17494;   12701;    4793;      26
5683;A028725;GM0150;2016;   41615;   23637;   17957;   12881;    5076;      21
5684;A028725;GM0150;2017;   43032;   23833;   19164;   13339;    5825;      35
5685;A028725;GM0150;2018;   43301;   24244;   19008;   13241;    5767;      49
5686;A028725;GM0150;2019;   43739;   24777;   18920;   13164;    5756;      42
5687;A028725;GM0150;2020;   44455;   24897;   19376;   13390;    5986;     182
5688;A028725;GM0384;2012;   11296;    4667;    6070;    3119;    2951;     559
5689;A028725;GM0384;2013;   11378;    4706;    6117;    3106;    3011;     555
5690;A028725;GM0384;2014;   11939;    4761;    6622;    3589;    3033;     556
5691;A028725;GM0384;2015;   12484;    4893;    7589;    4178;    3411;       2
5692;A028725;GM0384;2016;   12581;    4952;    7078;    3591;    3487;     551
5693;A028725;GM0384;2017;   12140;    5040;    7066;    3579;    3487;      34
5694;A028725;GM0384;2018;   12541;    5372;    7118;    3544;    3574;      51
5695;A028725;GM0384;2019;   13101;    5776;    7313;    3595;    3718;      12
5696;A028725;GM0384;2020;   14000;    5886;    8098;    3606;    4492;      16
5697;A028725;GM1774;2012;    9336;    6986;    2343;    1364;     979;       7
5698;A028725;GM1774;2013;    9459;    7092;    2361;    1367;     994;       6
5699;A028725;GM1774;2014;    9614;    7116;    2387;    1414;     973;     111
5700;A028725;GM1774;2015;    9670;    7149;    2413;    1435;     978;     108
5701;A028725;GM1774;2016;    9739;    7168;    2413;    1394;    1019;     158
5702;A028725;GM1774;2017;    9885;    7289;    2437;    1387;    1050;     159
5703;A028725;GM1774;2018;   10016;    7538;    2309;    1394;     915;     169
5704;A028725;GM1774;2019;   10142;    7596;    2532;    1384;    1148;      14
5705;A028725;GM1774;2020;   10193;    7634;    2550;    1380;    1170;       9
5706;A028725;GM0504;2012;    3180;    2058;    1121;     967;     154;       1
5707;A028725;GM0504;2013;;;;;;
5708;A028725;GM0504;2014;;;;;;
5709;A028725;GM0504;2015;;;;;;
5710;A028725;GM0504;2016;;;;;;
5711;A028725;GM0504;2017;;;;;;
5712;A028725;GM0504;2018;;;;;;
5713;A028725;GM0504;2019;;;;;;
5714;A028725;GM0504;2020;;;;;;
5715;A028725;GM0221;2012;    4924;    2566;    2353;    2084;     269;       5
5716;A028725;GM0221;2013;    4944;    2574;    2368;    2096;     272;       2
5717;A028725;GM0221;2014;    4975;    2585;    2387;    2070;     317;       3
5718;A028725;GM0221;2015;    4983;    2571;    2409;    2009;     400;       3
5719;A028725;GM0221;2016;    5067;    2603;    2463;    2063;     400;       1
5720;A028725;GM0221;2017;    5081;    2616;    2464;    2057;     407;       1
5721;A028725;GM0221;2018;    5128;    2689;    2438;    2079;     359;       1
5722;A028725;GM0221;2019;    5112;    2705;    2403;    2034;     369;       4
5723;A028725;GM0221;2020;    5102;    2712;    2385;    2009;     376;       5
5724;A028725;GM0222;2012;   23445;   14184;    9124;    7327;    1797;     137
5725;A028725;GM0222;2013;   23622;   14298;    9290;    7367;    1923;      34
5726;A028725;GM0222;2014;   24013;   14463;    9532;    7280;    2252;      18
5727;A028725;GM0222;2015;   24217;   14524;    9670;    7376;    2294;      23
5728;A028725;GM0222;2016;   24418;   14616;    9763;    7370;    2393;      39
5729;A028725;GM0222;2017;   24677;   14736;    9886;    7438;    2448;      55
5730;A028725;GM0222;2018;   24937;   14635;   10225;    7468;    2757;      77
5731;A028725;GM0222;2019;   25149;   15190;    9880;    7491;    2389;      79
5732;A028725;GM0222;2020;   25386;   15308;   10057;    7531;    2526;      21
5733;A028725;GM0766;2012;   10147;    7079;    3062;    2426;     636;       6
5734;A028725;GM0766;2013;   10332;    7219;    3112;    2463;     649;       1
5735;A028725;GM0766;2014;   10426;    7286;    3137;    2446;     691;       3
5736;A028725;GM0766;2015;   10508;    7333;    3173;    2457;     716;       2
5737;A028725;GM0766;2016;   10537;    7340;    3195;    2434;     761;       2
5738;A028725;GM0766;2017;   10571;    7361;    3209;    2404;     805;       1
5739;A028725;GM0766;2018;   10779;    7476;    3295;    2485;     810;       8
5740;A028725;GM0766;2019;   10917;    7730;    3183;    2297;     886;       4
5741;A028725;GM0766;2020;   10989;    7794;    3185;    2274;     911;      10
5742;A028725;GM0058;2012;    9981;    6509;    3470;    2860;     610;       2
5743;A028725;GM0058;2013;   10038;    6514;    3523;    2879;     644;       1
5744;A028725;GM0058;2014;   10273;    6512;    3570;    2880;     690;     191
5745;A028725;GM0058;2015;   10285;    6503;    3608;    2856;     752;     174
5746;A028725;GM0058;2016;   10293;    6553;    3584;    2813;     771;     156
5747;A028725;GM0058;2017;   10345;    6529;    3668;    2837;     831;     148
5748;A028725;GM0058;2018;   10351;    6648;    3566;    2799;     767;     137
5749;A028725;GM0058;2019;;;;;;
5750;A028725;GM0058;2020;;;;;;
5751;A028725;GM0505;2012;   51118;   28834;   22185;   16457;    5728;      99
5752;A028725;GM0505;2013;   51456;   29074;   22309;   16431;    5878;      73
5753;A028725;GM0505;2014;   51721;   29335;   22343;   16429;    5914;      43
5754;A028725;GM0505;2015;   51905;   29469;   22391;   16401;    5990;      45
5755;A028725;GM0505;2016;   52046;   29557;   22391;   16163;    6228;      98
5756;A028725;GM0505;2017;   52072;   29716;   22260;   15852;    6408;      96
5757;A028725;GM0505;2018;   52124;   30183;   21830;   15693;    6137;     111
5758;A028725;GM0505;2019;   52422;   30822;   21562;   15545;    6017;      38
5759;A028725;GM0505;2020;   52744;   31024;   21678;   15433;    6245;      42
5760;A028725;GM0498;2012;    7565;    5718;    1847;    1552;     295;       0
5761;A028725;GM0498;2013;    7638;    5735;    1903;    1553;     350;       0
5762;A028725;GM0498;2014;    7765;    5766;    1954;    1583;     371;      45
5763;A028725;GM0498;2015;    7806;    5786;    1968;    1571;     397;      52
5764;A028725;GM0498;2016;    7855;    5827;    1969;    1591;     378;      59
5765;A028725;GM0498;2017;    7909;    5874;    1970;    1600;     370;      65
5766;A028725;GM0498;2018;    7938;    5899;    1977;    1597;     380;      62
5767;A028725;GM0498;2019;    8004;    5970;    1988;    1654;     334;      46
5768;A028725;GM0498;2020;    8116;    6008;    2066;    1696;     370;      42
5769;A028725;GM1719;2012;   10538;    7579;    2930;    2469;     461;      29
5770;A028725;GM1719;2013;   10666;    7634;    3023;    2509;     514;       9
5771;A028725;GM1719;2014;   10915;    7689;    3129;    2582;     547;      97
5772;A028725;GM1719;2015;   11019;    7769;    3164;    2604;     560;      86
5773;A028725;GM1719;2016;   11105;    7847;    3181;    2584;     597;      77
5774;A028725;GM1719;2017;   11158;    7902;    3181;    2584;     597;      75
5775;A028725;GM1719;2018;   11295;    8092;    3101;    2582;     519;     102
5776;A028725;GM1719;2019;   11347;    8156;    3180;    2662;     518;      11
5777;A028725;GM1719;2020;   11412;    8207;    3197;    2655;     542;       8
5778;A028725;GM0303;2012;   15520;   10204;    5101;    4227;     874;     215
5779;A028725;GM0303;2013;   15687;   10267;    5302;    4250;    1052;     118
5780;A028725;GM0303;2014;   15765;   10273;    5375;    4231;    1144;     117
5781;A028725;GM0303;2015;   15883;   10317;    5491;    4298;    1193;      75
5782;A028725;GM0303;2016;   15876;   10374;    5467;    4295;    1172;      35
5783;A028725;GM0303;2017;   16053;   10378;    5645;    4290;    1355;      30
5784;A028725;GM0303;2018;   16182;   10458;    5689;    4241;    1448;      35
5785;A028725;GM0303;2019;   16342;   11093;    5232;    4347;     885;      17
5786;A028725;GM0303;2020;   16636;   11343;    5270;    4301;     969;      23
5787;A028725;GM0225;2012;    6988;    4437;    2517;    1977;     540;      34
5788;A028725;GM0225;2013;    7062;    4515;    2535;    1984;     551;      12
5789;A028725;GM0225;2014;    7214;    4546;    2583;    1938;     645;      85
5790;A028725;GM0225;2015;    7350;    4632;    2668;    1979;     689;      50
5791;A028725;GM0225;2016;    7427;    4730;    2649;    1933;     716;      48
5792;A028725;GM0225;2017;    7570;    4774;    2750;    1953;     797;      46
5793;A028725;GM0225;2018;    7697;    4975;    2629;    1935;     694;      93
5794;A028725;GM0225;2019;    7746;    5069;    2638;    1928;     710;      39
5795;A028725;GM0225;2020;    7845;    5158;    2647;    1901;     746;      40
5796;A028725;GM0226;2012;   10116;    6605;    3507;    2507;    1000;       4
5797;A028725;GM0226;2013;   10243;    6643;    3571;    2566;    1005;      29
5798;A028725;GM0226;2014;   10364;    6673;    3656;    2643;    1013;      35
5799;A028725;GM0226;2015;   10382;    6670;    3675;    2678;     997;      37
5800;A028725;GM0226;2016;   10412;    6712;    3664;    2678;     986;      36
5801;A028725;GM0226;2017;   10432;    6706;    3694;    2674;    1020;      32
5802;A028725;GM0226;2018;   10505;    6906;    3563;    2814;     749;      36
5803;A028725;GM0226;2019;   10536;    7032;    3488;    2840;     648;      16
5804;A028725;GM0226;2020;   10556;    7084;    3463;    2830;     633;       9
5805;A028725;GM1711;2012;   13476;    9384;    4033;    2797;    1236;      59
5806;A028725;GM1711;2013;   13529;    9433;    4058;    2770;    1288;      38
5807;A028725;GM1711;2014;   13554;    9740;    3793;    2727;    1066;      21
5808;A028725;GM1711;2015;   13622;    9757;    3844;    2712;    1132;      21
5809;A028725;GM1711;2016;   13834;    9727;    3956;    2700;    1256;     151
5810;A028725;GM1711;2017;   13875;    9744;    3972;    2717;    1255;     159
5811;A028725;GM1711;2018;   13922;    9886;    3861;    2746;    1115;     175
5812;A028725;GM1711;2019;   13937;    9921;    4001;    2761;    1240;      15
5813;A028725;GM1711;2020;   13970;    9954;    3996;    2719;    1277;      20
5814;A028725;GM0385;2012;   10808;    8846;    1961;    1587;     374;       1
5815;A028725;GM0385;2013;   10814;    8866;    1946;    1550;     396;       2
5816;A028725;GM0385;2014;   11470;    9021;    2447;    2030;     417;       2
5817;A028725;GM0385;2015;   11696;    9159;    2536;    2036;     500;       1
5818;A028725;GM0385;2016;   14282;   11187;    3089;    2452;     637;       6
5819;A028725;GM0385;2017;   14384;   11264;    3117;    2461;     656;       3
5820;A028725;GM0385;2018;   14502;   11349;    3147;    2473;     674;       6
5821;A028725;GM0385;2019;   14629;   11399;    3164;    2525;     639;      66
5822;A028725;GM0385;2020;   14697;   11439;    3202;    2521;     681;      56
5823;A028725;GM0228;2012;   40773;   27989;   12484;    9202;    3282;     300
5824;A028725;GM0228;2013;   41551;   28563;   12779;    9321;    3458;     209
5825;A028725;GM0228;2014;   42237;   28734;   13113;    9449;    3664;     390
5826;A028725;GM0228;2015;   42771;   28976;   13392;    9496;    3896;     403
5827;A028725;GM0228;2016;   43444;   29392;   13658;    9526;    4132;     394
5828;A028725;GM0228;2017;   44296;   29740;   14160;    9631;    4529;     396
5829;A028725;GM0228;2018;   44961;   30269;   14299;    9664;    4635;     393
5830;A028725;GM0228;2019;   45733;   30607;   15016;    9841;    5175;     110
5831;A028725;GM0228;2020;   46709;   31237;   15362;    9930;    5432;     110
5832;A028725;GM0317;2012;    3326;    2345;     965;     754;     211;      16
5833;A028725;GM0317;2013;    3426;    2401;    1024;     814;     210;       1
5834;A028725;GM0317;2014;    3454;    2413;    1040;     818;     222;       1
5835;A028725;GM0317;2015;    3519;    2441;    1077;     833;     244;       1
5836;A028725;GM0317;2016;    3568;    2497;    1070;     826;     244;       1
5837;A028725;GM0317;2017;    3605;    2508;    1096;     828;     268;       1
5838;A028725;GM0317;2018;    3719;    2663;    1054;     838;     216;       2
5839;A028725;GM0317;2019;    3771;    2728;    1017;     824;     193;      26
5840;A028725;GM0317;2020;    3890;    2791;    1048;     857;     191;      51
5841;A028725;GM1651;2012;    6897;    4296;    2568;    2181;     387;      33
5842;A028725;GM1651;2013;    6882;    4296;    2581;    2160;     421;       5
5843;A028725;GM1651;2014;    6930;    4293;    2632;    2208;     424;       5
5844;A028725;GM1651;2015;    6974;    4294;    2675;    2215;     460;       5
5845;A028725;GM1651;2016;    7045;    4300;    2743;    2242;     501;       2
5846;A028725;GM1651;2017;    7028;    4294;    2732;    2230;     502;       2
5847;A028725;GM1651;2018;    7024;    4399;    2622;    2193;     429;       3
5848;A028725;GM1651;2019;;;;;;
5849;A028725;GM1651;2020;;;;;;
5850;A028725;GM0770;2012;    7263;    5522;    1720;    1341;     379;      21
5851;A028725;GM0770;2013;    7289;    5520;    1760;    1334;     426;       9
5852;A028725;GM0770;2014;    7413;    5537;    1844;    1413;     431;      32
5853;A028725;GM0770;2015;    7494;    5589;    1874;    1427;     447;      31
5854;A028725;GM0770;2016;    7585;    5634;    1916;    1429;     487;      35
5855;A028725;GM0770;2017;    7598;    5651;    1910;    1404;     506;      37
5856;A028725;GM0770;2018;    7675;    5747;    1890;    1404;     486;      38
5857;A028725;GM0770;2019;    7840;    5858;    1977;    1411;     566;       5
5858;A028725;GM0770;2020;    7954;    5921;    2025;    1439;     586;       8
5859;A028725;GM1903;2012;    9788;    7482;    2296;    1278;    1018;      10
5860;A028725;GM1903;2013;    9853;    7481;    2365;    1262;    1103;       7
5861;A028725;GM1903;2014;   10086;    7590;    2387;    1256;    1131;     109
5862;A028725;GM1903;2015;   10193;    7614;    2515;    1170;    1345;      64
5863;A028725;GM1903;2016;   10297;    7710;    2520;    1159;    1361;      67
5864;A028725;GM1903;2017;   10374;    7793;    2519;    1140;    1379;      62
5865;A028725;GM1903;2018;   10592;    8254;    2249;    1130;    1119;      89
5866;A028725;GM1903;2019;   10658;    8238;    2378;    1154;    1224;      42
5867;A028725;GM1903;2020;   10776;    8342;    2393;    1150;    1243;      41
5868;A028725;GM0772;2012;   96428;   44933;   50762;   39413;   11349;     733
5869;A028725;GM0772;2013;   97178;   45372;   51340;   39414;   11926;     466
5870;A028725;GM0772;2014;   98924;   45628;   52732;   39623;   13109;     564
5871;A028725;GM0772;2015;  100133;   46011;   53622;   40268;   13354;     500
5872;A028725;GM0772;2016;  101187;   46270;   54106;   39779;   14327;     811
5873;A028725;GM0772;2017;  102704;   46956;   54566;   39658;   14908;    1182
5874;A028725;GM0772;2018;  104732;   47985;   56002;   39003;   16999;     745
5875;A028725;GM0772;2019;  106537;   48718;   57635;   40835;   16800;     184
5876;A028725;GM0772;2020;  108308;   48963;   59207;   41156;   18051;     138
5877;A028725;GM0230;2012;    8288;    5372;    2878;    2282;     596;      38
5878;A028725;GM0230;2013;    8419;    5458;    2950;    2297;     653;      11
5879;A028725;GM0230;2014;    8685;    5536;    2984;    2297;     687;     165
5880;A028725;GM0230;2015;    8788;    5609;    3014;    2369;     645;     165
5881;A028725;GM0230;2016;    8852;    5697;    2999;    2322;     677;     156
5882;A028725;GM0230;2017;    8913;    5701;    3059;    2327;     732;     153
5883;A028725;GM0230;2018;    8994;    5841;    2999;    2372;     627;     154
5884;A028725;GM0230;2019;    8990;    5862;    3127;    2444;     683;       1
5885;A028725;GM0230;2020;    9070;    5898;    3172;    2440;     732;       0
5886;A028725;GM0114;2012;   45639;   28903;   16391;   13136;    3255;     345
5887;A028725;GM0114;2013;   45750;   29035;   16468;   12972;    3496;     247
5888;A028725;GM0114;2014;   46262;   29169;   16739;   13062;    3677;     354
5889;A028725;GM0114;2015;   46471;   29106;   17063;   13221;    3842;     302
5890;A028725;GM0114;2016;   46711;   29420;   16981;   13133;    3848;     310
5891;A028725;GM0114;2017;   47027;   29431;   17275;   13263;    4012;     321
5892;A028725;GM0114;2018;   47248;   29496;   17439;   13298;    4141;     313
5893;A028725;GM0114;2019;   47412;   29917;   17458;   13598;    3860;      37
5894;A028725;GM0114;2020;   47660;   30016;   17603;   13557;    4046;      41
5895;A028725;GM0388;2012;    8031;    4789;    3157;    2619;     538;      85
5896;A028725;GM0388;2013;    8098;    4828;    3210;    2602;     608;      60
5897;A028725;GM0388;2014;    8227;    4832;    3276;    2584;     692;     119
5898;A028725;GM0388;2015;    8243;    4886;    3263;    2613;     650;      94
5899;A028725;GM0388;2016;    8308;    4945;    3260;    2545;     715;     103
5900;A028725;GM0388;2017;    8379;    5020;    3255;    2526;     729;     104
5901;A028725;GM0388;2018;    8396;    5129;    3162;    2507;     655;     105
5902;A028725;GM0388;2019;    8447;    5184;    3221;    2616;     605;      42
5903;A028725;GM0388;2020;    8520;    5209;    3265;    2594;     671;      46
5904;A028725;GM0153;2012;   69905;   34303;   34254;   26702;    7552;    1348
5905;A028725;GM0153;2013;   70475;   34412;   35307;   26754;    8553;     756
5906;A028725;GM0153;2014;   71033;   34390;   35925;   26745;    9180;     718
5907;A028725;GM0153;2015;   71097;   34487;   36011;   28845;    7166;     599
5908;A028725;GM0153;2016;   71305;   34608;   35901;   27401;    8500;     796
5909;A028725;GM0153;2017;   71111;   34301;   36077;   28094;    7983;     733
5910;A028725;GM0153;2018;   70396;   34896;   34937;   26994;    7943;     563
5911;A028725;GM0153;2019;   70798;   35402;   35322;   27011;    8311;      74
5912;A028725;GM0153;2020;   71816;   35498;   36208;   27158;    9050;     110
5913;A028725;GM0232;2012;   13008;    8327;    4635;    3615;    1020;      46
5914;A028725;GM0232;2013;   13032;    8352;    4646;    3586;    1060;      34
5915;A028725;GM0232;2014;   13038;    8318;    4667;    3568;    1099;      53
5916;A028725;GM0232;2015;   13092;    8353;    4712;    3622;    1090;      27
5917;A028725;GM0232;2016;   13380;    8460;    4812;    3680;    1132;     108
5918;A028725;GM0232;2017;   13504;    8483;    4920;    3737;    1183;     101
5919;A028725;GM0232;2018;   13608;    8723;    4791;    3759;    1032;      94
5920;A028725;GM0232;2019;   13768;    8968;    4789;    3875;     914;      11
5921;A028725;GM0232;2020;   13985;    9092;    4877;    3916;     961;      16
5922;A028725;GM0233;2012;    9560;    6063;    3371;    2609;     762;     126
5923;A028725;GM0233;2013;    9593;    6103;    3460;    2595;     865;      30
5924;A028725;GM0233;2014;    9895;    6244;    3634;    2587;    1047;      17
5925;A028725;GM0233;2015;   10089;    6340;    3711;    2608;    1103;      38
5926;A028725;GM0233;2016;   10248;    6452;    3768;    2621;    1147;      28
5927;A028725;GM0233;2017;   10310;    6491;    3789;    2649;    1140;      30
5928;A028725;GM0233;2018;   10398;    6613;    3752;    2664;    1088;      33
5929;A028725;GM0233;2019;   10467;    6708;    3746;    2682;    1064;      13
5930;A028725;GM0233;2020;   10575;    6793;    3769;    2705;    1064;      13
5931;A028725;GM0777;2012;   17009;   10943;    6057;    4713;    1344;       9
5932;A028725;GM0777;2013;   17455;   11113;    6322;    5002;    1320;      20
5933;A028725;GM0777;2014;   17592;   11124;    6449;    4890;    1559;      19
5934;A028725;GM0777;2015;   17692;   11227;    6440;    4906;    1534;      25
5935;A028725;GM0777;2016;   17912;   11323;    6563;    5006;    1557;      26
5936;A028725;GM0777;2017;   18099;   11434;    6620;    5009;    1611;      45
5937;A028725;GM0777;2018;   18325;   11544;    6726;    5027;    1699;      55
5938;A028725;GM0777;2019;   18533;   11930;    6596;    5239;    1357;       7
5939;A028725;GM0777;2020;   18664;   12034;    6623;    5241;    1382;       7
5940;A028725;GM1722;2012;    3537;    2513;    1022;     759;     263;       2
5941;A028725;GM1722;2013;    3508;    2524;     983;     723;     260;       1
5942;A028725;GM1722;2014;    3528;    2528;     996;     679;     317;       4
5943;A028725;GM1722;2015;    3650;    2547;    1022;     734;     288;      81
5944;A028725;GM1722;2016;    3642;    2535;    1034;     739;     295;      73
5945;A028725;GM1722;2017;    3669;    2549;    1042;     749;     293;      78
5946;A028725;GM1722;2018;    3669;    2603;     984;     734;     250;      82
5947;A028725;GM1722;2019;;;;;;
5948;A028725;GM1722;2020;;;;;;
5949;A028725;GM0070;2012;    8690;    5669;    3014;    2528;     486;       7
5950;A028725;GM0070;2013;    8686;    5676;    3005;    2502;     503;       5
5951;A028725;GM0070;2014;    8894;    5708;    3121;    2368;     753;      65
5952;A028725;GM0070;2015;    8907;    5710;    3131;    2489;     642;      66
5953;A028725;GM0070;2016;    8924;    5725;    3169;    2483;     686;      30
5954;A028725;GM0070;2017;    8923;    5740;    3155;    2470;     685;      28
5955;A028725;GM0070;2018;;;;;;
5956;A028725;GM0070;2019;;;;;;
5957;A028725;GM0070;2020;;;;;;
5958;A028725;GM1921;2012;;;;;;
5959;A028725;GM1921;2013;;;;;;
5960;A028725;GM1921;2014;   21109;   14191;    6795;    5443;    1352;     123
5961;A028725;GM1921;2015;   21265;   14325;    6857;    5552;    1305;      83
5962;A028725;GM1921;2016;;;;;;
5963;A028725;GM1921;2017;;;;;;
5964;A028725;GM1921;2018;;;;;;
5965;A028725;GM1921;2019;;;;;;
5966;A028725;GM1921;2020;;;;;;
5967;A028725;GM1940;2012;;;;;;
5968;A028725;GM1940;2013;;;;;;
5969;A028725;GM1940;2014;;;;;;
5970;A028725;GM1940;2015;;;;;;
5971;A028725;GM1940;2016;   21381;   14381;    6879;    5488;    1391;     121
5972;A028725;GM1940;2017;   21483;   14486;    6877;    5446;    1431;     120
5973;A028725;GM1940;2018;   21702;   14818;    6753;    5462;    1291;     131
5974;A028725;GM1940;2019;   21811;   15113;    6692;    5498;    1194;       6
5975;A028725;GM1940;2020;   21900;   15231;    6662;    5434;    1228;       7
5976;A028725;GM0653;2012;    4182;    2927;    1248;    1004;     244;       7
5977;A028725;GM0653;2013;    4180;    2930;    1245;    1000;     245;       5
5978;A028725;GM0653;2014;;;;;;
5979;A028725;GM0653;2015;;;;;;
5980;A028725;GM0653;2016;;;;;;
5981;A028725;GM0653;2017;;;;;;
5982;A028725;GM0653;2018;;;;;;
5983;A028725;GM0653;2019;;;;;;
5984;A028725;GM0653;2020;;;;;;
5985;A028725;GM0779;2012;    8957;    5632;    3310;    2947;     363;      15
5986;A028725;GM0779;2013;    9017;    5654;    3349;    2980;     369;      14
5987;A028725;GM0779;2014;    9116;    5718;    3388;    3035;     353;      10
5988;A028725;GM0779;2015;    9177;    5758;    3411;    3019;     392;       8
5989;A028725;GM0779;2016;    9238;    5843;    3387;    2952;     435;       8
5990;A028725;GM0779;2017;    9254;    5817;    3429;    2954;     475;       8
5991;A028725;GM0779;2018;    9301;    5825;    3471;    2946;     525;       5
5992;A028725;GM0779;2019;    9304;    5925;    3376;    2883;     493;       3
5993;A028725;GM0779;2020;    9328;    5926;    3399;    2892;     507;       3
5994;A028725;GM0236;2012;    9973;    6957;    2942;    2164;     778;      74
5995;A028725;GM0236;2013;    9999;    6984;    2959;    2145;     814;      56
5996;A028725;GM0236;2014;   10135;    7087;    2971;    2109;     862;      77
5997;A028725;GM0236;2015;   10192;    7172;    2931;    2097;     834;      89
5998;A028725;GM0236;2016;   10243;    7353;    2810;    2117;     693;      80
5999;A028725;GM0236;2017;   10381;    7390;    2927;    2092;     835;      64
6000;A028725;GM0236;2018;   10499;    7495;    2984;    2141;     843;      20
6001;A028725;GM0236;2019;;;;;;
6002;A028725;GM0236;2020;;;;;;
6003;A028725;GM1771;2012;   16514;   10643;    5808;    4697;    1111;      63
6004;A028725;GM1771;2013;   16577;   10683;    5822;    4666;    1156;      72
6005;A028725;GM1771;2014;   16691;   10727;    5856;    4640;    1216;     108
6006;A028725;GM1771;2015;   16720;   10800;    5867;    4605;    1262;      53
6007;A028725;GM1771;2016;   16798;   10872;    5926;    4669;    1257;       0
6008;A028725;GM1771;2017;   16893;   10847;    6045;    4677;    1368;       1
6009;A028725;GM1771;2018;   16956;   11083;    5870;    4644;    1226;       3
6010;A028725;GM1771;2019;   17152;   11354;    5788;    4664;    1124;      10
6011;A028725;GM1771;2020;   17233;   11378;    5842;    4651;    1191;      13
6012;A028725;GM1652;2012;   11125;    7618;    3444;    2598;     846;      63
6013;A028725;GM1652;2013;   11418;    7787;    3617;    2680;     937;      14
6014;A028725;GM1652;2014;   11575;    7854;    3711;    2623;    1088;      10
6015;A028725;GM1652;2015;   11729;    7923;    3790;    2585;    1205;      16
6016;A028725;GM1652;2016;   11920;    7987;    3913;    2606;    1307;      20
6017;A028725;GM1652;2017;   12081;    8042;    4018;    2627;    1391;      21
6018;A028725;GM1652;2018;   12237;    8309;    3893;    2663;    1230;      35
6019;A028725;GM1652;2019;   12328;    8370;    3940;    2660;    1280;      18
6020;A028725;GM1652;2020;   12205;    8347;    3841;    2690;    1151;      17
6021;A028725;GM0907;2012;    6779;    4459;    2296;    1678;     618;      24
6022;A028725;GM0907;2013;    6860;    4503;    2339;    1725;     614;      18
6023;A028725;GM0907;2014;    6904;    4502;    2383;    1716;     667;      19
6024;A028725;GM0907;2015;    7050;    4566;    2469;    1680;     789;      15
6025;A028725;GM0907;2016;    6993;    4584;    2391;    1670;     721;      18
6026;A028725;GM0907;2017;    7090;    4605;    2457;    1725;     732;      28
6027;A028725;GM0907;2018;    7111;    4723;    2375;    1721;     654;      13
6028;A028725;GM0907;2019;    7153;    4808;    2330;    1738;     592;      15
6029;A028725;GM0907;2020;    7166;    4804;    2355;    1737;     618;       7
6030;A028725;GM0689;2012;    5473;    4059;    1412;    1160;     252;       2
6031;A028725;GM0689;2013;    5489;    4063;    1424;    1153;     271;       2
6032;A028725;GM0689;2014;    5519;    4094;    1422;    1145;     277;       3
6033;A028725;GM0689;2015;    5595;    4135;    1458;    1183;     275;       2
6034;A028725;GM0689;2016;    5680;    4213;    1463;    1186;     277;       4
6035;A028725;GM0689;2017;    5705;    4218;    1480;    1177;     303;       7
6036;A028725;GM0689;2018;    5721;    4279;    1432;    1176;     256;      10
6037;A028725;GM0689;2019;;;;;;
6038;A028725;GM0689;2020;;;;;;
6039;A028725;GM0784;2012;    9648;    6260;    3380;    2892;     488;       8
6040;A028725;GM0784;2013;   10248;    6623;    3622;    3074;     548;       3
6041;A028725;GM0784;2014;   10495;    6665;    3824;    3247;     577;       6
6042;A028725;GM0784;2015;   10573;    6704;    3858;    3256;     602;      11
6043;A028725;GM0784;2016;   10634;    6742;    3883;    3234;     649;       9
6044;A028725;GM0784;2017;   10678;    6776;    3872;    3232;     640;      30
6045;A028725;GM0784;2018;   10783;    7004;    3765;    3244;     521;      14
6046;A028725;GM0784;2019;   10911;    7078;    3825;    3286;     539;       8
6047;A028725;GM0784;2020;   10962;    7091;    3863;    3287;     576;       8
6048;A028725;GM0511;2012;    4342;    2988;    1339;    1148;     191;      15
6049;A028725;GM0511;2013;;;;;;
6050;A028725;GM0511;2014;;;;;;
6051;A028725;GM0511;2015;;;;;;
6052;A028725;GM0511;2016;;;;;;
6053;A028725;GM0511;2017;;;;;;
6054;A028725;GM0511;2018;;;;;;
6055;A028725;GM0511;2019;;;;;;
6056;A028725;GM0511;2020;;;;;;
6057;A028725;GM1924;2012;;;;;;
6058;A028725;GM1924;2013;   19007;   11790;    7193;    6161;    1032;      24
6059;A028725;GM1924;2014;   19377;   12015;    7331;    6249;    1082;      31
6060;A028725;GM1924;2015;   19678;   12171;    7478;    6230;    1248;      29
6061;A028725;GM1924;2016;   19827;   12355;    7447;    6246;    1201;      25
6062;A028725;GM1924;2017;   20029;   12491;    7509;    6239;    1270;      29
6063;A028725;GM1924;2018;   20295;   12910;    7362;    6235;    1127;      23
6064;A028725;GM1924;2019;   20509;   13209;    7278;    6231;    1047;      22
6065;A028725;GM1924;2020;   20712;   13372;    7312;    6243;    1069;      28
6066;A028725;GM0664;2012;   16061;    9564;    6455;    5037;    1418;      42
6067;A028725;GM0664;2013;   16277;    9684;    6565;    5134;    1431;      28
6068;A028725;GM0664;2014;   16436;    9669;    6748;    5178;    1570;      19
6069;A028725;GM0664;2015;   16570;    9787;    6702;    5219;    1483;      81
6070;A028725;GM0664;2016;   16669;    9880;    6712;    5202;    1510;      77
6071;A028725;GM0664;2017;   16804;    9968;    6748;    5136;    1612;      88
6072;A028725;GM0664;2018;   16969;   10197;    6622;    5125;    1497;     150
6073;A028725;GM0664;2019;   17148;   10406;    6647;    5097;    1550;      95
6074;A028725;GM0664;2020;   17375;   10557;    6705;    5113;    1592;     113
6075;A028725;GM0785;2012;    9346;    6264;    2776;    2403;     373;     306
6076;A028725;GM0785;2013;    9453;    6554;    2862;    2426;     436;      37
6077;A028725;GM0785;2014;    9613;    6647;    2934;    2453;     481;      32
6078;A028725;GM0785;2015;    9595;    6658;    2933;    2459;     474;       4
6079;A028725;GM0785;2016;    9610;    6719;    2852;    2388;     464;      39
6080;A028725;GM0785;2017;    9696;    6758;    2901;    2380;     521;      37
6081;A028725;GM0785;2018;    9864;    6971;    2853;    2409;     444;      40
6082;A028725;GM0785;2019;    9971;    7102;    2859;    2464;     395;      10
6083;A028725;GM0785;2020;   10064;    7162;    2895;    2465;     430;       7
6084;A028725;GM1942;2012;;;;;;
6085;A028725;GM1942;2013;;;;;;
6086;A028725;GM1942;2014;;;;;;
6087;A028725;GM1942;2015;;;;;;
6088;A028725;GM1942;2016;   24800;   15630;    8769;    5740;    3029;     401
6089;A028725;GM1942;2017;   24875;   15785;    8710;    5674;    3036;     380
6090;A028725;GM1942;2018;   25037;   15971;    8650;    5644;    3006;     416
6091;A028725;GM1942;2019;   25189;   16306;    8790;    5782;    3008;      93
6092;A028725;GM1942;2020;   25340;   16363;    8944;    5770;    3174;      33
6093;A028725;GM0512;2012;   14717;    6933;    7721;    6852;     869;      63
6094;A028725;GM0512;2013;   14730;    6946;    7718;    6838;     880;      66
6095;A028725;GM0512;2014;   15214;    7125;    8024;    6902;    1122;      65
6096;A028725;GM0512;2015;   15277;    7193;    8051;    6872;    1179;      33
6097;A028725;GM0512;2016;   15342;    7275;    8024;    6775;    1249;      43
6098;A028725;GM0512;2017;   15534;    7496;    7999;    6704;    1295;      39
6099;A028725;GM0512;2018;   15698;    7685;    7973;    6693;    1280;      40
6100;A028725;GM0512;2019;   15858;    7843;    7981;    6620;    1361;      34
6101;A028725;GM0512;2020;   16318;    8104;    8202;    6459;    1743;      12
6102;A028725;GM0513;2012;   29609;   16420;   13138;    9811;    3327;      51
6103;A028725;GM0513;2013;   29789;   16517;   13258;    9906;    3352;      14
6104;A028725;GM0513;2014;   30143;   16621;   13488;    9980;    3508;      34
6105;A028725;GM0513;2015;   30397;   16918;   13447;   10018;    3429;      32
6106;A028725;GM0513;2016;   30611;   17058;   13446;    9751;    3695;     107
6107;A028725;GM0513;2017;   30946;   17139;   13666;    9823;    3843;     141
6108;A028725;GM0513;2018;   31630;   17369;   14129;    9920;    4209;     132
6109;A028725;GM0513;2019;   32085;   18007;   14018;    9888;    4130;      60
6110;A028725;GM0513;2020;   32322;   18110;   14157;    9904;    4253;      55
6111;A028725;GM0693;2012;    3289;    2275;    1001;     776;     225;      13
6112;A028725;GM0693;2013;;;;;;
6113;A028725;GM0693;2014;;;;;;
6114;A028725;GM0693;2015;;;;;;
6115;A028725;GM0693;2016;;;;;;
6116;A028725;GM0693;2017;;;;;;
6117;A028725;GM0693;2018;;;;;;
6118;A028725;GM0693;2019;;;;;;
6119;A028725;GM0693;2020;;;;;;
6120;A028725;GM0365;2012;    2486;    1887;     593;     431;     162;       6
6121;A028725;GM0365;2013;    2503;    1906;     592;     432;     160;       5
6122;A028725;GM0365;2014;    2519;    1914;     602;     432;     170;       3
6123;A028725;GM0365;2015;;;;;;
6124;A028725;GM0365;2016;;;;;;
6125;A028725;GM0365;2017;;;;;;
6126;A028725;GM0365;2018;;;;;;
6127;A028725;GM0365;2019;;;;;;
6128;A028725;GM0365;2020;;;;;;
6129;A028725;GM0786;2012;    4897;    3349;    1526;    1051;     475;      22
6130;A028725;GM0786;2013;    4929;    3373;    1542;    1054;     488;      14
6131;A028725;GM0786;2014;    4934;    3384;    1534;    1045;     489;      16
6132;A028725;GM0786;2015;    5103;    3417;    1668;    1153;     515;      18
6133;A028725;GM0786;2016;    5145;    3450;    1673;    1155;     518;      22
6134;A028725;GM0786;2017;    5152;    3480;    1653;    1148;     505;      19
6135;A028725;GM0786;2018;    5199;    3569;    1606;    1148;     458;      24
6136;A028725;GM0786;2019;    5243;    3631;    1579;    1149;     430;      33
6137;A028725;GM0786;2020;    5254;    3639;    1607;    1141;     466;       8
6138;A028725;GM0518;2012;  219180;   99340;  118426;   77677;   40749;    1414
6139;A028725;GM0518;2013;  222196;   99874;  120477;   77719;   42758;    1845
6140;A028725;GM0518;2014;  225202;  100080;  123524;   77933;   45591;    1598
6141;A028725;GM0518;2015;  227464;  100377;  125721;   78188;   47533;    1366
6142;A028725;GM0518;2016;  230398;  100877;  127581;   77258;   50323;    1940
6143;A028725;GM0518;2017;  233080;  101795;  129939;   76794;   53145;    1346
6144;A028725;GM0518;2018;  236950;  101831;  132861;   77260;   55601;    2258
6145;A028725;GM0518;2019;  239336;  103172;  134753;   78219;   56534;    1411
6146;A028725;GM0518;2020;  242536;  103422;  137256;   79028;   58228;    1858
6147;A028725;GM0241;2012;    7251;    4363;    2884;    2195;     689;       4
6148;A028725;GM0241;2013;    7569;    4508;    3057;    2373;     684;       4
6149;A028725;GM0241;2014;    7713;    4555;    3143;    2424;     719;      15
6150;A028725;GM0241;2015;   14422;    8826;    5578;    4423;    1155;      18
6151;A028725;GM0241;2016;;;;;;
6152;A028725;GM0241;2017;;;;;;
6153;A028725;GM0241;2018;;;;;;
6154;A028725;GM0241;2019;;;;;;
6155;A028725;GM0241;2020;;;;;;
6156;A028725;GM0014;2012;   88482;   35329;   51945;   34372;   17573;    1208
6157;A028725;GM0014;2013;   89953;   35535;   53620;   34923;   18697;     798
6158;A028725;GM0014;2014;   92047;   35702;   55466;   35608;   19858;     879
6159;A028725;GM0014;2015;   93526;   35958;   57096;   37894;   19202;     472
6160;A028725;GM0014;2016;   94965;   36290;   58123;   37536;   20587;     552
6161;A028725;GM0014;2017;   96922;   37013;   59483;   37413;   22070;     426
6162;A028725;GM0014;2018;   96949;   37385;   58809;   35927;   22882;     755
6163;A028725;GM0014;2019;  109868;   46517;   63076;   37704;   25372;     275
6164;A028725;GM0014;2020;  111541;   46596;   64245;   37502;   26743;     700
6165;A028725;GM0015;2012;    4533;    3382;    1136;     919;     217;      15
6166;A028725;GM0015;2013;    4667;    3438;    1228;     969;     259;       1
6167;A028725;GM0015;2014;    4692;    3458;    1234;     959;     275;       0
6168;A028725;GM0015;2015;    4742;    3456;    1197;     938;     259;      89
6169;A028725;GM0015;2016;    4805;    3501;    1215;     942;     273;      89
6170;A028725;GM0015;2017;    4831;    3496;    1237;     929;     308;      98
6171;A028725;GM0015;2018;    4855;    3606;    1156;     922;     234;      93
6172;A028725;GM0015;2019;;;;;;
6173;A028725;GM0015;2020;;;;;;
6174;A028725;GM1729;2012;    5797;    4022;    1768;    1145;     623;       7
6175;A028725;GM1729;2013;    6029;    4153;    1874;    1191;     683;       2
6176;A028725;GM1729;2014;    6172;    4170;    1927;    1216;     711;      75
6177;A028725;GM1729;2015;    6199;    4077;    2047;    1221;     826;      75
6178;A028725;GM1729;2016;    6201;    4072;    2057;    1233;     824;      72
6179;A028725;GM1729;2017;    6229;    4105;    2060;    1227;     833;      64
6180;A028725;GM1729;2018;    6203;    4237;    1911;    1224;     687;      55
6181;A028725;GM1729;2019;    6252;    4272;    1958;    1231;     727;      22
6182;A028725;GM1729;2020;    6298;    4298;    1982;    1257;     725;      18
6183;A028725;GM0158;2012;    9340;    6454;    2808;    2175;     633;      78
6184;A028725;GM0158;2013;    9424;    6566;    2796;    2149;     647;      62
6185;A028725;GM0158;2014;    9610;    6585;    2861;    2165;     696;     164
6186;A028725;GM0158;2015;    9697;    6581;    2980;    2224;     756;     136
6187;A028725;GM0158;2016;    9760;    6610;    2988;    2189;     799;     162
6188;A028725;GM0158;2017;    9775;    6625;    3008;    2181;     827;     142
6189;A028725;GM0158;2018;    9840;    6823;    2848;    2169;     679;     169
6190;A028725;GM0158;2019;    9932;    6878;    3046;    2215;     831;       8
6191;A028725;GM0158;2020;    9992;    6941;    3044;    2205;     839;       7
6192;A028725;GM0788;2012;    4852;    3823;    1018;     755;     263;      11
6193;A028725;GM0788;2013;    4974;    3881;    1070;     749;     321;      23
6194;A028725;GM0788;2014;    5011;    3878;    1100;     741;     359;      33
6195;A028725;GM0788;2015;    5020;    3874;    1124;     747;     377;      22
6196;A028725;GM0788;2016;    5079;    3917;    1140;     745;     395;      22
6197;A028725;GM0788;2017;    5237;    3979;    1157;     757;     400;     101
6198;A028725;GM0788;2018;    5561;    4129;    1273;     887;     386;     159
6199;A028725;GM0788;2019;    5638;    4166;    1470;     939;     531;       2
6200;A028725;GM0788;2020;    5752;    4220;    1497;     935;     562;      35
6201;A028725;GM0392;2012;   67704;   35848;   31136;   22637;    8499;     720
6202;A028725;GM0392;2013;   68405;   36223;   31748;   22733;    9015;     434
6203;A028725;GM0392;2014;   69316;   36652;   32314;   22486;    9828;     350
6204;A028725;GM0392;2015;   70083;   37069;   32802;   22588;   10214;     212
6205;A028725;GM0392;2016;   70701;   37472;   33038;   22436;   10602;     191
6206;A028725;GM0392;2017;   71085;   37782;   33022;   22226;   10796;     281
6207;A028725;GM0392;2018;   71622;   38435;   32947;   22082;   10865;     240
6208;A028725;GM0392;2019;   72323;   39078;   33124;   22313;   10811;     121
6209;A028725;GM0392;2020;   73230;   39227;   33884;   22328;   11556;     119
6210;A028725;GM0393;2012;    2081;    1390;     688;     482;     206;       3
6211;A028725;GM0393;2013;    2127;    1445;     682;     478;     204;       0
6212;A028725;GM0393;2014;    2155;    1460;     694;     486;     208;       1
6213;A028725;GM0393;2015;    2179;    1486;     693;     489;     204;       0
6214;A028725;GM0393;2016;    2186;    1504;     681;     493;     188;       1
6215;A028725;GM0393;2017;    2212;    1540;     671;     482;     189;       1
6216;A028725;GM0393;2018;    2258;    1585;     669;     479;     190;       4
6217;A028725;GM0393;2019;;;;;;
6218;A028725;GM0393;2020;;;;;;
6219;A028725;GM0394;2012;   56306;   36924;   19225;   13758;    5467;     157
6220;A028725;GM0394;2013;   56543;   37289;   19236;   13451;    5785;      18
6221;A028725;GM0394;2014;   56838;   37525;   19299;   13089;    6210;      14
6222;A028725;GM0394;2015;   57248;   37746;   19442;   13530;    5912;      60
6223;A028725;GM0394;2016;   57529;   38091;   19371;   13382;    5989;      67
6224;A028725;GM0394;2017;   58209;   38479;   19631;   13405;    6226;      99
6225;A028725;GM0394;2018;   58737;   39504;   19083;   13533;    5550;     150
6226;A028725;GM0394;2019;   61377;   41859;   19479;   14055;    5424;      39
6227;A028725;GM0394;2020;   62106;   42203;   19861;   14137;    5724;      42
6228;A028725;GM1655;2012;   12042;    7634;    4379;    3885;     494;      29
6229;A028725;GM1655;2013;   12202;    7823;    4360;    3879;     481;      19
6230;A028725;GM1655;2014;   12273;    7833;    4427;    3901;     526;      13
6231;A028725;GM1655;2015;   12432;    7931;    4493;    3820;     673;       8
6232;A028725;GM1655;2016;   12539;    7965;    4568;    3918;     650;       6
6233;A028725;GM1655;2017;   12528;    7977;    4547;    3804;     743;       4
6234;A028725;GM1655;2018;   12612;    7966;    4633;    3842;     791;      13
6235;A028725;GM1655;2019;   12823;    8357;    4457;    3902;     555;       9
6236;A028725;GM1655;2020;   12936;    8453;    4477;    3898;     579;       6
6237;A028725;GM0160;2012;   22176;   15322;    6800;    4811;    1989;      54
6238;A028725;GM0160;2013;   22371;   15477;    6850;    4820;    2030;      44
6239;A028725;GM0160;2014;   22501;   15561;    6885;    4828;    2057;      55
6240;A028725;GM0160;2015;   22718;   15584;    7008;    4929;    2079;     126
6241;A028725;GM0160;2016;   22966;   15735;    7054;    4854;    2200;     177
6242;A028725;GM0160;2017;   23252;   15893;    7179;    4870;    2309;     180
6243;A028725;GM0160;2018;   23496;   16518;    6786;    4978;    1808;     192
6244;A028725;GM0160;2019;   23701;   16778;    6634;    5029;    1605;     289
6245;A028725;GM0160;2020;   23964;   16947;    6866;    5122;    1744;     151
6246;A028725;GM0243;2012;   17707;   10413;    7088;    5524;    1564;     206
6247;A028725;GM0243;2013;   17835;   10536;    7126;    5539;    1587;     173
6248;A028725;GM0243;2014;   17899;   10574;    7156;    5418;    1738;     169
6249;A028725;GM0243;2015;   18088;   10588;    7274;    5583;    1691;     226
6250;A028725;GM0243;2016;   18245;   10790;    7301;    5614;    1687;     154
6251;A028725;GM0243;2017;   18511;   10917;    7437;    5632;    1805;     157
6252;A028725;GM0243;2018;   18618;   10973;    7454;    5627;    1827;     191
6253;A028725;GM0243;2019;   18853;   11313;    7421;    5669;    1752;     119
6254;A028725;GM0243;2020;   19300;   11550;    7642;    5736;    1906;     108
6255;A028725;GM0523;2012;    6667;    4134;    2476;    2107;     369;      57
6256;A028725;GM0523;2013;    6737;    4176;    2508;    2112;     396;      53
6257;A028725;GM0523;2014;    6788;    4210;    2526;    2093;     433;      52
6258;A028725;GM0523;2015;    6797;    4256;    2492;    2062;     430;      49
6259;A028725;GM0523;2016;    6849;    4332;    2465;    2037;     428;      52
6260;A028725;GM0523;2017;    6894;    4377;    2467;    2023;     444;      50
6261;A028725;GM0523;2018;    6966;    4508;    2400;    2000;     400;      58
6262;A028725;GM0523;2019;    7015;    4593;    2397;    2020;     377;      25
6263;A028725;GM0523;2020;    7083;    4656;    2409;    2025;     384;      18
6264;A028725;GM0017;2012;    8052;    5587;    2447;    1185;    1262;      18
6265;A028725;GM0017;2013;    8089;    5580;    2505;    1220;    1285;       4
6266;A028725;GM0017;2014;    8182;    5653;    2526;    1199;    1327;       3
6267;A028725;GM0017;2015;    8222;    5729;    2491;    1191;    1300;       2
6268;A028725;GM0017;2016;    8242;    5778;    2462;    1176;    1286;       2
6269;A028725;GM0017;2017;    8388;    5883;    2501;    1133;    1368;       4
6270;A028725;GM0017;2018;    8533;    6220;    2305;    1124;    1181;       8
6271;A028725;GM0017;2019;;;;;;
6272;A028725;GM0017;2020;;;;;;
6273;A028725;GM0395;2012;    6039;    4506;    1532;    1203;     329;       1
6274;A028725;GM0395;2013;;;;;;
6275;A028725;GM0395;2014;;;;;;
6276;A028725;GM0395;2015;;;;;;
6277;A028725;GM0395;2016;;;;;;
6278;A028725;GM0395;2017;;;;;;
6279;A028725;GM0395;2018;;;;;;
6280;A028725;GM0395;2019;;;;;;
6281;A028725;GM0395;2020;;;;;;
6282;A028725;GM0072;2012;    7008;    3904;    3069;    2405;     664;      35
6283;A028725;GM0072;2013;    7018;    3953;    3039;    2364;     675;      26
6284;A028725;GM0072;2014;    7081;    3949;    3112;    2396;     716;      20
6285;A028725;GM0072;2015;    7140;    3937;    3194;    2454;     740;       9
6286;A028725;GM0072;2016;    7169;    3959;    3193;    2454;     739;      17
6287;A028725;GM0072;2017;    7198;    3965;    3218;    2431;     787;      15
6288;A028725;GM0072;2018;    7162;    4034;    3111;    2354;     757;      17
6289;A028725;GM0072;2019;    7226;    4115;    3111;    2356;     755;       0
6290;A028725;GM0072;2020;    7305;    4135;    3170;    2385;     785;       0
6291;A028725;GM0244;2012;    4772;    3038;    1637;    1327;     310;      97
6292;A028725;GM0244;2013;    4812;    3099;    1611;    1304;     307;     102
6293;A028725;GM0244;2014;    4826;    3124;    1663;    1278;     385;      39
6294;A028725;GM0244;2015;    4905;    3155;    1699;    1313;     386;      51
6295;A028725;GM0244;2016;    4932;    3177;    1730;    1302;     428;      25
6296;A028725;GM0244;2017;    5004;    3227;    1755;    1332;     423;      22
6297;A028725;GM0244;2018;    5049;    3345;    1676;    1313;     363;      28
6298;A028725;GM0244;2019;    5064;    3408;    1633;    1356;     277;      23
6299;A028725;GM0244;2020;    5093;    3427;    1644;    1355;     289;      22
6300;A028725;GM0396;2012;   16476;    9465;    6994;    5640;    1354;      17
6301;A028725;GM0396;2013;   16485;    9485;    6984;    5599;    1385;      16
6302;A028725;GM0396;2014;   16683;    9590;    7030;    5477;    1553;      63
6303;A028725;GM0396;2015;   16834;    9705;    7108;    5541;    1567;      21
6304;A028725;GM0396;2016;   17011;    9783;    7187;    5570;    1617;      41
6305;A028725;GM0396;2017;   17035;    9850;    7142;    5540;    1602;      43
6306;A028725;GM0396;2018;   17015;   10090;    6879;    5466;    1413;      46
6307;A028725;GM0396;2019;   17004;   10246;    6750;    5548;    1202;       8
6308;A028725;GM0396;2020;   17074;   10289;    6775;    5476;    1299;      10
6309;A028725;GM0397;2012;   11246;    7283;    3823;    2460;    1363;     140
6310;A028725;GM0397;2013;   11289;    7289;    3918;    2471;    1447;      82
6311;A028725;GM0397;2014;   11635;    7428;    4103;    2526;    1577;     104
6312;A028725;GM0397;2015;   11764;    7509;    4144;    2549;    1595;     111
6313;A028725;GM0397;2016;   11932;    7659;    4101;    2543;    1558;     172
6314;A028725;GM0397;2017;   11961;    7688;    4105;    2504;    1601;     168
6315;A028725;GM0397;2018;   12014;    7849;    3969;    2503;    1466;     196
6316;A028725;GM0397;2019;   12066;    7949;    4044;    2668;    1376;      73
6317;A028725;GM0397;2020;   12036;    7940;    4030;    2618;    1412;      66
6318;A028725;GM0246;2012;    7106;    4961;    2113;    1708;     405;      32
6319;A028725;GM0246;2013;    7217;    5037;    2167;    1743;     424;      13
6320;A028725;GM0246;2014;    7414;    5078;    2196;    1750;     446;     140
6321;A028725;GM0246;2015;    7484;    5120;    2224;    1782;     442;     140
6322;A028725;GM0246;2016;    7504;    5158;    2213;    1759;     454;     133
6323;A028725;GM0246;2017;    7535;    5179;    2222;    1753;     469;     134
6324;A028725;GM0246;2018;    7545;    5199;    2203;    1756;     447;     143
6325;A028725;GM0246;2019;    7566;    5224;    2264;    1852;     412;      78
6326;A028725;GM0246;2020;    7647;    5290;    2331;    1830;     501;      26
6327;A028725;GM0074;2012;   18678;   10963;    7689;    6036;    1653;      26
6328;A028725;GM0074;2013;   18757;   11119;    7631;    5930;    1701;       7
6329;A028725;GM0074;2014;   21902;   13063;    8638;    6597;    2041;     201
6330;A028725;GM0074;2015;   22018;   13181;    8638;    6719;    1919;     199
6331;A028725;GM0074;2016;   22126;   13259;    8680;    6641;    2039;     187
6332;A028725;GM0074;2017;   22172;   13325;    8650;    6553;    2097;     197
6333;A028725;GM0074;2018;   22282;   13421;    8662;    6498;    2164;     199
6334;A028725;GM0074;2019;   22316;   13648;    8556;    6545;    2011;     112
6335;A028725;GM0074;2020;   22601;   13741;    8749;    6628;    2121;     111
6336;A028725;GM0398;2012;   20773;   14649;    6093;    4586;    1507;      31
6337;A028725;GM0398;2013;   21004;   14800;    6192;    4673;    1519;      12
6338;A028725;GM0398;2014;   21411;   14951;    6411;    4801;    1610;      49
6339;A028725;GM0398;2015;   21696;   15019;    6628;    4862;    1766;      49
6340;A028725;GM0398;2016;   21894;   15155;    6665;    4800;    1865;      74
6341;A028725;GM0398;2017;   22276;   15314;    6898;    4845;    2053;      64
6342;A028725;GM0398;2018;   22674;   15751;    6824;    4864;    1960;      99
6343;A028725;GM0398;2019;   22972;   16114;    6847;    5049;    1798;      11
6344;A028725;GM0398;2020;   23357;   16358;    6987;    5047;    1940;      12
6345;A028725;GM0917;2012;   42473;   20474;   21932;   16544;    5388;      67
6346;A028725;GM0917;2013;   42508;   20395;   22067;   16343;    5724;      46
6347;A028725;GM0917;2014;   42469;   20363;   22045;   16216;    5829;      61
6348;A028725;GM0917;2015;   42569;   20283;   22212;   16240;    5972;      74
6349;A028725;GM0917;2016;   42744;   20235;   22445;   16197;    6248;      64
6350;A028725;GM0917;2017;   43165;   20257;   22467;   16107;    6360;     441
6351;A028725;GM0917;2018;   43314;   20510;   22363;   16058;    6305;     441
6352;A028725;GM0917;2019;   43460;   20766;   22631;   16084;    6547;      63
6353;A028725;GM0917;2020;   43586;   20822;   22691;   16045;    6646;      73
6354;A028725;GM1658;2012;    6018;    4547;    1455;     956;     499;      16
6355;A028725;GM1658;2013;    6092;    4602;    1477;     949;     528;      13
6356;A028725;GM1658;2014;    6181;    4648;    1486;     939;     547;      47
6357;A028725;GM1658;2015;    6239;    4674;    1536;     961;     575;      29
6358;A028725;GM1658;2016;    6344;    4774;    1510;     937;     573;      60
6359;A028725;GM1658;2017;    6387;    4766;    1549;     925;     624;      72
6360;A028725;GM1658;2018;    6461;    4982;    1421;     956;     465;      58
6361;A028725;GM1658;2019;    6526;    5050;    1426;     990;     436;      50
6362;A028725;GM1658;2020;    6603;    5116;    1436;     988;     448;      51
6363;A028725;GM0399;2012;    9460;    7006;    2409;    1731;     678;      45
6364;A028725;GM0399;2013;    9486;    7017;    2427;    1690;     737;      42
6365;A028725;GM0399;2014;    9681;    7042;    2561;    1750;     811;      78
6366;A028725;GM0399;2015;    9738;    7030;    2630;    1756;     874;      78
6367;A028725;GM0399;2016;    9848;    7039;    2776;    1817;     959;      33
6368;A028725;GM0399;2017;    9996;    7125;    2785;    1809;     976;      86
6369;A028725;GM0399;2018;   10090;    7346;    2708;    1832;     876;      36
6370;A028725;GM0399;2019;   10225;    7527;    2688;    1844;     844;      10
6371;A028725;GM0399;2020;   10417;    7629;    2778;    1879;     899;      10
6372;A028725;GM0400;2012;   25681;   13759;   11837;   10293;    1544;      85
6373;A028725;GM0400;2013;   25662;   13813;   11794;   10170;    1624;      55
6374;A028725;GM0400;2014;   25855;   13905;   11911;   10162;    1749;      39
6375;A028725;GM0400;2015;   26228;   14022;   11967;   10112;    1855;     239
6376;A028725;GM0400;2016;   26355;   14082;   12113;   10146;    1967;     160
6377;A028725;GM0400;2017;   26410;   14114;   12141;   10093;    2048;     155
6378;A028725;GM0400;2018;   26470;   14338;   11956;    8057;    3899;     176
6379;A028725;GM0400;2019;   26610;   14589;   12019;   10089;    1930;       2
6380;A028725;GM0400;2020;   26806;   14761;   12040;   10084;    1956;       5
6381;A028725;GM0163;2012;   13710;    9747;    3947;    3060;     887;      16
6382;A028725;GM0163;2013;   13845;    9810;    4020;    3081;     939;      15
6383;A028725;GM0163;2014;   13903;    9850;    4046;    3059;     987;       7
6384;A028725;GM0163;2015;   13978;    9945;    4017;    3056;     961;      16
6385;A028725;GM0163;2016;   14127;    9985;    4130;    3040;    1090;      12
6386;A028725;GM0163;2017;   14202;   10056;    4117;    3019;    1098;      29
6387;A028725;GM0163;2018;   14280;   10377;    3871;    3080;     791;      32
6388;A028725;GM0163;2019;   14353;   10449;    3869;    3078;     791;      35
6389;A028725;GM0163;2020;   14484;   10535;    3911;    3129;     782;      38
6390;A028725;GM0530;2012;   16525;   10567;    5951;    5114;     837;       7
6391;A028725;GM0530;2013;   16563;   10613;    5917;    5103;     814;      33
6392;A028725;GM0530;2014;   16623;   10656;    5961;    5161;     800;       6
6393;A028725;GM0530;2015;   16678;   10729;    5944;    5123;     821;       5
6394;A028725;GM0530;2016;   16709;   10878;    5830;    5072;     758;       1
6395;A028725;GM0530;2017;   16812;   10906;    5903;    5121;     782;       3
6396;A028725;GM0530;2018;   17405;   11386;    6015;    5234;     781;       4
6397;A028725;GM0530;2019;   17424;   11563;    5856;    5209;     647;       5
6398;A028725;GM0530;2020;   17454;   11586;    5862;    5195;     667;       6
6399;A028725;GM0794;2012;   36968;   19910;   17046;   14425;    2621;      12
6400;A028725;GM0794;2013;   37214;   19986;   17217;   14390;    2827;      11
6401;A028725;GM0794;2014;   37616;   20102;   17503;   14813;    2690;      11
6402;A028725;GM0794;2015;   37955;   20218;   17732;   14548;    3184;       5
6403;A028725;GM0794;2016;   38289;   20354;   17927;   14597;    3330;       8
6404;A028725;GM0794;2017;   38484;   20435;   18043;   14599;    3444;       6
6405;A028725;GM0794;2018;   38762;   20841;   17892;   14724;    3168;      29
6406;A028725;GM0794;2019;   39204;   21290;   17893;   14812;    3081;      21
6407;A028725;GM0794;2020;   39733;   21570;   18060;   14898;    3162;     103
6408;A028725;GM0531;2012;   10818;    7338;    3475;    2768;     707;       5
6409;A028725;GM0531;2013;   10944;    7454;    3490;    2765;     725;       0
6410;A028725;GM0531;2014;   11129;    7579;    3549;    2771;     778;       1
6411;A028725;GM0531;2015;   11272;    7762;    3509;    2761;     748;       1
6412;A028725;GM0531;2016;   11373;    7887;    3485;    2740;     745;       1
6413;A028725;GM0531;2017;   11487;    8000;    3485;    2751;     734;       2
6414;A028725;GM0531;2018;   11842;    8351;    3489;    2779;     710;       2
6415;A028725;GM0531;2019;   11954;    8529;    3416;    2795;     621;       9
6416;A028725;GM0531;2020;   12038;    8622;    3407;    2788;     619;       9
6417;A028725;GM0164;2012;   35251;   19647;   15584;   12405;    3179;      20
6418;A028725;GM0164;2013;   35512;   19823;   15672;   12378;    3294;      17
6419;A028725;GM0164;2014;   35836;   19906;   15909;   12408;    3501;      21
6420;A028725;GM0164;2015;   36064;   20057;   15950;   12373;    3577;      57
6421;A028725;GM0164;2016;   36145;   20205;   15824;   12077;    3747;     116
6422;A028725;GM0164;2017;   36277;   20247;   15903;   12019;    3884;     127
6423;A028725;GM0164;2018;   36487;   20797;   15538;   11940;    3598;     152
6424;A028725;GM0164;2019;   36864;   21172;   15677;   11783;    3894;      15
6425;A028725;GM0164;2020;   37248;   21338;   15833;   11794;    4039;      77
6426;A028725;GM0796;2012;   60816;   31534;   29201;   22833;    6368;      81
6427;A028725;GM0796;2013;   62031;   32176;   29753;   23655;    6098;     102
6428;A028725;GM0796;2014;   62933;   32592;   30189;   23304;    6885;     152
6429;A028725;GM0796;2015;   66219;   34787;   31057;   23915;    7142;     375
6430;A028725;GM0796;2016;   66978;   35222;   31314;   23729;    7585;     442
6431;A028725;GM0796;2017;   67492;   35597;   31485;   23409;    8076;     410
6432;A028725;GM0796;2018;   68529;   35951;   32086;   23657;    8429;     492
6433;A028725;GM0796;2019;   69369;   36800;   32390;   23829;    8561;     179
6434;A028725;GM0796;2020;   70360;   37278;   32866;   23883;    8983;     216
6435;A028725;GM0252;2012;    6481;    4693;    1788;    1234;     554;       0
6436;A028725;GM0252;2013;    6537;    4733;    1800;    1246;     554;       4
6437;A028725;GM0252;2014;    6572;    4746;    1825;    1246;     579;       1
6438;A028725;GM0252;2015;    6759;    4793;    1880;    1293;     587;      86
6439;A028725;GM0252;2016;    6824;    4802;    1924;    1303;     621;      98
6440;A028725;GM0252;2017;    6911;    4824;    1985;    1309;     676;     102
6441;A028725;GM0252;2018;    6945;    4944;    1903;    1328;     575;      98
6442;A028725;GM0252;2019;    7004;    5012;    1872;    1335;     537;     120
6443;A028725;GM0252;2020;    7024;    5013;    1888;    1331;     557;     123
6444;A028725;GM0797;2012;   17084;   11602;    5456;    4590;     866;      26
6445;A028725;GM0797;2013;   17260;   11655;    5571;    4668;     903;      34
6446;A028725;GM0797;2014;   17475;   11676;    5627;    4690;     937;     172
6447;A028725;GM0797;2015;   17580;   11698;    5764;    4777;     987;     118
6448;A028725;GM0797;2016;   17695;   11818;    5722;    4731;     991;     155
6449;A028725;GM0797;2017;   17779;   11884;    5732;    4726;    1006;     163
6450;A028725;GM0797;2018;   17938;   12068;    5687;    4718;     969;     183
6451;A028725;GM0797;2019;   18201;   12369;    5819;    4781;    1038;      13
6452;A028725;GM0797;2020;   18573;   12609;    5957;    4902;    1055;       7
6453;A028725;GM0534;2012;    8596;    5604;    2987;    2101;     886;       5
6454;A028725;GM0534;2013;    8747;    5631;    3113;    2195;     918;       3
6455;A028725;GM0534;2014;    8916;    5701;    3143;    2189;     954;      72
6456;A028725;GM0534;2015;    9017;    5738;    3272;    2206;    1066;       7
6457;A028725;GM0534;2016;    9055;    5801;    3245;    2359;     886;       9
6458;A028725;GM0534;2017;    9146;    5855;    3285;    2363;     922;       6
6459;A028725;GM0534;2018;    9419;    6140;    3270;    2417;     853;       9
6460;A028725;GM0534;2019;    9480;    6347;    3128;    2426;     702;       5
6461;A028725;GM0534;2020;    9593;    6429;    3159;    2420;     739;       5
6462;A028725;GM0798;2012;    5753;    4424;    1280;     869;     411;      49
6463;A028725;GM0798;2013;    5812;    4520;    1287;     822;     465;       5
6464;A028725;GM0798;2014;    5895;    4541;    1351;     870;     481;       3
6465;A028725;GM0798;2015;    5944;    4560;    1381;     875;     506;       3
6466;A028725;GM0798;2016;    6121;    4592;    1436;     879;     557;      93
6467;A028725;GM0798;2017;    6230;    4617;    1518;     914;     604;      95
6468;A028725;GM0798;2018;    6252;    4778;    1369;     906;     463;     105
6469;A028725;GM0798;2019;    6302;    4825;    1471;     898;     573;       6
6470;A028725;GM0798;2020;    6446;    4918;    1521;     905;     616;       7
6471;A028725;GM0402;2012;   36945;   20210;   16690;   12181;    4509;      45
6472;A028725;GM0402;2013;   37396;   20500;   16858;   12330;    4528;      38
6473;A028725;GM0402;2014;   38429;   20640;   17208;   12191;    5017;     581
6474;A028725;GM0402;2015;   38698;   20780;   17397;   12159;    5238;     521
6475;A028725;GM0402;2016;   39108;   20997;   17703;   12239;    5464;     408
6476;A028725;GM0402;2017;   39591;   21445;   17740;   12065;    5675;     406
6477;A028725;GM0402;2018;   40033;   21596;   18095;   12038;    6057;     342
6478;A028725;GM0402;2019;   40315;   22270;   17983;   12209;    5774;      62
6479;A028725;GM0402;2020;   40705;   22329;   18310;   12398;    5912;      66
6480;A028725;GM1963;2012;;;;;;
6481;A028725;GM1963;2013;;;;;;
6482;A028725;GM1963;2014;;;;;;
6483;A028725;GM1963;2015;;;;;;
6484;A028725;GM1963;2016;;;;;;
6485;A028725;GM1963;2017;;;;;;
6486;A028725;GM1963;2018;;;;;;
6487;A028725;GM1963;2019;   36237;   25552;   10646;    9251;    1395;      39
6488;A028725;GM1963;2020;   36721;   25950;   10732;    9219;    1513;      39
6489;A028725;GM1735;2012;   13800;    9142;    4529;    3109;    1420;     129
6490;A028725;GM1735;2013;   13918;    9242;    4551;    3086;    1465;     125
6491;A028725;GM1735;2014;   13986;    9316;    4542;    3010;    1532;     128
6492;A028725;GM1735;2015;   14177;    9472;    4565;    2938;    1627;     140
6493;A028725;GM1735;2016;   14264;    9532;    4601;    2945;    1656;     131
6494;A028725;GM1735;2017;   14405;    9589;    4681;    3003;    1678;     135
6495;A028725;GM1735;2018;   14480;    9900;    4439;    2997;    1442;     141
6496;A028725;GM1735;2019;   14538;    9936;    4587;    2993;    1594;      15
6497;A028725;GM1735;2020;   14643;   10021;    4606;    2991;    1615;      16
6498;A028725;GM1966;2012;;;;;;
6499;A028725;GM1966;2013;;;;;;
6500;A028725;GM1966;2014;;;;;;
6501;A028725;GM1966;2015;;;;;;
6502;A028725;GM1966;2016;;;;;;
6503;A028725;GM1966;2017;;;;;;
6504;A028725;GM1966;2018;;;;;;
6505;A028725;GM1966;2019;   21225;   14454;    6727;    5340;    1387;      44
6506;A028725;GM1966;2020;   21371;   14520;    6819;    5322;    1497;      32
6507;A028725;GM1911;2012;   19189;   13203;    5976;    4899;    1077;      10
6508;A028725;GM1911;2013;   19284;   13263;    6016;    4893;    1123;       5
6509;A028725;GM1911;2014;   19535;   13339;    6073;    4868;    1205;     123
6510;A028725;GM1911;2015;   19654;   13451;    6076;    4817;    1259;     127
6511;A028725;GM1911;2016;   19691;   13484;    6096;    4741;    1355;     111
6512;A028725;GM1911;2017;   19743;   13571;    6081;    4722;    1359;      91
6513;A028725;GM1911;2018;   19814;   13838;    5898;    4644;    1254;      78
6514;A028725;GM1911;2019;   19894;   14049;    5761;    4655;    1106;      84
6515;A028725;GM1911;2020;   19971;   14132;    5762;    4628;    1134;      77
6516;A028725;GM0118;2012;   22487;   14207;    8276;    7181;    1095;       4
6517;A028725;GM0118;2013;   22577;   14300;    8260;    7078;    1182;      17
6518;A028725;GM0118;2014;   23160;   14534;    8533;    7180;    1353;      93
6519;A028725;GM0118;2015;   23318;   14595;    8629;    6927;    1702;      94
6520;A028725;GM0118;2016;   23479;   14678;    8686;    6973;    1713;     115
6521;A028725;GM0118;2017;   23684;   14696;    8891;    6965;    1926;      97
6522;A028725;GM0118;2018;   23877;   14867;    8908;    7083;    1825;     102
6523;A028725;GM0118;2019;   24090;   15118;    8913;    7248;    1665;      59
6524;A028725;GM0118;2020;   24166;   15174;    8846;    6880;    1966;     146
6525;A028725;GM0018;2012;   15172;    8698;    6452;    5374;    1078;      22
6526;A028725;GM0018;2013;   15217;    8707;    6489;    5365;    1124;      21
6527;A028725;GM0018;2014;   15220;    8688;    6512;    5033;    1479;      20
6528;A028725;GM0018;2015;   15352;    8646;    6643;    5092;    1551;      63
6529;A028725;GM0018;2016;   15458;    8692;    6666;    5330;    1336;     100
6530;A028725;GM0018;2017;   15523;    8729;    6718;    5384;    1334;      76
6531;A028725;GM0018;2018;;;;;;
6532;A028725;GM0018;2019;;;;;;
6533;A028725;GM0018;2020;;;;;;
6534;A028725;GM0405;2012;   30112;   17960;   12127;   10287;    1840;      25
6535;A028725;GM0405;2013;   30438;   18165;   12218;   10267;    1951;      55
6536;A028725;GM0405;2014;   31008;   18296;   12623;    9942;    2681;      89
6537;A028725;GM0405;2015;   31266;   18478;   12704;    9894;    2810;      84
6538;A028725;GM0405;2016;   31459;   18777;   12636;    9766;    2870;      46
6539;A028725;GM0405;2017;   31747;   18914;   12773;    9895;    2878;      60
6540;A028725;GM0405;2018;   31890;   19317;   12500;    9753;    2747;      73
6541;A028725;GM0405;2019;   32005;   19692;   12292;    9701;    2591;      21
6542;A028725;GM0405;2020;   32189;   19752;   12412;    9715;    2697;      25
6543;A028725;GM1507;2012;   15934;   12457;    3466;    2575;     891;      11
6544;A028725;GM1507;2013;   16143;   12608;    3525;    2594;     931;      10
6545;A028725;GM1507;2014;   16432;   12644;    3670;    2643;    1027;     118
6546;A028725;GM1507;2015;   16565;   12747;    3739;    2687;    1052;      79
6547;A028725;GM1507;2016;   16739;   12870;    3812;    2730;    1082;      57
6548;A028725;GM1507;2017;   16950;   12956;    3933;    2723;    1210;      61
6549;A028725;GM1507;2018;   17092;   13037;    3986;    2499;    1487;      69
6550;A028725;GM1507;2019;   17184;   13142;    3978;    2688;    1290;      64
6551;A028725;GM1507;2020;   17311;   13233;    4029;    2694;    1335;      49
6552;A028725;GM0321;2012;   18416;   12368;    5958;    5072;     886;      90
6553;A028725;GM0321;2013;   18635;   12474;    6160;    5090;    1070;       1
6554;A028725;GM0321;2014;   18777;   12601;    6176;    4772;    1404;       0
6555;A028725;GM0321;2015;   18991;   12796;    6190;    4986;    1204;       5
6556;A028725;GM0321;2016;   19125;   12892;    6196;    4797;    1399;      37
6557;A028725;GM0321;2017;   19363;   12982;    6366;    4825;    1541;      15
6558;A028725;GM0321;2018;   19538;   12970;    6531;    4896;    1635;      37
6559;A028725;GM0321;2019;   19854;   13565;    6282;    4991;    1291;       7
6560;A028725;GM0321;2020;   19973;   13642;    6322;    4988;    1334;       9
6561;A028725;GM0406;2012;   17624;   10002;    7619;    6147;    1472;       3
6562;A028725;GM0406;2013;   17706;   10151;    7554;    6040;    1514;       1
6563;A028725;GM0406;2014;   17734;   10278;    7445;    5964;    1481;      11
6564;A028725;GM0406;2015;   17900;   10373;    7516;    5990;    1526;      11
6565;A028725;GM0406;2016;   18053;   10496;    7490;    5947;    1543;      67
6566;A028725;GM0406;2017;   18234;   10464;    7708;    5986;    1722;      62
6567;A028725;GM0406;2018;   18259;   10643;    7564;    5985;    1579;      52
6568;A028725;GM0406;2019;   18326;   10810;    7471;    6026;    1445;      45
6569;A028725;GM0406;2020;   18406;   10804;    7543;    6058;    1485;      59
6570;A028725;GM0677;2012;   11648;    8443;    3179;    2405;     774;      26
6571;A028725;GM0677;2013;   12040;    8831;    3206;    2404;     802;       3
6572;A028725;GM0677;2014;   12109;    8757;    3349;    2392;     957;       3
6573;A028725;GM0677;2015;   12237;    8885;    3280;    2418;     862;      72
6574;A028725;GM0677;2016;   12280;    8933;    3289;    2430;     859;      58
6575;A028725;GM0677;2017;   12326;    8971;    3300;    2424;     876;      55
6576;A028725;GM0677;2018;   12425;    9208;    3164;    2438;     726;      53
6577;A028725;GM0677;2019;   12494;    9305;    3051;    2430;     621;     138
6578;A028725;GM0677;2020;   12576;    9343;    3085;    2428;     657;     148
6579;A028725;GM0353;2012;   13409;    8533;    4870;    3440;    1430;       6
6580;A028725;GM0353;2013;   13481;    8573;    4902;    3478;    1424;       6
6581;A028725;GM0353;2014;   13587;    8625;    4938;    3442;    1496;      24
6582;A028725;GM0353;2015;   13670;    8713;    4871;    3401;    1470;      86
6583;A028725;GM0353;2016;   13867;    8883;    4891;    3454;    1437;      93
6584;A028725;GM0353;2017;   13964;    8826;    5054;    3503;    1551;      84
6585;A028725;GM0353;2018;   14089;    8818;    5181;    3505;    1676;      90
6586;A028725;GM0353;2019;   14103;    9129;    4970;    3470;    1500;       4
6587;A028725;GM0353;2020;   14116;    9124;    4988;    3465;    1523;       4
6588;A028725;GM1884;2012;   10004;    6437;    3552;    2995;     557;      15
6589;A028725;GM1884;2013;   10096;    6502;    3586;    2960;     626;       8
6590;A028725;GM1884;2014;   10227;    6521;    3611;    2948;     663;      95
6591;A028725;GM1884;2015;   10308;    6575;    3638;    2960;     678;      95
6592;A028725;GM1884;2016;   10583;    6729;    3749;    3035;     714;     105
6593;A028725;GM1884;2017;   10725;    6842;    3783;    3030;     753;     100
6594;A028725;GM1884;2018;   10871;    7044;    3717;    3018;     699;     110
6595;A028725;GM1884;2019;   11013;    7256;    3730;    3093;     637;      27
6596;A028725;GM1884;2020;   11292;    7432;    3831;    3147;     684;      29
6597;A028725;GM0166;2012;   19340;   12079;    7179;    5256;    1923;      82
6598;A028725;GM0166;2013;   19715;   12314;    7326;    5324;    2002;      75
6599;A028725;GM0166;2014;   19923;   12499;    7358;    5277;    2081;      66
6600;A028725;GM0166;2015;   20114;   12623;    7418;    5350;    2068;      73
6601;A028725;GM0166;2016;   20435;   12764;    7605;    5429;    2176;      66
6602;A028725;GM0166;2017;   20676;   12950;    7669;    5416;    2253;      57
6603;A028725;GM0166;2018;   20950;   13329;    7550;    5527;    2023;      71
6604;A028725;GM0166;2019;   21222;   13597;    7602;    5585;    2017;      23
6605;A028725;GM0166;2020;   21635;   13859;    7752;    5622;    2130;      24
6606;A028725;GM0678;2012;    4813;    3653;    1158;     749;     409;       2
6607;A028725;GM0678;2013;    4857;    3706;    1149;     762;     387;       2
6608;A028725;GM0678;2014;    4940;    3734;    1170;     753;     417;      36
6609;A028725;GM0678;2015;    4979;    3779;    1165;     759;     406;      35
6610;A028725;GM0678;2016;    5028;    3812;    1185;     770;     415;      31
6611;A028725;GM0678;2017;    5031;    3779;    1224;     765;     459;      28
6612;A028725;GM0678;2018;    5098;    3866;    1198;     776;     422;      34
6613;A028725;GM0678;2019;    5142;    3938;    1196;     780;     416;       8
6614;A028725;GM0678;2020;    5162;    3952;    1195;     767;     428;      15
6615;A028725;GM0537;2012;   23360;   15097;    8210;    7233;     977;      53
6616;A028725;GM0537;2013;   23689;   15061;    8592;    7249;    1343;      36
6617;A028725;GM0537;2014;   24148;   15253;    8810;    7228;    1582;      85
6618;A028725;GM0537;2015;   24622;   15747;    8790;    7336;    1454;      85
6619;A028725;GM0537;2016;   24920;   16080;    8727;    7253;    1474;     113
6620;A028725;GM0537;2017;   25245;   16370;    8727;    7203;    1524;     148
6621;A028725;GM0537;2018;   25577;   16581;    8845;    7219;    1626;     151
6622;A028725;GM0537;2019;   25796;   16873;    8896;    7304;    1592;      27
6623;A028725;GM0537;2020;   25984;   17023;    8948;    7308;    1640;      13
6624;A028725;GM0928;2012;   19752;   11554;    8185;    5884;    2301;      13
6625;A028725;GM0928;2013;   19925;   11461;    8455;    5972;    2483;       9
6626;A028725;GM0928;2014;   20992;   11592;    9082;    6419;    2663;     318
6627;A028725;GM0928;2015;   22388;   11615;   10460;    7400;    3060;     313
6628;A028725;GM0928;2016;   22223;   11612;   10333;    7245;    3088;     278
6629;A028725;GM0928;2017;   22240;   11640;   10335;    7204;    3131;     265
6630;A028725;GM0928;2018;   22370;   11918;   10165;    7256;    2909;     287
6631;A028725;GM0928;2019;   22440;   12108;   10139;    7269;    2870;     193
6632;A028725;GM0928;2020;   22601;   12125;   10334;    7407;    2927;     142
6633;A028725;GM1598;2012;    8562;    6693;    1843;     618;    1225;      26
6634;A028725;GM1598;2013;    8670;    6767;    1879;     621;    1258;      24
6635;A028725;GM1598;2014;    8780;    6824;    1927;     650;    1277;      29
6636;A028725;GM1598;2015;    8833;    6846;    1963;     667;    1296;      24
6637;A028725;GM1598;2016;    8916;    6874;    1991;     639;    1352;      51
6638;A028725;GM1598;2017;    8935;    6841;    2034;     628;    1406;      60
6639;A028725;GM1598;2018;    9016;    6876;    2063;     639;    1424;      77
6640;A028725;GM1598;2019;    9111;    7185;    1924;     651;    1273;       2
6641;A028725;GM1598;2020;    9169;    7241;    1925;     513;    1412;       3
6642;A028725;GM0079;2012;    5202;    3591;    1608;    1215;     393;       3
6643;A028725;GM0079;2013;    5187;    3601;    1585;    1190;     395;       1
6644;A028725;GM0079;2014;    5226;    3585;    1639;    1205;     434;       2
6645;A028725;GM0079;2015;    5216;    3589;    1624;    1183;     441;       3
6646;A028725;GM0079;2016;    5256;    3619;    1633;    1278;     355;       4
6647;A028725;GM0079;2017;    5295;    3596;    1668;    1278;     390;      31
6648;A028725;GM0079;2018;    5308;    3710;    1564;    1276;     288;      34
6649;A028725;GM0079;2019;;;;;;
6650;A028725;GM0079;2020;;;;;;
6651;A028725;GM0588;2012;    4175;    3071;    1100;     938;     162;       4
6652;A028725;GM0588;2013;    4193;    3075;    1116;     948;     168;       2
6653;A028725;GM0588;2014;    4204;    3088;    1115;     946;     169;       1
6654;A028725;GM0588;2015;    4226;    3114;    1111;     937;     174;       1
6655;A028725;GM0588;2016;    4291;    3172;    1118;     928;     190;       1
6656;A028725;GM0588;2017;    4369;    3205;    1164;     927;     237;       0
6657;A028725;GM0588;2018;    4440;    3271;    1169;     938;     231;       0
6658;A028725;GM0588;2019;;;;;;
6659;A028725;GM0588;2020;;;;;;
6660;A028725;GM0542;2012;   11623;    6838;    4780;    4366;     414;       5
6661;A028725;GM0542;2013;   11787;    6945;    4837;    4423;     414;       5
6662;A028725;GM0542;2014;   11867;    6980;    4791;    4350;     441;      96
6663;A028725;GM0542;2015;   11964;    7023;    4851;    4404;     447;      90
6664;A028725;GM0542;2016;   12044;    7100;    4867;    4419;     448;      77
6665;A028725;GM0542;2017;   12044;    7131;    4844;    4407;     437;      69
6666;A028725;GM0542;2018;   12142;    7180;    4890;    4477;     413;      72
6667;A028725;GM0542;2019;   12228;    7282;    4943;    4430;     513;       3
6668;A028725;GM0542;2020;   12294;    7333;    4958;    4436;     522;       3
6669;A028725;GM1931;2012;;;;;;
6670;A028725;GM1931;2013;;;;;;
6671;A028725;GM1931;2014;;;;;;
6672;A028725;GM1931;2015;   21935;   14021;    7895;    6323;    1572;      19
6673;A028725;GM1931;2016;   22231;   14257;    7948;    6399;    1549;      26
6674;A028725;GM1931;2017;   22444;   14503;    7912;    6348;    1564;      29
6675;A028725;GM1931;2018;   22649;   14901;    7712;    6268;    1444;      36
6676;A028725;GM1931;2019;   22836;   15149;    7675;    6217;    1458;      12
6677;A028725;GM1931;2020;   23005;   15280;    7709;    6228;    1481;      16
6678;A028725;GM1659;2012;    8423;    5831;    2558;    2010;     548;      34
6679;A028725;GM1659;2013;    8724;    5906;    2811;    2209;     602;       7
6680;A028725;GM1659;2014;    8790;    5913;    2870;    2216;     654;       7
6681;A028725;GM1659;2015;    8912;    6015;    2871;    2217;     654;      26
6682;A028725;GM1659;2016;    8928;    6058;    2845;    2174;     671;      25
6683;A028725;GM1659;2017;    8935;    6052;    2858;    2186;     672;      25
6684;A028725;GM1659;2018;    9014;    6263;    2723;    2223;     500;      28
6685;A028725;GM1659;2019;    9143;    6405;    2734;    2218;     516;       4
6686;A028725;GM1659;2020;    9212;    6440;    2768;    2228;     540;       4
6687;A028725;GM1685;2012;    5386;    3969;    1409;    1097;     312;       8
6688;A028725;GM1685;2013;    5551;    4097;    1448;    1100;     348;       6
6689;A028725;GM1685;2014;    5661;    4115;    1459;    1101;     358;      87
6690;A028725;GM1685;2015;    5757;    4217;    1451;    1096;     355;      89
6691;A028725;GM1685;2016;    5781;    4234;    1481;    1119;     362;      66
6692;A028725;GM1685;2017;    5861;    4296;    1502;    1126;     376;      63
6693;A028725;GM1685;2018;    5924;    4381;    1469;    1111;     358;      74
6694;A028725;GM1685;2019;    6018;    4449;    1568;    1162;     406;       1
6695;A028725;GM1685;2020;    6177;    4587;    1589;    1156;     433;       1
6696;A028725;GM0882;2012;   16951;   10701;    6209;    4846;    1363;      41
6697;A028725;GM0882;2013;   17011;   10687;    6304;    4773;    1531;      20
6698;A028725;GM0882;2014;   17093;   10738;    6250;    4767;    1483;     105
6699;A028725;GM0882;2015;   17194;   10707;    6382;    4809;    1573;     105
6700;A028725;GM0882;2016;   17236;   10727;    6386;    4760;    1626;     123
6701;A028725;GM0882;2017;   17323;   10697;    6517;    4818;    1699;     109
6702;A028725;GM0882;2018;   17444;   10925;    6410;    4876;    1534;     109
6703;A028725;GM0882;2019;   17500;   11072;    6378;    4979;    1399;      50
6704;A028725;GM0882;2020;   17532;   11052;    6390;    4990;    1400;      90
6705;A028725;GM0415;2012;    4225;    2808;    1414;    1174;     240;       3
6706;A028725;GM0415;2013;    4267;    2820;    1445;    1172;     273;       2
6707;A028725;GM0415;2014;    4312;    2840;    1470;    1173;     297;       2
6708;A028725;GM0415;2015;    4482;    2883;    1592;    1245;     347;       7
6709;A028725;GM0415;2016;    4509;    2899;    1605;    1244;     361;       5
6710;A028725;GM0415;2017;    4587;    2953;    1629;    1267;     362;       5
6711;A028725;GM0415;2018;    4665;    3099;    1558;    1266;     292;       8
6712;A028725;GM0415;2019;    4651;    3115;    1529;    1234;     295;       7
6713;A028725;GM0415;2020;    4674;    3124;    1543;    1226;     317;       7
6714;A028725;GM0416;2012;   10400;    7869;    2525;    1771;     754;       6
6715;A028725;GM0416;2013;   10427;    7920;    2504;    1739;     765;       3
6716;A028725;GM0416;2014;   10631;    7941;    2645;    2044;     601;      45
6717;A028725;GM0416;2015;   10801;    7941;    2817;    2107;     710;      43
6718;A028725;GM0416;2016;   10969;    8003;    2902;    2137;     765;      64
6719;A028725;GM0416;2017;   11035;    8042;    2931;    2126;     805;      62
6720;A028725;GM0416;2018;   11146;    8251;    2874;    2144;     730;      21
6721;A028725;GM0416;2019;   11280;    8444;    2832;    2234;     598;       4
6722;A028725;GM0416;2020;   11347;    8480;    2863;    2258;     605;       4
6723;A028725;GM1621;2012;   20397;   14964;    5368;    4189;    1179;      65
6724;A028725;GM1621;2013;   21114;   15356;    5710;    4318;    1392;      48
6725;A028725;GM1621;2014;   21393;   15473;    5846;    4348;    1498;      74
6726;A028725;GM1621;2015;   21780;   15723;    5973;    4352;    1621;      84
6727;A028725;GM1621;2016;   22221;   16071;    6062;    4406;    1656;      88
6728;A028725;GM1621;2017;   22584;   16319;    6175;    4440;    1735;      90
6729;A028725;GM1621;2018;   22956;   16761;    6106;    4425;    1681;      89
6730;A028725;GM1621;2019;   23129;   17097;    6019;    4484;    1535;      13
6731;A028725;GM1621;2020;   23444;   17312;    6084;    4458;    1626;      48
6732;A028725;GM0417;2012;    4567;    3209;    1358;     849;     509;       0
6733;A028725;GM0417;2013;    4659;    3201;    1446;     881;     565;      12
6734;A028725;GM0417;2014;    4693;    3176;    1493;     875;     618;      24
6735;A028725;GM0417;2015;    4722;    3183;    1514;     877;     637;      25
6736;A028725;GM0417;2016;    4745;    3226;    1504;     883;     621;      15
6737;A028725;GM0417;2017;    4784;    3238;    1516;     864;     652;      30
6738;A028725;GM0417;2018;    4848;    3358;    1409;     881;     528;      81
6739;A028725;GM0417;2019;    4856;    3393;    1434;     797;     637;      29
6740;A028725;GM0417;2020;    4905;    3383;    1491;     893;     598;      31
6741;A028725;GM0022;2012;    7808;    5162;    2594;    1886;     708;      52
6742;A028725;GM0022;2013;    8093;    5224;    2861;    2022;     839;       8
6743;A028725;GM0022;2014;    8167;    5239;    2920;    2099;     821;       8
6744;A028725;GM0022;2015;    8205;    5300;    2897;    2145;     752;       8
6745;A028725;GM0022;2016;    8297;    5288;    3001;    2094;     907;       8
6746;A028725;GM0022;2017;    8394;    5404;    2982;    2115;     867;       8
6747;A028725;GM0022;2018;    8441;    5516;    2906;    2106;     800;      19
6748;A028725;GM0022;2019;;;;;;
6749;A028725;GM0022;2020;;;;;;
6750;A028725;GM0545;2012;    8069;    4227;    3824;    3366;     458;      18
6751;A028725;GM0545;2013;    8218;    4258;    3944;    3444;     500;      16
6752;A028725;GM0545;2014;    8240;    4311;    3883;    3336;     547;      46
6753;A028725;GM0545;2015;    8254;    4361;    3856;    3300;     556;      37
6754;A028725;GM0545;2016;    8362;    4439;    3877;    3212;     665;      46
6755;A028725;GM0545;2017;    8460;    4509;    3911;    3230;     681;      40
6756;A028725;GM0545;2018;    8536;    4640;    3853;    3171;     682;      43
6757;A028725;GM0545;2019;;;;;;
6758;A028725;GM0545;2020;;;;;;
6759;A028725;GM0080;2012;   44392;   22389;   21763;   15020;    6743;     240
6760;A028725;GM0080;2013;   45385;   22601;   22599;   15227;    7372;     185
6761;A028725;GM0080;2014;   50395;   25651;   24549;   16666;    7883;     195
6762;A028725;GM0080;2015;   50877;   25584;   25089;   16951;    8138;     204
6763;A028725;GM0080;2016;   51274;   25574;   25473;   16808;    8665;     227
6764;A028725;GM0080;2017;   51845;   25846;   25788;   16684;    9104;     211
6765;A028725;GM0080;2018;   58204;   30180;   27677;   17682;    9995;     347
6766;A028725;GM0080;2019;   58930;   31086;   27553;   17760;    9793;     291
6767;A028725;GM0080;2020;   59863;   31206;   28402;   17561;   10841;     255
6768;A028725;GM0081;2012;    4135;    3116;    1016;     836;     180;       3
6769;A028725;GM0081;2013;    4153;    3119;    1032;     830;     202;       2
6770;A028725;GM0081;2014;    4214;    3133;    1047;     825;     222;      34
6771;A028725;GM0081;2015;    4237;    3142;    1057;     826;     231;      38
6772;A028725;GM0081;2016;    4252;    3149;    1063;     808;     255;      40
6773;A028725;GM0081;2017;    4244;    3165;    1043;     795;     248;      36
6774;A028725;GM0081;2018;;;;;;
6775;A028725;GM0081;2019;;;;;;
6776;A028725;GM0081;2020;;;;;;
6777;A028725;GM0546;2012;   50783;   23286;   27076;   18407;    8669;     421
6778;A028725;GM0546;2013;   51671;   23625;   27807;   18899;    8908;     239
6779;A028725;GM0546;2014;   52410;   23869;   28321;   19209;    9112;     220
6780;A028725;GM0546;2015;   52685;   24369;   28117;   19274;    8843;     199
6781;A028725;GM0546;2016;   53791;   24629;   28918;   19039;    9879;     244
6782;A028725;GM0546;2017;   55050;   24871;   29883;   19311;   10572;     296
6783;A028725;GM0546;2018;   55829;   24673;   30824;   19155;   11669;     332
6784;A028725;GM0546;2019;   56604;   25011;   31475;   19427;   12048;     118
6785;A028725;GM0546;2020;   57156;   24920;   32105;   19271;   12834;     131
6786;A028725;GM0547;2012;   11382;    7091;    4283;    2967;    1316;       8
6787;A028725;GM0547;2013;   11436;    7197;    4233;    3034;    1199;       6
6788;A028725;GM0547;2014;   11545;    7258;    4281;    2851;    1430;       6
6789;A028725;GM0547;2015;   11611;    7355;    4250;    3044;    1206;       6
6790;A028725;GM0547;2016;   11644;    7427;    4211;    3010;    1201;       6
6791;A028725;GM0547;2017;   11748;    7530;    4193;    3031;    1162;      25
6792;A028725;GM0547;2018;   11842;    7672;    4163;    3031;    1132;       7
6793;A028725;GM0547;2019;   11835;    7729;    4103;    2969;    1134;       3
6794;A028725;GM0547;2020;   11822;    7747;    4073;    2934;    1139;       2
6795;A028725;GM1916;2012;   33789;   19102;   14678;    9285;    5393;       9
6796;A028725;GM1916;2013;   33938;   19196;   14739;    9203;    5536;       3
6797;A028725;GM1916;2014;   34462;   19363;   14935;    9170;    5765;     164
6798;A028725;GM1916;2015;   34690;   19570;   14978;    9232;    5746;     142
6799;A028725;GM1916;2016;   34823;   19707;   14975;    9242;    5733;     141
6800;A028725;GM1916;2017;   34943;   19826;   14981;    9217;    5764;     136
6801;A028725;GM1916;2018;   35028;   19672;   15204;    9306;    5898;     152
6802;A028725;GM1916;2019;   35129;   20405;   14605;    9250;    5355;     119
6803;A028725;GM1916;2020;   35438;   20582;   14775;    9212;    5563;      81
6804;A028725;GM0995;2012;   30684;   19719;   10881;    8906;    1975;      84
6805;A028725;GM0995;2013;   30924;   19837;   10981;    8872;    2109;     106
6806;A028725;GM0995;2014;   31213;   19892;   11179;    8930;    2249;     142
6807;A028725;GM0995;2015;   31429;   19907;   11371;    9017;    2354;     151
6808;A028725;GM0995;2016;   31641;   20009;   11524;    9104;    2420;     108
6809;A028725;GM0995;2017;   31712;   20053;   11604;    9065;    2539;      55
6810;A028725;GM0995;2018;   31928;   19973;   11885;    9015;    2870;      70
6811;A028725;GM0995;2019;   32122;   20700;   11404;    9086;    2318;      18
6812;A028725;GM0995;2020;   32484;   20808;   11659;    9204;    2455;      17
6813;A028725;GM0082;2012;    5467;    3597;    1855;    1554;     301;      15
6814;A028725;GM0082;2013;    5590;    3692;    1888;    1554;     334;      10
6815;A028725;GM0082;2014;;;;;;
6816;A028725;GM0082;2015;;;;;;
6817;A028725;GM0082;2016;;;;;;
6818;A028725;GM0082;2017;;;;;;
6819;A028725;GM0082;2018;;;;;;
6820;A028725;GM0082;2019;;;;;;
6821;A028725;GM0082;2020;;;;;;
6822;A028725;GM1640;2012;   14560;   11815;    2717;    1838;     879;      28
6823;A028725;GM1640;2013;   14688;   11893;    2782;    1869;     913;      13
6824;A028725;GM1640;2014;   14729;   11902;    2815;    1861;     954;      12
6825;A028725;GM1640;2015;   14813;   11881;    2915;    1883;    1032;      17
6826;A028725;GM1640;2016;   15010;   11828;    2991;    1877;    1114;     191
6827;A028725;GM1640;2017;   15100;   11796;    3062;    1892;    1170;     242
6828;A028725;GM1640;2018;   15164;   11974;    2964;    1864;    1100;     226
6829;A028725;GM1640;2019;   15225;   11990;    3220;    1960;    1260;      15
6830;A028725;GM1640;2020;   15378;   12034;    3327;    1979;    1348;      17
6831;A028725;GM0327;2012;   11725;    8154;    3552;    2688;     864;      19
6832;A028725;GM0327;2013;   11924;    8292;    3632;    2728;     904;       0
6833;A028725;GM0327;2014;   12018;    8361;    3655;    2556;    1099;       2
6834;A028725;GM0327;2015;   12085;    8385;    3697;    2549;    1148;       3
6835;A028725;GM0327;2016;   12148;    8471;    3669;    2580;    1089;       8
6836;A028725;GM0327;2017;   12260;    8562;    3691;    2578;    1113;       7
6837;A028725;GM0327;2018;   12397;    8625;    3762;    2660;    1102;      10
6838;A028725;GM0327;2019;   12588;    8976;    3604;    2632;     972;       8
6839;A028725;GM0327;2020;   12745;    9055;    3683;    2658;    1025;       7
6840;A028725;GM0694;2012;    3599;    2249;    1343;    1192;     151;       7
6841;A028725;GM0694;2013;;;;;;
6842;A028725;GM0694;2014;;;;;;
6843;A028725;GM0694;2015;;;;;;
6844;A028725;GM0694;2016;;;;;;
6845;A028725;GM0694;2017;;;;;;
6846;A028725;GM0694;2018;;;;;;
6847;A028725;GM0694;2019;;;;;;
6848;A028725;GM0694;2020;;;;;;
6849;A028725;GM0733;2012;    4132;    2776;    1347;    1129;     218;       9
6850;A028725;GM0733;2013;    4222;    2804;    1406;    1175;     231;      12
6851;A028725;GM0733;2014;    4337;    2855;    1458;    1162;     296;      24
6852;A028725;GM0733;2015;    4333;    2873;    1431;    1147;     284;      29
6853;A028725;GM0733;2016;    4379;    2939;    1399;    1151;     248;      41
6854;A028725;GM0733;2017;    4404;    2954;    1426;    1148;     278;      24
6855;A028725;GM0733;2018;    4431;    3005;    1400;    1137;     263;      26
6856;A028725;GM0733;2019;;;;;;
6857;A028725;GM0733;2020;;;;;;
6858;A028725;GM1705;2012;   18066;   13170;    4895;    3749;    1146;       1
6859;A028725;GM1705;2013;   18267;   13296;    4970;    3738;    1232;       1
6860;A028725;GM1705;2014;   18366;   13331;    5031;    3679;    1352;       4
6861;A028725;GM1705;2015;   18710;   13422;    5131;    3711;    1420;     157
6862;A028725;GM1705;2016;   18866;   13557;    5146;    3754;    1392;     163
6863;A028725;GM1705;2017;   19091;   13579;    5342;    3836;    1506;     170
6864;A028725;GM1705;2018;   19209;   13837;    5207;    3853;    1354;     165
6865;A028725;GM1705;2019;   19307;   14038;    5197;    3841;    1356;      72
6866;A028725;GM1705;2020;   19368;   14050;    5253;    3826;    1427;      65
6867;A028725;GM0553;2012;    9347;    5907;    3439;    2817;     622;       1
6868;A028725;GM0553;2013;    9344;    5909;    3435;    2792;     643;       0
6869;A028725;GM0553;2014;    9433;    5907;    3526;    2761;     765;       0
6870;A028725;GM0553;2015;    9578;    6027;    3548;    2765;     783;       3
6871;A028725;GM0553;2016;    9715;    6092;    3622;    2783;     839;       1
6872;A028725;GM0553;2017;    9781;    6145;    3613;    2772;     841;      23
6873;A028725;GM0553;2018;    9794;    6238;    3532;    2757;     775;      24
6874;A028725;GM0553;2019;    9891;    6337;    3494;    2789;     705;      60
6875;A028725;GM0553;2020;    9994;    6406;    3529;    2798;     731;      59
6876;A028725;GM0140;2012;    4242;    3210;    1029;     856;     173;       3
6877;A028725;GM0140;2013;    4296;    3260;    1034;     862;     172;       2
6878;A028725;GM0140;2014;    4336;    3295;    1039;     851;     188;       2
6879;A028725;GM0140;2015;    4334;    3312;    1011;     830;     181;      11
6880;A028725;GM0140;2016;    4354;    3336;    1005;     814;     191;      13
6881;A028725;GM0140;2017;    4352;    3333;    1009;     799;     210;      10
6882;A028725;GM0140;2018;;;;;;
6883;A028725;GM0140;2019;;;;;;
6884;A028725;GM0140;2020;;;;;;
6885;A028725;GM0262;2012;   13421;    9273;    4129;    2699;    1430;      19
6886;A028725;GM0262;2013;   13549;    9363;    4174;    2713;    1461;      12
6887;A028725;GM0262;2014;   13679;    9447;    4211;    2742;    1469;      21
6888;A028725;GM0262;2015;   13823;    9559;    4230;    2811;    1419;      34
6889;A028725;GM0262;2016;   13926;    9654;    4219;    2811;    1408;      53
6890;A028725;GM0262;2017;   14164;    9812;    4295;    2852;    1443;      57
6891;A028725;GM0262;2018;   14280;   10033;    4171;    2843;    1328;      76
6892;A028725;GM0262;2019;   14351;   10160;    4178;    2773;    1405;      13
6893;A028725;GM0262;2020;   14407;   10231;    4163;    2778;    1385;      13
6894;A028725;GM0809;2012;    9411;    5971;    3339;    2367;     972;     101
6895;A028725;GM0809;2013;    9506;    6047;    3454;    2380;    1074;       5
6896;A028725;GM0809;2014;    9604;    6051;    3550;    2406;    1144;       3
6897;A028725;GM0809;2015;    9624;    6090;    3530;    2418;    1112;       4
6898;A028725;GM0809;2016;    9665;    6147;    3512;    2448;    1064;       6
6899;A028725;GM0809;2017;    9722;    6153;    3566;    2491;    1075;       3
6900;A028725;GM0809;2018;    9807;    6271;    3529;    2506;    1023;       7
6901;A028725;GM0809;2019;    9915;    6376;    3516;    2464;    1052;      23
6902;A028725;GM0809;2020;    9985;    6416;    3546;    2459;    1087;      23
6903;A028725;GM0331;2012;    5075;    3785;    1241;     959;     282;      49
6904;A028725;GM0331;2013;    5090;    3805;    1278;     956;     322;       7
6905;A028725;GM0331;2014;    5107;    3820;    1281;     949;     332;       6
6906;A028725;GM0331;2015;    5149;    3777;    1359;     954;     405;      13
6907;A028725;GM0331;2016;    5236;    3816;    1405;     947;     458;      15
6908;A028725;GM0331;2017;    5270;    3873;    1383;     935;     448;      14
6909;A028725;GM0331;2018;    5329;    3918;    1385;     933;     452;      26
6910;A028725;GM0331;2019;    5446;    4089;    1345;     967;     378;      12
6911;A028725;GM0331;2020;    5512;    4119;    1383;     983;     400;      10
6912;A028725;GM0024;2012;    4266;    2914;    1352;    1136;     216;       0
6913;A028725;GM0024;2013;    4309;    2923;    1386;    1163;     223;       0
6914;A028725;GM0024;2014;    4319;    2922;    1396;    1162;     234;       1
6915;A028725;GM0024;2015;    4350;    2913;    1436;    1197;     239;       1
6916;A028725;GM0024;2016;    4340;    2916;    1406;    1172;     234;      18
6917;A028725;GM0024;2017;    4330;    2888;    1423;    1187;     236;      19
6918;A028725;GM0024;2018;    4280;    2896;    1366;    1146;     220;      18
6919;A028725;GM0024;2019;    4283;    2922;    1346;    1158;     188;      15
6920;A028725;GM0024;2020;    4299;    2936;    1361;    1165;     196;       2
6921;A028725;GM0168;2012;    8898;    6169;    2624;    1945;     679;     105
6922;A028725;GM0168;2013;    8936;    6166;    2636;    1943;     693;     134
6923;A028725;GM0168;2014;    9010;    6143;    2759;    1934;     825;     108
6924;A028725;GM0168;2015;    9072;    6161;    2782;    1949;     833;     129
6925;A028725;GM0168;2016;    9179;    6217;    2834;    1921;     913;     128
6926;A028725;GM0168;2017;    9210;    6190;    2904;    1910;     994;     116
6927;A028725;GM0168;2018;    9310;    6385;    2806;    1926;     880;     119
6928;A028725;GM0168;2019;    9368;    6436;    2917;    1924;     993;      15
6929;A028725;GM0168;2020;    9404;    6521;    2869;    1899;     970;      14
6930;A028725;GM1671;2012;    4066;    3071;     946;     683;     263;      49
6931;A028725;GM1671;2013;    4123;    3085;     977;     667;     310;      61
6932;A028725;GM1671;2014;    4151;    3106;     980;     655;     325;      65
6933;A028725;GM1671;2015;;;;;;
6934;A028725;GM1671;2016;;;;;;
6935;A028725;GM1671;2017;;;;;;
6936;A028725;GM1671;2018;;;;;;
6937;A028725;GM1671;2019;;;;;;
6938;A028725;GM1671;2020;;;;;;
6939;A028725;GM0263;2012;    9030;    6213;    2792;    2178;     614;      25
6940;A028725;GM0263;2013;    9151;    6334;    2787;    2149;     638;      30
6941;A028725;GM0263;2014;    9201;    6366;    2804;    2128;     676;      31
6942;A028725;GM0263;2015;    9245;    6438;    2790;    2095;     695;      17
6943;A028725;GM0263;2016;    9307;    6605;    2691;    2084;     607;      11
6944;A028725;GM0263;2017;    9360;    6603;    2743;    2078;     665;      14
6945;A028725;GM0263;2018;    9466;    6696;    2752;    2076;     676;      18
6946;A028725;GM0263;2019;    9576;    6854;    2702;    2074;     628;      20
6947;A028725;GM0263;2020;    9738;    6941;    2780;    2088;     692;      17
6948;A028725;GM1641;2012;    9821;    7472;    2300;    1607;     693;      49
6949;A028725;GM1641;2013;    9858;    7453;    2363;    1601;     762;      42
6950;A028725;GM1641;2014;   10148;    7589;    2483;    1530;     953;      76
6951;A028725;GM1641;2015;   10188;    7607;    2511;    1557;     954;      70
6952;A028725;GM1641;2016;   10215;    7606;    2534;    1543;     991;      75
6953;A028725;GM1641;2017;   10209;    7585;    2552;    1548;    1004;      72
6954;A028725;GM1641;2018;   10227;    7744;    2419;    1548;     871;      64
6955;A028725;GM1641;2019;   10272;    7793;    2468;    1702;     766;      11
6956;A028725;GM1641;2020;   10438;    7874;    2552;    1736;     816;      12
6957;A028725;GM0556;2012;   13798;    6912;    6879;    6098;     781;       7
6958;A028725;GM0556;2013;   13926;    7017;    6902;    6053;     849;       7
6959;A028725;GM0556;2014;   14064;    7037;    6935;    6069;     866;      92
6960;A028725;GM0556;2015;   14237;    7118;    7006;    6121;     885;     113
6961;A028725;GM0556;2016;   14360;    7225;    7011;    6118;     893;     124
6962;A028725;GM0556;2017;   14398;    7305;    6950;    6063;     887;     143
6963;A028725;GM0556;2018;   14437;    7461;    6810;    6012;     798;     166
6964;A028725;GM0556;2019;   14529;    7663;    6859;    6021;     838;       7
6965;A028725;GM0556;2020;   14632;    7829;    6796;    5990;     806;       7
6966;A028725;GM0935;2012;   52942;   21801;   30641;   21022;    9619;     500
6967;A028725;GM0935;2013;   54646;   22097;   32139;   21610;   10529;     410
6968;A028725;GM0935;2014;   55497;   22367;   32647;   22012;   10635;     483
6969;A028725;GM0935;2015;   55732;   22428;   32663;   21913;   10750;     641
6970;A028725;GM0935;2016;   56041;   22534;   32887;   21802;   11085;     620
6971;A028725;GM0935;2017;   56195;   22666;   33050;   21683;   11367;     479
6972;A028725;GM0935;2018;   56773;   22720;   33456;   21184;   12272;     597
6973;A028725;GM0935;2019;   56874;   23182;   33229;   21263;   11966;     463
6974;A028725;GM0935;2020;   57177;   23288;   33371;   21117;   12254;     518
6975;A028725;GM1663;2012;    4570;    3108;    1452;    1146;     306;      10
6976;A028725;GM1663;2013;    4578;    3124;    1443;    1141;     302;      11
6977;A028725;GM1663;2014;    4585;    3108;    1418;    1106;     312;      59
6978;A028725;GM1663;2015;    4596;    3112;    1418;    1087;     331;      66
6979;A028725;GM1663;2016;    4606;    3128;    1426;    1089;     337;      52
6980;A028725;GM1663;2017;    4589;    3127;    1437;    1080;     357;      25
6981;A028725;GM1663;2018;    4602;    3165;    1396;    1089;     307;      41
6982;A028725;GM1663;2019;;;;;;
6983;A028725;GM1663;2020;;;;;;
6984;A028725;GM0025;2012;    3967;    2943;    1015;     815;     200;       9
6985;A028725;GM0025;2013;    4019;    2959;    1057;     825;     232;       3
6986;A028725;GM0025;2014;    4108;    2972;    1133;     830;     303;       3
6987;A028725;GM0025;2015;    4115;    2992;    1120;     823;     297;       3
6988;A028725;GM0025;2016;    4137;    3011;    1122;     816;     306;       4
6989;A028725;GM0025;2017;    4208;    3055;    1148;     813;     335;       5
6990;A028725;GM0025;2018;    4276;    3175;    1097;     794;     303;       4
6991;A028725;GM0025;2019;;;;;;
6992;A028725;GM0025;2020;;;;;;
6993;A028725;GM0420;2012;   16752;   11708;    5022;    4246;     776;      22
6994;A028725;GM0420;2013;   16923;   11794;    5108;    4251;     857;      21
6995;A028725;GM0420;2014;   17397;   11996;    5309;    4234;    1075;      92
6996;A028725;GM0420;2015;   17548;   12026;    5426;    4289;    1137;      96
6997;A028725;GM0420;2016;   17693;   12122;    5475;    4282;    1193;      96
6998;A028725;GM0420;2017;   17888;   12319;    5494;    4293;    1201;      75
6999;A028725;GM0420;2018;   18089;   12419;    5587;    4318;    1269;      83
7000;A028725;GM0420;2019;   18255;   12795;    5412;    4440;     972;      48
7001;A028725;GM0420;2020;   18422;   12895;    5477;    4417;    1060;      50
7002;A028725;GM0938;2012;    8018;    5718;    2297;    1546;     751;       3
7003;A028725;GM0938;2013;    8025;    5742;    2281;    1528;     753;       2
7004;A028725;GM0938;2014;    8086;    5728;    2356;    1559;     797;       2
7005;A028725;GM0938;2015;    8151;    5728;    2420;    1570;     850;       3
7006;A028725;GM0938;2016;    8202;    5747;    2450;    1602;     848;       5
7007;A028725;GM0938;2017;    8231;    5762;    2467;    1602;     865;       2
7008;A028725;GM0938;2018;    8271;    6041;    2223;    1594;     629;       7
7009;A028725;GM0938;2019;    8283;    6067;    2198;    1576;     622;      18
7010;A028725;GM0938;2020;    8302;    6073;    2213;    1580;     633;      16
7011;A028725;GM1948;2012;;;;;;
7012;A028725;GM1948;2013;;;;;;
7013;A028725;GM1948;2014;;;;;;
7014;A028725;GM1948;2015;;;;;;
7015;A028725;GM1948;2016;;;;;;
7016;A028725;GM1948;2017;   32160;   22650;    9380;    6765;    2615;     130
7017;A028725;GM1948;2018;   32391;   23220;    8907;    6865;    2042;     264
7018;A028725;GM1948;2019;   32973;   23224;    9736;    7043;    2693;      13
7019;A028725;GM1948;2020;   33341;   23463;    9874;    7079;    2795;       4
7020;A028725;GM1908;2012;    5426;    3897;    1524;    1114;     410;       5
7021;A028725;GM1908;2013;    5476;    3960;    1515;    1114;     401;       1
7022;A028725;GM1908;2014;    5635;    4094;    1540;    1102;     438;       1
7023;A028725;GM1908;2015;    5623;    4094;    1528;    1193;     335;       1
7024;A028725;GM1908;2016;    5641;    4122;    1518;    1129;     389;       1
7025;A028725;GM1908;2017;    5655;    4137;    1518;    1131;     387;       0
7026;A028725;GM1908;2018;;;;;;
7027;A028725;GM1908;2019;;;;;;
7028;A028725;GM1908;2020;;;;;;
7029;A028725;GM1987;2012;    5147;    3312;    1831;    1481;     350;       4
7030;A028725;GM1987;2013;    5165;    3331;    1833;    1482;     351;       1
7031;A028725;GM1987;2014;    5227;    3345;    1881;    1518;     363;       1
7032;A028725;GM1987;2015;    5216;    3354;    1861;    1489;     372;       1
7033;A028725;GM1987;2016;    5239;    3357;    1881;    1489;     392;       1
7034;A028725;GM1987;2017;    5249;    3388;    1860;    1480;     380;       1
7035;A028725;GM1987;2018;;;;;;
7036;A028725;GM1987;2019;;;;;;
7037;A028725;GM1987;2020;;;;;;
7038;A028725;GM0119;2012;   13555;    7918;    5632;    4247;    1385;       5
7039;A028725;GM0119;2013;   13985;    8191;    5783;    4291;    1492;      11
7040;A028725;GM0119;2014;   14382;    8258;    5891;    4303;    1588;     233
7041;A028725;GM0119;2015;   14400;    8323;    5871;    4275;    1596;     206
7042;A028725;GM0119;2016;   14479;    8390;    5872;    4643;    1229;     217
7043;A028725;GM0119;2017;   14686;    8588;    5850;    4666;    1184;     248
7044;A028725;GM0119;2018;   14940;    8669;    5988;    4675;    1313;     283
7045;A028725;GM0119;2019;   15059;    8864;    6192;    4737;    1455;       3
7046;A028725;GM0119;2020;   15225;    8950;    6274;    4773;    1501;       1
7047;A028725;GM0687;2012;   21313;   12735;    8407;    6435;    1972;     171
7048;A028725;GM0687;2013;   21505;   12859;    8610;    6459;    2151;      36
7049;A028725;GM0687;2014;   21922;   12918;    8786;    6571;    2215;     218
7050;A028725;GM0687;2015;   21839;   12988;    8685;    6534;    2151;     166
7051;A028725;GM0687;2016;   21881;   13060;    8702;    6543;    2159;     119
7052;A028725;GM0687;2017;   22087;   13120;    8793;    6533;    2260;     174
7053;A028725;GM0687;2018;   22220;   13395;    8679;    6502;    2177;     146
7054;A028725;GM0687;2019;   22446;   13801;    8612;    6479;    2133;      33
7055;A028725;GM0687;2020;   22593;   13932;    8621;    6401;    2220;      40
7056;A028725;GM0559;2012;    7243;    4331;    2869;    2513;     356;      43
7057;A028725;GM0559;2013;;;;;;
7058;A028725;GM0559;2014;;;;;;
7059;A028725;GM0559;2015;;;;;;
7060;A028725;GM0559;2016;;;;;;
7061;A028725;GM0559;2017;;;;;;
7062;A028725;GM0559;2018;;;;;;
7063;A028725;GM0559;2019;;;;;;
7064;A028725;GM0559;2020;;;;;;
7065;A028725;GM1842;2012;    6948;    4948;    1995;    1626;     369;       5
7066;A028725;GM1842;2013;    7006;    4998;    2005;    1628;     377;       3
7067;A028725;GM1842;2014;    7183;    5159;    2023;    1587;     436;       1
7068;A028725;GM1842;2015;    7333;    5277;    2056;    1583;     473;       0
7069;A028725;GM1842;2016;    7419;    5383;    2036;    1561;     475;       0
7070;A028725;GM1842;2017;    7495;    5436;    2059;    1568;     491;       0
7071;A028725;GM1842;2018;    7645;    5616;    2025;    1600;     425;       4
7072;A028725;GM1842;2019;    7699;    5690;    2004;    1621;     383;       5
7073;A028725;GM1842;2020;    7701;    5692;    2005;    1627;     378;       4
7074;A028725;GM1731;2012;   13343;    9145;    4180;    3305;     875;      18
7075;A028725;GM1731;2013;   13356;    9315;    4033;    3281;     752;       8
7076;A028725;GM1731;2014;   13356;    9342;    4006;    3234;     772;       8
7077;A028725;GM1731;2015;   13384;    9370;    4008;    3221;     787;       6
7078;A028725;GM1731;2016;   13423;    9405;    4010;    3215;     795;       8
7079;A028725;GM1731;2017;   13585;    9462;    4114;    3231;     883;       9
7080;A028725;GM1731;2018;   13738;    9547;    4170;    3229;     941;      21
7081;A028725;GM1731;2019;   13799;    9748;    3994;    3206;     788;      57
7082;A028725;GM1731;2020;   13834;    9741;    4078;    3219;     859;      15
7083;A028725;GM1952;2012;;;;;;
7084;A028725;GM1952;2013;;;;;;
7085;A028725;GM1952;2014;;;;;;
7086;A028725;GM1952;2015;;;;;;
7087;A028725;GM1952;2016;;;;;;
7088;A028725;GM1952;2017;;;;;;
7089;A028725;GM1952;2018;   26899;   16929;    9840;    7976;    1864;     130
7090;A028725;GM1952;2019;   27118;   17094;    9982;    8196;    1786;      42
7091;A028725;GM1952;2020;   27212;   17099;   10070;    8197;    1873;      43
7092;A028725;GM0815;2012;    4186;    3026;    1146;     934;     212;      14
7093;A028725;GM0815;2013;    4235;    3075;    1156;     934;     222;       4
7094;A028725;GM0815;2014;    4311;    3085;    1168;     929;     239;      58
7095;A028725;GM0815;2015;    4327;    3109;    1161;     910;     251;      57
7096;A028725;GM0815;2016;    4298;    3126;    1153;     899;     254;      19
7097;A028725;GM0815;2017;    4354;    3151;    1185;     891;     294;      18
7098;A028725;GM0815;2018;    4392;    3225;    1146;     901;     245;      21
7099;A028725;GM0815;2019;    4421;    3223;    1196;     899;     297;       2
7100;A028725;GM0815;2020;    4472;    3269;    1199;     899;     300;       4
7101;A028725;GM0265;2012;    2403;    1602;     801;     727;      74;       0
7102;A028725;GM0265;2013;    2448;    1623;     825;     752;      73;       0
7103;A028725;GM0265;2014;    2471;    1628;     843;     757;      86;       0
7104;A028725;GM0265;2015;;;;;;
7105;A028725;GM0265;2016;;;;;;
7106;A028725;GM0265;2017;;;;;;
7107;A028725;GM0265;2018;;;;;;
7108;A028725;GM0265;2019;;;;;;
7109;A028725;GM0265;2020;;;;;;
7110;A028725;GM1709;2012;   14916;    9859;    5047;    4259;     788;      10
7111;A028725;GM1709;2013;   15096;    9999;    5088;    4293;     795;       9
7112;A028725;GM1709;2014;   15318;   10093;    5214;    4302;     912;      11
7113;A028725;GM1709;2015;   15491;   10166;    5298;    4293;    1005;      27
7114;A028725;GM1709;2016;   15522;   10217;    5278;    4254;    1024;      27
7115;A028725;GM1709;2017;   15673;   10271;    5374;    4237;    1137;      28
7116;A028725;GM1709;2018;   15829;   10220;    5575;    4348;    1227;      34
7117;A028725;GM1709;2019;   15895;   10541;    5339;    4348;     991;      15
7118;A028725;GM1709;2020;   15996;   10599;    5388;    4365;    1023;       9
7119;A028725;GM1978;2012;;;;;;
7120;A028725;GM1978;2013;;;;;;
7121;A028725;GM1978;2014;;;;;;
7122;A028725;GM1978;2015;;;;;;
7123;A028725;GM1978;2016;;;;;;
7124;A028725;GM1978;2017;;;;;;
7125;A028725;GM1978;2018;;;;;;
7126;A028725;GM1978;2019;   16491;   11397;    5023;    4379;     644;      71
7127;A028725;GM1978;2020;   16538;   11449;    5018;    4348;     670;      71
7128;A028725;GM1927;2012;;;;;;
7129;A028725;GM1927;2013;   10375;    6555;    3806;    3274;     532;      14
7130;A028725;GM1927;2014;   10463;    6597;    3805;    3258;     547;      61
7131;A028725;GM1927;2015;   10442;    6643;    3744;    3214;     530;      55
7132;A028725;GM1927;2016;   10529;    6758;    3723;    3222;     501;      48
7133;A028725;GM1927;2017;   10630;    6824;    3760;    3227;     533;      46
7134;A028725;GM1927;2018;   10723;    7017;    3655;    3215;     440;      51
7135;A028725;GM1927;2019;;;;;;
7136;A028725;GM1927;2020;;;;;;
7137;A028725;GM1955;2012;   13857;    9146;    4705;    3550;    1155;       6
7138;A028725;GM1955;2013;   13994;    9239;    4747;    3581;    1166;       8
7139;A028725;GM1955;2014;   14236;    9363;    4866;    3676;    1190;       7
7140;A028725;GM1955;2015;   14560;    9475;    5080;    3830;    1250;       5
7141;A028725;GM1955;2016;   14738;    9617;    5115;    3737;    1378;       6
7142;A028725;GM1955;2017;   14872;    9682;    5186;    3740;    1446;       4
7143;A028725;GM1955;2018;   15060;    9920;    5132;    3798;    1334;       8
7144;A028725;GM1955;2019;   15294;   10115;    5132;    3770;    1362;      47
7145;A028725;GM1955;2020;   15418;   10193;    5183;    3775;    1408;      42
7146;A028725;GM0335;2012;    5125;    3844;    1279;     885;     394;       2
7147;A028725;GM0335;2013;    5215;    3904;    1299;     884;     415;      12
7148;A028725;GM0335;2014;    5267;    3906;    1335;     829;     506;      26
7149;A028725;GM0335;2015;    5314;    3935;    1351;     905;     446;      28
7150;A028725;GM0335;2016;    5374;    4013;    1331;     847;     484;      30
7151;A028725;GM0335;2017;    5426;    4014;    1380;     855;     525;      32
7152;A028725;GM0335;2018;    5490;    4027;    1412;     865;     547;      51
7153;A028725;GM0335;2019;    5551;    4198;    1347;     898;     449;       6
7154;A028725;GM0335;2020;    5538;    4168;    1365;     900;     465;       5
7155;A028725;GM0944;2012;    3247;    2448;     794;     572;     222;       5
7156;A028725;GM0944;2013;    3267;    2455;     809;     578;     231;       3
7157;A028725;GM0944;2014;    3293;    2481;     810;     579;     231;       2
7158;A028725;GM0944;2015;    3334;    2491;     841;     602;     239;       2
7159;A028725;GM0944;2016;    3367;    2504;     857;     602;     255;       6
7160;A028725;GM0944;2017;    3370;    2499;     864;     597;     267;       7
7161;A028725;GM0944;2018;    3413;    2538;     868;     589;     279;       7
7162;A028725;GM0944;2019;    3436;    2574;     860;     581;     279;       2
7163;A028725;GM0944;2020;    3446;    2594;     850;     585;     265;       2
7164;A028725;GM0424;2012;    2644;    1606;    1038;     816;     222;       0
7165;A028725;GM0424;2013;    2638;    1596;    1041;     813;     228;       1
7166;A028725;GM0424;2014;    2643;    1584;    1058;     805;     253;       1
7167;A028725;GM0424;2015;    2655;    1603;    1051;     795;     256;       1
7168;A028725;GM0424;2016;;;;;;
7169;A028725;GM0424;2017;;;;;;
7170;A028725;GM0424;2018;;;;;;
7171;A028725;GM0424;2019;;;;;;
7172;A028725;GM0424;2020;;;;;;
7173;A028725;GM0425;2012;    7103;    5060;    2034;    1570;     464;       9
7174;A028725;GM0425;2013;    7120;    5050;    2064;    1556;     508;       6
7175;A028725;GM0425;2014;    7123;    5046;    2072;    1528;     544;       5
7176;A028725;GM0425;2015;    7224;    5091;    2090;    1503;     587;      43
7177;A028725;GM0425;2016;;;;;;
7178;A028725;GM0425;2017;;;;;;
7179;A028725;GM0425;2018;;;;;;
7180;A028725;GM0425;2019;;;;;;
7181;A028725;GM0425;2020;;;;;;
7182;A028725;GM1740;2012;    7570;    4644;    2922;    2430;     492;       4
7183;A028725;GM1740;2013;    7672;    4743;    2927;    2435;     492;       2
7184;A028725;GM1740;2014;    7733;    4811;    2921;    2437;     484;       1
7185;A028725;GM1740;2015;    7925;    4934;    2990;    2488;     502;       1
7186;A028725;GM1740;2016;    8096;    5009;    3084;    2546;     538;       3
7187;A028725;GM1740;2017;    8229;    5113;    3112;    2549;     563;       4
7188;A028725;GM1740;2018;    8362;    5353;    3001;    2565;     436;       8
7189;A028725;GM1740;2019;    8457;    5486;    2960;    2543;     417;      11
7190;A028725;GM1740;2020;    8561;    5578;    2965;    2549;     416;      18
7191;A028725;GM0643;2012;    5630;    3605;    2023;    1559;     464;       2
7192;A028725;GM0643;2013;    5826;    3703;    2118;    1645;     473;       5
7193;A028725;GM0643;2014;    5863;    3737;    2124;    1669;     455;       2
7194;A028725;GM0643;2015;;;;;;
7195;A028725;GM0643;2016;;;;;;
7196;A028725;GM0643;2017;;;;;;
7197;A028725;GM0643;2018;;;;;;
7198;A028725;GM0643;2019;;;;;;
7199;A028725;GM0643;2020;;;;;;
7200;A028725;GM0946;2012;    6653;    4618;    2030;    1566;     464;       5
7201;A028725;GM0946;2013;    6746;    4709;    2031;    1530;     501;       6
7202;A028725;GM0946;2014;    6832;    4767;    2016;    1520;     496;      49
7203;A028725;GM0946;2015;    6883;    4774;    2057;    1514;     543;      52
7204;A028725;GM0946;2016;    6930;    4783;    2090;    1497;     593;      57
7205;A028725;GM0946;2017;    7009;    4848;    2105;    1496;     609;      56
7206;A028725;GM0946;2018;    7116;    4956;    2106;    1495;     611;      54
7207;A028725;GM0946;2019;    7143;    5060;    2071;    1480;     591;      12
7208;A028725;GM0946;2020;    7185;    5114;    2060;    1460;     600;      11
7209;A028725;GM0304;2012;    4366;    3000;    1329;    1116;     213;      37
7210;A028725;GM0304;2013;    4411;    3029;    1345;    1114;     231;      37
7211;A028725;GM0304;2014;    4443;    3069;    1357;    1101;     256;      17
7212;A028725;GM0304;2015;    4460;    3083;    1356;    1121;     235;      21
7213;A028725;GM0304;2016;    4542;    3181;    1327;    1140;     187;      34
7214;A028725;GM0304;2017;    4629;    3232;    1355;    1137;     218;      42
7215;A028725;GM0304;2018;    4672;    3271;    1352;    1132;     220;      49
7216;A028725;GM0304;2019;;;;;;
7217;A028725;GM0304;2020;;;;;;
7218;A028725;GM0356;2012;   25721;   15330;   10371;    8491;    1880;      20
7219;A028725;GM0356;2013;   25863;   15431;   10421;    8426;    1995;      11
7220;A028725;GM0356;2014;   26249;   15655;   10467;    8349;    2118;     127
7221;A028725;GM0356;2015;   26603;   15860;   10635;    8483;    2152;     108
7222;A028725;GM0356;2016;   26939;   16049;   10787;    8549;    2238;     103
7223;A028725;GM0356;2017;   27193;   16219;   10832;    8507;    2325;     142
7224;A028725;GM0356;2018;   27608;   16283;   11205;    8523;    2682;     120
7225;A028725;GM0356;2019;   28004;   16953;   10969;    8602;    2367;      82
7226;A028725;GM0356;2020;   28143;   16968;   11004;    8581;    2423;     171
7227;A028725;GM0569;2012;    9932;    6996;    2908;    2248;     660;      28
7228;A028725;GM0569;2013;   10053;    7103;    2927;    2266;     661;      23
7229;A028725;GM0569;2014;   10185;    7205;    2966;    2275;     691;      14
7230;A028725;GM0569;2015;   10279;    7290;    2949;    2248;     701;      40
7231;A028725;GM0569;2016;   10459;    7440;    2982;    2285;     697;      37
7232;A028725;GM0569;2017;   10700;    7649;    3010;    2279;     731;      41
7233;A028725;GM0569;2018;   10899;    7856;    2988;    2344;     644;      55
7234;A028725;GM0569;2019;   11061;    8037;    3013;    2359;     654;      11
7235;A028725;GM0569;2020;   11142;    8099;    3026;    2374;     652;      17
7236;A028725;GM0571;2012;    3351;    1913;    1413;    1291;     122;      25
7237;A028725;GM0571;2013;;;;;;
7238;A028725;GM0571;2014;;;;;;
7239;A028725;GM0571;2015;;;;;;
7240;A028725;GM0571;2016;;;;;;
7241;A028725;GM0571;2017;;;;;;
7242;A028725;GM0571;2018;;;;;;
7243;A028725;GM0571;2019;;;;;;
7244;A028725;GM0571;2020;;;;;;
7245;A028725;GM0267;2012;   14957;   10244;    4701;    3208;    1493;      12
7246;A028725;GM0267;2013;   15084;   10392;    4691;    3689;    1002;       1
7247;A028725;GM0267;2014;   15299;   10493;    4804;    3739;    1065;       2
7248;A028725;GM0267;2015;   15511;   10663;    4845;    3742;    1103;       3
7249;A028725;GM0267;2016;   15660;   10769;    4887;    3749;    1138;       4
7250;A028725;GM0267;2017;   15948;   10978;    4966;    3806;    1160;       4
7251;A028725;GM0267;2018;   16173;   11138;    4966;    3828;    1138;      69
7252;A028725;GM0267;2019;   16648;   11739;    4903;    3891;    1012;       6
7253;A028725;GM0267;2020;   16830;   11880;    4939;    3900;    1039;      11
7254;A028725;GM0268;2012;   71035;   30110;   39914;   29622;   10292;    1011
7255;A028725;GM0268;2013;   73155;   30343;   40797;   29858;   10939;    2015
7256;A028725;GM0268;2014;   73946;   30484;   41372;   29786;   11586;    2090
7257;A028725;GM0268;2015;   75343;   30853;   44066;   32568;   11498;     424
7258;A028725;GM0268;2016;   76148;   31413;   44312;   32819;   11493;     423
7259;A028725;GM0268;2017;   75038;   31927;   42702;   31102;   11600;     409
7260;A028725;GM0268;2018;   76434;   33280;   42766;   31287;   11479;     388
7261;A028725;GM0268;2019;   77857;   34205;   43398;   31405;   11993;     254
7262;A028725;GM0268;2020;   79037;   34681;   43978;   31639;   12339;     378
7263;A028725;GM1930;2012;;;;;;
7264;A028725;GM1930;2013;;;;;;
7265;A028725;GM1930;2014;;;;;;
7266;A028725;GM1930;2015;   37616;   21525;   16081;   14505;    1576;      10
7267;A028725;GM1930;2016;   37799;   21715;   16077;   14142;    1935;       7
7268;A028725;GM1930;2017;   37994;   21837;   16103;   14471;    1632;      54
7269;A028725;GM1930;2018;   37779;   21590;   16131;   14495;    1636;      58
7270;A028725;GM1930;2019;   37876;   22156;   15703;   14396;    1307;      17
7271;A028725;GM1930;2020;   37917;   22312;   15589;   14198;    1391;      16
7272;A028725;GM1970;2012;;;;;;
7273;A028725;GM1970;2013;;;;;;
7274;A028725;GM1970;2014;;;;;;
7275;A028725;GM1970;2015;;;;;;
7276;A028725;GM1970;2016;;;;;;
7277;A028725;GM1970;2017;;;;;;
7278;A028725;GM1970;2018;;;;;;
7279;A028725;GM1970;2019;   19355;   13091;    6175;    4863;    1312;      89
7280;A028725;GM1970;2020;   19520;   13133;    6289;    4835;    1454;      98
7281;A028725;GM1695;2012;    3272;    2432;     840;     612;     228;       0
7282;A028725;GM1695;2013;    3274;    2431;     843;     610;     233;       0
7283;A028725;GM1695;2014;    3326;    2458;     868;     597;     271;       0
7284;A028725;GM1695;2015;    3434;    2477;     955;     622;     333;       2
7285;A028725;GM1695;2016;    3462;    2500;     952;     625;     327;      10
7286;A028725;GM1695;2017;    3450;    2495;     951;     607;     344;       4
7287;A028725;GM1695;2018;    3471;    2549;     917;     609;     308;       5
7288;A028725;GM1695;2019;    3480;    2609;     852;     594;     258;      19
7289;A028725;GM1695;2020;    3534;    2660;     857;     592;     265;      17
7290;A028725;GM1699;2012;   12967;    9374;    3540;    2386;    1154;      53
7291;A028725;GM1699;2013;   13076;    9414;    3623;    2413;    1210;      39
7292;A028725;GM1699;2014;   13362;    9509;    3695;    2406;    1289;     158
7293;A028725;GM1699;2015;   13424;    9566;    3704;    2374;    1330;     154
7294;A028725;GM1699;2016;   13512;    9585;    3786;    2727;    1059;     141
7295;A028725;GM1699;2017;   13628;    9740;    3751;    2749;    1002;     137
7296;A028725;GM1699;2018;   13671;    9759;    3769;    2738;    1031;     143
7297;A028725;GM1699;2019;   13716;    9925;    3753;    2710;    1043;      38
7298;A028725;GM1699;2020;   13804;    9999;    3704;    2705;     999;     101
7299;A028725;GM0171;2012;   18105;   12066;    6023;    5025;     998;      16
7300;A028725;GM0171;2013;   18227;   12181;    6036;    4987;    1049;      10
7301;A028725;GM0171;2014;   18514;   12191;    6180;    4917;    1263;     143
7302;A028725;GM0171;2015;   18551;   12240;    6167;    4841;    1326;     144
7303;A028725;GM0171;2016;   18605;   12339;    6108;    4803;    1305;     158
7304;A028725;GM0171;2017;   18653;   12239;    6264;    4753;    1511;     150
7305;A028725;GM0171;2018;   18859;   12472;    6223;    4844;    1379;     164
7306;A028725;GM0171;2019;   19000;   12795;    6198;    4811;    1387;       7
7307;A028725;GM0171;2020;   19101;   12868;    6226;    4787;    1439;       7
7308;A028725;GM0575;2012;   10528;    6922;    3526;    2227;    1299;      80
7309;A028725;GM0575;2013;   10789;    7008;    3655;    2237;    1418;     126
7310;A028725;GM0575;2014;   10833;    6946;    3764;    2229;    1535;     123
7311;A028725;GM0575;2015;   10818;    6974;    3701;    2232;    1469;     143
7312;A028725;GM0575;2016;   11031;    7030;    3742;    2222;    1520;     259
7313;A028725;GM0575;2017;   11094;    7037;    3787;    2204;    1583;     270
7314;A028725;GM0575;2018;   11194;    7136;    3804;    2213;    1591;     254
7315;A028725;GM0575;2019;   18133;   11620;    6351;    4076;    2275;     162
7316;A028725;GM0575;2020;   18376;   11766;    6461;    4114;    2347;     149
7317;A028725;GM0576;2012;    6109;    3816;    2281;    1717;     564;      12
7318;A028725;GM0576;2013;    6197;    3865;    2328;    1863;     465;       4
7319;A028725;GM0576;2014;    6466;    3942;    2414;    1915;     499;     110
7320;A028725;GM0576;2015;    6539;    4010;    2484;    1955;     529;      45
7321;A028725;GM0576;2016;    6580;    4062;    2452;    1888;     564;      66
7322;A028725;GM0576;2017;    6719;    4148;    2503;    1877;     626;      68
7323;A028725;GM0576;2018;    6780;    4238;    2464;    1876;     588;      78
7324;A028725;GM0576;2019;;;;;;
7325;A028725;GM0576;2020;;;;;;
7326;A028725;GM0820;2012;    9086;    6900;    2183;    1466;     717;       3
7327;A028725;GM0820;2013;    9458;    7122;    2331;    1562;     769;       5
7328;A028725;GM0820;2014;    9525;    7115;    2406;    1579;     827;       4
7329;A028725;GM0820;2015;    9583;    7158;    2421;    1586;     835;       4
7330;A028725;GM0820;2016;    9687;    7177;    2504;    1609;     895;       6
7331;A028725;GM0820;2017;    9689;    7224;    2458;    1619;     839;       7
7332;A028725;GM0820;2018;    9749;    7425;    2301;    1619;     682;      23
7333;A028725;GM0820;2019;    9899;    7515;    2370;    1622;     748;      14
7334;A028725;GM0820;2020;    9997;    7548;    2438;    1632;     806;      11
7335;A028725;GM0302;2012;    9445;    6066;    3319;    2373;     946;      60
7336;A028725;GM0302;2013;    9634;    6108;    3462;    2419;    1043;      64
7337;A028725;GM0302;2014;    9686;    6143;    3483;    2388;    1095;      60
7338;A028725;GM0302;2015;    9847;    6233;    3570;    2525;    1045;      44
7339;A028725;GM0302;2016;    9946;    6301;    3559;    2464;    1095;      86
7340;A028725;GM0302;2017;    9996;    6351;    3551;    2472;    1079;      94
7341;A028725;GM0302;2018;   10179;    6639;    3439;    2532;     907;     101
7342;A028725;GM0302;2019;   10383;    6768;    3567;    2588;     979;      48
7343;A028725;GM0302;2020;   10558;    6918;    3576;    2587;     989;      64
7344;A028725;GM0951;2012;    6486;    4650;    1835;    1402;     433;       1
7345;A028725;GM0951;2013;    6576;    4721;    1854;    1379;     475;       1
7346;A028725;GM0951;2014;    6606;    4758;    1847;    1339;     508;       1
7347;A028725;GM0951;2015;    6619;    4770;    1849;    1346;     503;       0
7348;A028725;GM0951;2016;    6640;    4770;    1870;    1333;     537;       0
7349;A028725;GM0951;2017;    6656;    4779;    1877;    1311;     566;       0
7350;A028725;GM0951;2018;    6658;    4866;    1789;    1294;     495;       3
7351;A028725;GM0951;2019;;;;;;
7352;A028725;GM0951;2020;;;;;;
7353;A028725;GM0579;2012;    9333;    6682;    2519;    1718;     801;     132
7354;A028725;GM0579;2013;    9566;    6827;    2607;    1750;     857;     132
7355;A028725;GM0579;2014;    9766;    6924;    2639;    1652;     987;     203
7356;A028725;GM0579;2015;    9835;    7056;    2696;    1718;     978;      83
7357;A028725;GM0579;2016;    9915;    7108;    2724;    1713;    1011;      83
7358;A028725;GM0579;2017;   10103;    7240;    2778;    1718;    1060;      85
7359;A028725;GM0579;2018;   10144;    7184;    2879;    1733;    1146;      81
7360;A028725;GM0579;2019;   10335;    7475;    2783;    1735;    1048;      77
7361;A028725;GM0579;2020;   10464;    7538;    2900;    1702;    1198;      26
7362;A028725;GM0823;2012;    6615;    5264;    1333;     918;     415;      18
7363;A028725;GM0823;2013;    6622;    5273;    1345;     921;     424;       4
7364;A028725;GM0823;2014;    6696;    5273;    1419;     931;     488;       4
7365;A028725;GM0823;2015;    6798;    5344;    1450;     952;     498;       4
7366;A028725;GM0823;2016;    7138;    5580;    1553;     965;     588;       5
7367;A028725;GM0823;2017;    7360;    5645;    1579;     975;     604;     136
7368;A028725;GM0823;2018;    7428;    5741;    1565;    1000;     565;     122
7369;A028725;GM0823;2019;    7517;    5791;    1718;     994;     724;       8
7370;A028725;GM0823;2020;    7584;    5844;    1728;     996;     732;      12
7371;A028725;GM0824;2012;   10251;    7048;    3179;    2278;     901;      24
7372;A028725;GM0824;2013;   10449;    7064;    3311;    2380;     931;      74
7373;A028725;GM0824;2014;   10575;    7130;    3382;    2312;    1070;      63
7374;A028725;GM0824;2015;   10597;    7153;    3386;    2381;    1005;      58
7375;A028725;GM0824;2016;   10663;    7161;    3443;    2385;    1058;      59
7376;A028725;GM0824;2017;   10779;    7260;    3464;    2396;    1068;      55
7377;A028725;GM0824;2018;   10889;    7543;    3280;    2416;     864;      66
7378;A028725;GM0824;2019;   10981;    7645;    3326;    2402;     924;      10
7379;A028725;GM0824;2020;   11087;    7655;    3403;    2390;    1013;      29
7380;A028725;GM1895;2012;   17201;   11070;    6006;    4719;    1287;     125
7381;A028725;GM1895;2013;   17239;   11104;    6093;    4703;    1390;      42
7382;A028725;GM1895;2014;   17264;   11074;    6165;    4665;    1500;      25
7383;A028725;GM1895;2015;   17447;   11057;    6367;    4842;    1525;      23
7384;A028725;GM1895;2016;   17559;   11035;    6479;    4883;    1596;      45
7385;A028725;GM1895;2017;   17601;   11042;    6517;    4879;    1638;      42
7386;A028725;GM1895;2018;   17678;   11255;    6379;    4870;    1509;      44
7387;A028725;GM1895;2019;   17712;   11428;    6264;    4824;    1440;      20
7388;A028725;GM1895;2020;   17824;   11449;    6356;    4846;    1510;      19
7389;A028725;GM0269;2012;    8219;    5645;    2549;    2021;     528;      25
7390;A028725;GM0269;2013;    8450;    5820;    2616;    2025;     591;      14
7391;A028725;GM0269;2014;    8585;    5864;    2646;    2040;     606;      75
7392;A028725;GM0269;2015;    8663;    5938;    2655;    2103;     552;      70
7393;A028725;GM0269;2016;    8723;    6033;    2626;    2104;     522;      64
7394;A028725;GM0269;2017;    8808;    6112;    2643;    2081;     562;      53
7395;A028725;GM0269;2018;    8913;    6181;    2659;    2072;     587;      73
7396;A028725;GM0269;2019;    8978;    6161;    2795;    2105;     690;      22
7397;A028725;GM0269;2020;    9015;    6219;    2780;    2106;     674;      16
7398;A028725;GM0173;2012;   13546;    8381;    5159;    4275;     884;       6
7399;A028725;GM0173;2013;   13596;    8428;    5166;    4279;     887;       2
7400;A028725;GM0173;2014;   13733;    8397;    5197;    4248;     949;     139
7401;A028725;GM0173;2015;   13771;    8447;    5153;    4223;     930;     171
7402;A028725;GM0173;2016;   13855;    8435;    5222;    4246;     976;     198
7403;A028725;GM0173;2017;   13883;    8398;    5280;    4251;    1029;     205
7404;A028725;GM0173;2018;   13938;    8654;    5147;    4195;     952;     137
7405;A028725;GM0173;2019;   13977;    8693;    5271;    4207;    1064;      13
7406;A028725;GM0173;2020;   14115;    8827;    5276;    4169;    1107;      12
7407;A028725;GM1773;2012;    6786;    4715;    2048;    1582;     466;      23
7408;A028725;GM1773;2013;    6935;    4800;    2125;    1664;     461;      10
7409;A028725;GM1773;2014;    6968;    4820;    2137;    1670;     467;      11
7410;A028725;GM1773;2015;    7072;    4861;    2200;    1725;     475;      11
7411;A028725;GM1773;2016;    7136;    4904;    2220;    1711;     509;      12
7412;A028725;GM1773;2017;    7219;    4894;    2283;    1701;     582;      42
7413;A028725;GM1773;2018;    7365;    5046;    2310;    1732;     578;       9
7414;A028725;GM1773;2019;    7433;    5157;    2271;    1725;     546;       5
7415;A028725;GM1773;2020;    7470;    5209;    2257;    1721;     536;       4
7416;A028725;GM0175;2012;    6724;    4685;    1931;    1222;     709;     108
7417;A028725;GM0175;2013;    6732;    4674;    1959;    1231;     728;      99
7418;A028725;GM0175;2014;    6453;    4513;    1886;    1224;     662;      54
7419;A028725;GM0175;2015;    6398;    4503;    1881;    1216;     665;      14
7420;A028725;GM0175;2016;    6663;    4679;    1958;    1211;     747;      26
7421;A028725;GM0175;2017;    6774;    4752;    2003;    1206;     797;      19
7422;A028725;GM0175;2018;    6885;    4963;    1892;    1206;     686;      30
7423;A028725;GM0175;2019;    7031;    5004;    2003;    1332;     671;      24
7424;A028725;GM0175;2020;    7122;    5090;    2023;    1320;     703;       9
7425;A028725;GM0881;2012;    3331;    2448;     881;     641;     240;       2
7426;A028725;GM0881;2013;    3345;    2444;     898;     637;     261;       3
7427;A028725;GM0881;2014;    3343;    2471;     871;     622;     249;       1
7428;A028725;GM0881;2015;    3354;    2475;     875;     621;     254;       4
7429;A028725;GM0881;2016;    3355;    2479;     872;     618;     254;       4
7430;A028725;GM0881;2017;    3382;    2487;     890;     626;     264;       5
7431;A028725;GM0881;2018;    3402;    2522;     875;     629;     246;       5
7432;A028725;GM0881;2019;;;;;;
7433;A028725;GM0881;2020;;;;;;
7434;A028725;GM1586;2012;   11826;    8839;    2982;    1950;    1032;       5
7435;A028725;GM1586;2013;   11965;    8907;    3050;    1961;    1089;       8
7436;A028725;GM1586;2014;   12144;    8925;    3202;    1934;    1268;      17
7437;A028725;GM1586;2015;   12204;    8990;    3207;    1937;    1270;       7
7438;A028725;GM1586;2016;   12273;    9020;    3242;    1915;    1327;      11
7439;A028725;GM1586;2017;   12339;    9033;    3296;    1909;    1387;      10
7440;A028725;GM1586;2018;   12403;    9291;    3106;    1904;    1202;       6
7441;A028725;GM1586;2019;   12496;    9389;    3107;    1923;    1184;       0
7442;A028725;GM1586;2020;   12557;    9414;    3138;    1923;    1215;       5
7443;A028725;GM0826;2012;   22595;   13331;    9254;    7711;    1543;      10
7444;A028725;GM0826;2013;   22627;   13380;    9239;    7659;    1580;       8
7445;A028725;GM0826;2014;   23010;   13598;    9296;    7755;    1541;     116
7446;A028725;GM0826;2015;   23268;   13778;    9378;    7726;    1652;     112
7447;A028725;GM0826;2016;   23321;   13893;    9347;    7678;    1669;      81
7448;A028725;GM0826;2017;   23601;   14023;    9495;    7819;    1676;      83
7449;A028725;GM0826;2018;   23888;   14061;    9738;    7850;    1888;      89
7450;A028725;GM0826;2019;   24301;   14745;    9477;    8039;    1438;      79
7451;A028725;GM0826;2020;   24390;   14911;    9396;    7941;    1455;      83
7452;A028725;GM0580;2012;    4046;    2407;    1633;    1498;     135;       6
7453;A028725;GM0580;2013;;;;;;
7454;A028725;GM0580;2014;;;;;;
7455;A028725;GM0580;2015;;;;;;
7456;A028725;GM0580;2016;;;;;;
7457;A028725;GM0580;2017;;;;;;
7458;A028725;GM0580;2018;;;;;;
7459;A028725;GM0580;2019;;;;;;
7460;A028725;GM0580;2020;;;;;;
7461;A028725;GM0085;2012;   10686;    7010;    3665;    3112;     553;      11
7462;A028725;GM0085;2013;   10743;    7045;    3692;    3105;     587;       6
7463;A028725;GM0085;2014;   10745;    7017;    3726;    3082;     644;       2
7464;A028725;GM0085;2015;   10766;    7034;    3731;    3073;     658;       1
7465;A028725;GM0085;2016;   10785;    7065;    3716;    3047;     669;       4
7466;A028725;GM0085;2017;   10822;    7080;    3740;    3040;     700;       2
7467;A028725;GM0085;2018;   10862;    7191;    3663;    3052;     611;       8
7468;A028725;GM0085;2019;   10896;    7363;    3518;    2984;     534;      15
7469;A028725;GM0085;2020;   10908;    7389;    3502;    2969;     533;      17
7470;A028725;GM0431;2012;    3696;    2421;    1208;    1020;     188;      67
7471;A028725;GM0431;2013;    3741;    2442;    1275;    1082;     193;      24
7472;A028725;GM0431;2014;    3752;    2445;    1283;    1086;     197;      24
7473;A028725;GM0431;2015;    3803;    2463;    1318;    1119;     199;      22
7474;A028725;GM0431;2016;    3931;    2567;    1341;    1103;     238;      23
7475;A028725;GM0431;2017;    3964;    2592;    1350;    1112;     238;      22
7476;A028725;GM0431;2018;    3986;    2663;    1299;    1110;     189;      24
7477;A028725;GM0431;2019;    3978;    2691;    1286;    1126;     160;       1
7478;A028725;GM0431;2020;    3970;    2687;    1282;    1105;     177;       1
7479;A028725;GM0432;2012;    4430;    3347;    1081;      58;    1023;       2
7480;A028725;GM0432;2013;    4454;    3337;    1117;      62;    1055;       0
7481;A028725;GM0432;2014;    4452;    3340;    1112;      62;    1050;       0
7482;A028725;GM0432;2015;    4474;    3360;    1114;      62;    1052;       0
7483;A028725;GM0432;2016;    4502;    3364;    1137;      60;    1077;       1
7484;A028725;GM0432;2017;    4553;    3403;    1150;      62;    1088;       0
7485;A028725;GM0432;2018;    4602;    3476;    1125;      60;    1065;       1
7486;A028725;GM0432;2019;    4639;    3555;    1084;      61;    1023;       0
7487;A028725;GM0432;2020;    4701;    3607;    1093;      27;    1066;       1
7488;A028725;GM0086;2012;   11912;    8499;    3383;    2888;     495;      30
7489;A028725;GM0086;2013;   11975;    8570;    3400;    2859;     541;       5
7490;A028725;GM0086;2014;   12233;    8585;    3452;    2902;     550;     196
7491;A028725;GM0086;2015;   12273;    8630;    3466;    2899;     567;     177
7492;A028725;GM0086;2016;   12397;    8639;    3489;    2871;     618;     269
7493;A028725;GM0086;2017;   12420;    8668;    3488;    2835;     653;     264
7494;A028725;GM0086;2018;   12485;    8774;    3449;    2820;     629;     262
7495;A028725;GM0086;2019;   12563;    8913;    3629;    2843;     786;      21
7496;A028725;GM0086;2020;   12655;    8951;    3681;    2850;     831;      23
7497;A028725;GM0828;2012;   34145;   21728;   12355;   10092;    2263;      62
7498;A028725;GM0828;2013;   34515;   21879;   12590;   10154;    2436;      46
7499;A028725;GM0828;2014;   35024;   21953;   12823;   10198;    2625;     248
7500;A028725;GM0828;2015;   37278;   23438;   13573;   10578;    2995;     267
7501;A028725;GM0828;2016;   37568;   23621;   13684;   10697;    2987;     263
7502;A028725;GM0828;2017;   37910;   23695;   13921;   10744;    3177;     294
7503;A028725;GM0828;2018;   38282;   24261;   13698;   10786;    2912;     323
7504;A028725;GM0828;2019;   38658;   24574;   14066;   11041;    3025;      18
7505;A028725;GM0828;2020;   39060;   24805;   14220;   11020;    3200;      35
7506;A028725;GM0584;2012;    9228;    6181;    3030;    2552;     478;      17
7507;A028725;GM0584;2013;    9261;    6194;    3053;    2539;     514;      14
7508;A028725;GM0584;2014;    9501;    6262;    3225;    2713;     512;      14
7509;A028725;GM0584;2015;    9542;    6278;    3250;    2730;     520;      14
7510;A028725;GM0584;2016;    9615;    6395;    3207;    2734;     473;      13
7511;A028725;GM0584;2017;    9774;    6472;    3289;    2760;     529;      13
7512;A028725;GM0584;2018;    9910;    6671;    3226;    2789;     437;      13
7513;A028725;GM0584;2019;;;;;;
7514;A028725;GM0584;2020;;;;;;
7515;A028725;GM1509;2012;   15859;   10683;    4929;    3865;    1064;     247
7516;A028725;GM1509;2013;   16391;   10927;    5205;    4011;    1194;     259
7517;A028725;GM1509;2014;   16411;   10971;    5185;    3979;    1206;     255
7518;A028725;GM1509;2015;   16514;   11001;    5259;    4061;    1198;     254
7519;A028725;GM1509;2016;   16690;   11046;    5387;    4134;    1253;     257
7520;A028725;GM1509;2017;   16738;   11069;    5413;    4134;    1279;     256
7521;A028725;GM1509;2018;   16756;   11120;    5377;    4119;    1258;     259
7522;A028725;GM1509;2019;   16844;   11080;    5746;    4192;    1554;      18
7523;A028725;GM1509;2020;   16874;   11110;    5748;    4222;    1526;      16
7524;A028725;GM0437;2012;    5530;    3115;    2413;    1778;     635;       2
7525;A028725;GM0437;2013;    5509;    3118;    2388;    1744;     644;       3
7526;A028725;GM0437;2014;    5590;    3160;    2429;    1768;     661;       1
7527;A028725;GM0437;2015;    5594;    3170;    2422;    1772;     650;       2
7528;A028725;GM0437;2016;    5654;    3224;    2428;    1787;     641;       2
7529;A028725;GM0437;2017;    5673;    3248;    2422;    1786;     636;       3
7530;A028725;GM0437;2018;    5684;    3284;    2392;    1788;     604;       8
7531;A028725;GM0437;2019;    5920;    3358;    2556;    1939;     617;       6
7532;A028725;GM0437;2020;    5969;    3363;    2598;    1949;     649;       8
7533;A028725;GM0644;2012;    3025;    2061;     960;     781;     179;       4
7534;A028725;GM0644;2013;    3087;    2113;     971;     771;     200;       3
7535;A028725;GM0644;2014;    3126;    2153;     973;     799;     174;       0
7536;A028725;GM0644;2015;;;;;;
7537;A028725;GM0644;2016;;;;;;
7538;A028725;GM0644;2017;;;;;;
7539;A028725;GM0644;2018;;;;;;
7540;A028725;GM0644;2019;;;;;;
7541;A028725;GM0644;2020;;;;;;
7542;A028725;GM0589;2012;    3818;    2744;    1072;     854;     218;       2
7543;A028725;GM0589;2013;    3888;    2771;    1115;     893;     222;       2
7544;A028725;GM0589;2014;    3961;    2777;    1132;     883;     249;      52
7545;A028725;GM0589;2015;    3971;    2776;    1143;     857;     286;      52
7546;A028725;GM0589;2016;    4063;    2798;    1222;     916;     306;      43
7547;A028725;GM0589;2017;    4129;    2871;    1223;     916;     307;      35
7548;A028725;GM0589;2018;    4106;    2909;    1186;     904;     282;      11
7549;A028725;GM0589;2019;    4109;    2908;    1196;     894;     302;       5
7550;A028725;GM0589;2020;    4156;    2926;    1227;     925;     302;       3
7551;A028725;GM1734;2012;   17589;   11976;    5607;    4289;    1318;       6
7552;A028725;GM1734;2013;   17855;   12187;    5660;    4294;    1366;       8
7553;A028725;GM1734;2014;   17981;   12271;    5706;    4264;    1442;       4
7554;A028725;GM1734;2015;   18322;   12350;    5821;    4214;    1607;     151
7555;A028725;GM1734;2016;   18696;   12500;    6057;    4224;    1833;     139
7556;A028725;GM1734;2017;   18852;   12495;    6220;    4245;    1975;     137
7557;A028725;GM1734;2018;   18986;   12743;    6096;    4224;    1872;     147
7558;A028725;GM1734;2019;   19189;   13169;    5968;    4333;    1635;      52
7559;A028725;GM1734;2020;   19385;   13272;    6059;    4340;    1719;      54
7560;A028725;GM0590;2012;   13463;    8523;    4936;    4111;     825;       4
7561;A028725;GM0590;2013;   13594;    8644;    4947;    4086;     861;       3
7562;A028725;GM0590;2014;   13689;    8756;    4929;    4077;     852;       4
7563;A028725;GM0590;2015;   13780;    8795;    4971;    4114;     857;      14
7564;A028725;GM0590;2016;   13840;    8815;    5000;    4118;     882;      25
7565;A028725;GM0590;2017;   13880;    8845;    4996;    4115;     881;      39
7566;A028725;GM0590;2018;   13923;    9024;    4848;    4093;     755;      51
7567;A028725;GM0590;2019;   13997;    9148;    4783;    4089;     694;      66
7568;A028725;GM0590;2020;   13942;    9121;    4759;    4074;     685;      62
7569;A028725;GM1894;2012;   16575;   12028;    4530;    3578;     952;      17
7570;A028725;GM1894;2013;   16757;   12016;    4719;    3596;    1123;      22
7571;A028725;GM1894;2014;   17100;   12276;    4652;    3646;    1006;     172
7572;A028725;GM1894;2015;   17258;   12317;    4804;    3710;    1094;     137
7573;A028725;GM1894;2016;   17355;   12381;    4852;    3749;    1103;     122
7574;A028725;GM1894;2017;   17456;   12504;    4844;    3722;    1122;     108
7575;A028725;GM1894;2018;   17535;   12682;    4744;    3431;    1313;     109
7576;A028725;GM1894;2019;   17662;   12918;    4714;    3632;    1082;      30
7577;A028725;GM1894;2020;   17816;   13032;    4752;    3601;    1151;      32
7578;A028725;GM0765;2012;    5373;    3571;    1797;    1451;     346;       5
7579;A028725;GM0765;2013;    5374;    3553;    1818;    1437;     381;       3
7580;A028725;GM0765;2014;    5501;    3572;    1927;    1447;     480;       2
7581;A028725;GM0765;2015;    5473;    3556;    1916;    1522;     394;       1
7582;A028725;GM0765;2016;    5482;    3529;    1952;    1477;     475;       1
7583;A028725;GM0765;2017;    5466;    3524;    1933;    1461;     472;       9
7584;A028725;GM0765;2018;    5480;    3500;    1968;    1480;     488;      12
7585;A028725;GM0765;2019;    5511;    3581;    1925;    1521;     404;       5
7586;A028725;GM0765;2020;    5512;    3555;    1955;    1517;     438;       2
7587;A028725;GM1926;2012;   18421;   13027;    5383;    4166;    1217;      11
7588;A028725;GM1926;2013;   18584;   13124;    5447;    4215;    1232;      13
7589;A028725;GM1926;2014;   19017;   13224;    5728;    4307;    1421;      65
7590;A028725;GM1926;2015;   19112;   13303;    5740;    4290;    1450;      69
7591;A028725;GM1926;2016;   19524;   13614;    5840;    4266;    1574;      70
7592;A028725;GM1926;2017;   19864;   13871;    5918;    4249;    1669;      75
7593;A028725;GM1926;2018;   20298;   14202;    6009;    4198;    1811;      87
7594;A028725;GM1926;2019;   20617;   14803;    5809;    4189;    1620;       5
7595;A028725;GM1926;2020;   21001;   15017;    5980;    4255;    1725;       4
7596;A028725;GM0439;2012;   33678;   19709;   13882;   12264;    1618;      87
7597;A028725;GM0439;2013;   33937;   19866;   13976;   12215;    1761;      95
7598;A028725;GM0439;2014;   34178;   19991;   14094;   12229;    1865;      93
7599;A028725;GM0439;2015;   34416;   20229;   14154;   12467;    1687;      33
7600;A028725;GM0439;2016;   34738;   20440;   14199;   12049;    2150;      99
7601;A028725;GM0439;2017;   34855;   20468;   14292;   11991;    2301;      95
7602;A028725;GM0439;2018;   34984;   20617;   14247;   12078;    2169;     120
7603;A028725;GM0439;2019;   35030;   20998;   14026;   12149;    1877;       6
7604;A028725;GM0439;2020;   35643;   21276;   14356;   12203;    2153;      11
7605;A028725;GM0273;2012;    8659;    5967;    2654;    1871;     783;      38
7606;A028725;GM0273;2013;    8861;    6051;    2775;    1927;     848;      35
7607;A028725;GM0273;2014;    8953;    6065;    2825;    1935;     890;      63
7608;A028725;GM0273;2015;    9129;    6131;    2929;    1968;     961;      69
7609;A028725;GM0273;2016;    9153;    6150;    2932;    1984;     948;      71
7610;A028725;GM0273;2017;    9203;    6176;    2959;    1998;     961;      68
7611;A028725;GM0273;2018;    9236;    6225;    2944;    2036;     908;      67
7612;A028725;GM0273;2019;    9252;    6266;    2959;    2056;     903;      27
7613;A028725;GM0273;2020;    9274;    6281;    2964;    2059;     905;      29
7614;A028725;GM0177;2012;   14240;    9638;    4544;    3466;    1078;      58
7615;A028725;GM0177;2013;   14351;    9756;    4571;    3455;    1116;      24
7616;A028725;GM0177;2014;   14469;    9818;    4640;    3525;    1115;      11
7617;A028725;GM0177;2015;   14677;    9916;    4750;    3651;    1099;      11
7618;A028725;GM0177;2016;   14753;   10068;    4672;    3651;    1021;      13
7619;A028725;GM0177;2017;   14866;   10067;    4786;    3650;    1136;      13
7620;A028725;GM0177;2018;   15060;   10298;    4745;    3633;    1112;      17
7621;A028725;GM0177;2019;   15247;   10572;    4653;    3725;     928;      22
7622;A028725;GM0177;2020;   15364;   10679;    4660;    3684;     976;      25
7623;A028725;GM0703;2012;    8129;    5627;    2496;    2073;     423;       6
7624;A028725;GM0703;2013;    8192;    5671;    2518;    2063;     455;       3
7625;A028725;GM0703;2014;    8345;    5704;    2524;    2060;     464;     117
7626;A028725;GM0703;2015;    8436;    5774;    2512;    2071;     441;     150
7627;A028725;GM0703;2016;    8513;    5833;    2528;    2061;     467;     152
7628;A028725;GM0703;2017;    8552;    5854;    2553;    2024;     529;     145
7629;A028725;GM0703;2018;    8591;    5956;    2501;    2033;     468;     134
7630;A028725;GM0703;2019;    8662;    6076;    2481;    1996;     485;     105
7631;A028725;GM0703;2020;    8747;    6181;    2450;    1935;     515;     116
7632;A028725;GM0274;2012;   13497;    8668;    4768;    3006;    1762;      61
7633;A028725;GM0274;2013;   13507;    8650;    4847;    2973;    1874;      10
7634;A028725;GM0274;2014;   13669;    8655;    4995;    3031;    1964;      19
7635;A028725;GM0274;2015;   13738;    8629;    5089;    3052;    2037;      20
7636;A028725;GM0274;2016;   13777;    8658;    5098;    3038;    2060;      21
7637;A028725;GM0274;2017;   13875;    8696;    5157;    2996;    2161;      22
7638;A028725;GM0274;2018;   13990;    8870;    5097;    3016;    2081;      23
7639;A028725;GM0274;2019;   14084;    9030;    5037;    3038;    1999;      17
7640;A028725;GM0274;2020;   14200;    9077;    5086;    3081;    2005;      37
7641;A028725;GM0339;2012;    1655;    1222;     419;       0;     419;      14
7642;A028725;GM0339;2013;    1747;    1292;     447;       0;     447;       8
7643;A028725;GM0339;2014;    1754;    1309;     439;       0;     439;       6
7644;A028725;GM0339;2015;    1767;    1322;     444;       0;     444;       1
7645;A028725;GM0339;2016;    1811;    1336;     474;       0;     474;       1
7646;A028725;GM0339;2017;    1821;    1351;     469;       0;     469;       1
7647;A028725;GM0339;2018;    1904;    1421;     482;       0;     482;       1
7648;A028725;GM0339;2019;    1942;    1454;     480;       0;     480;       8
7649;A028725;GM0339;2020;    2039;    1528;     503;       0;     503;       8
7650;A028725;GM1667;2012;    4794;    3765;    1024;     646;     378;       5
7651;A028725;GM1667;2013;    4851;    3803;    1044;     688;     356;       4
7652;A028725;GM1667;2014;    4924;    3830;    1064;     673;     391;      30
7653;A028725;GM1667;2015;    5009;    3910;    1070;     666;     404;      29
7654;A028725;GM1667;2016;    5046;    3956;    1046;     680;     366;      44
7655;A028725;GM1667;2017;    5085;    3980;    1073;     690;     383;      32
7656;A028725;GM1667;2018;    5149;    4075;    1043;     694;     349;      31
7657;A028725;GM1667;2019;    5181;    4075;    1103;     702;     401;       3
7658;A028725;GM1667;2020;    5250;    4129;    1117;     721;     396;       4
7659;A028725;GM0275;2012;   19199;   10561;    8559;    5997;    2562;      79
7660;A028725;GM0275;2013;   19342;   10579;    8685;    6042;    2643;      78
7661;A028725;GM0275;2014;   19846;   10586;    8889;    5890;    2999;     371
7662;A028725;GM0275;2015;   19906;   10614;    8966;    5868;    3098;     326
7663;A028725;GM0275;2016;   20052;   10669;    8989;    5992;    2997;     394
7664;A028725;GM0275;2017;   20143;   10666;    9090;    6117;    2973;     387
7665;A028725;GM0275;2018;   20176;   11021;    8765;    6078;    2687;     390
7666;A028725;GM0275;2019;   20287;   11279;    8791;    6044;    2747;     217
7667;A028725;GM0275;2020;   20324;   11312;    8781;    6012;    2769;     231
7668;A028725;GM0340;2012;    7180;    4589;    2578;    2058;     520;      13
7669;A028725;GM0340;2013;    7190;    4605;    2576;    2053;     523;       9
7670;A028725;GM0340;2014;    7306;    4613;    2637;    2075;     562;      56
7671;A028725;GM0340;2015;    7383;    4698;    2667;    2090;     577;      18
7672;A028725;GM0340;2016;    7435;    4740;    2675;    2079;     596;      20
7673;A028725;GM0340;2017;    7630;    4855;    2771;    2156;     615;       4
7674;A028725;GM0340;2018;    7759;    4999;    2742;    2168;     574;      18
7675;A028725;GM0340;2019;    7847;    5089;    2745;    2171;     574;      13
7676;A028725;GM0340;2020;    7964;    5181;    2764;    2191;     573;      19
7677;A028725;GM0597;2012;   19264;   10372;    8884;    7827;    1057;       8
7678;A028725;GM0597;2013;   19888;   10573;    9306;    8117;    1189;       9
7679;A028725;GM0597;2014;   20052;   10580;    9337;    8097;    1240;     135
7680;A028725;GM0597;2015;   20122;   10605;    9409;    8154;    1255;     108
7681;A028725;GM0597;2016;   20021;   10714;    9208;    7979;    1229;      99
7682;A028725;GM0597;2017;   20132;   10805;    9212;    7973;    1239;     115
7683;A028725;GM0597;2018;   20380;   11142;    9156;    8119;    1037;      82
7684;A028725;GM0597;2019;   20393;   11590;    8782;    7991;     791;      21
7685;A028725;GM0597;2020;   20461;   11628;    8812;    8005;     807;      21
7686;A028725;GM0196;2012;    4476;    2855;    1615;    1391;     224;       6
7687;A028725;GM0196;2013;    4508;    2855;    1652;    1401;     251;       1
7688;A028725;GM0196;2014;    4580;    2839;    1738;    1409;     329;       3
7689;A028725;GM0196;2015;    4591;    2834;    1753;    1419;     334;       4
7690;A028725;GM0196;2016;    4608;    2844;    1761;    1428;     333;       3
7691;A028725;GM0196;2017;    4627;    2866;    1756;    1426;     330;       5
7692;A028725;GM0196;2018;;;;;;
7693;A028725;GM0196;2019;;;;;;
7694;A028725;GM0196;2020;;;;;;
7695;A028725;GM1672;2012;    7166;    4736;    2416;    1767;     649;      14
7696;A028725;GM1672;2013;    7267;    4779;    2481;    1809;     672;       7
7697;A028725;GM1672;2014;;;;;;
7698;A028725;GM1672;2015;;;;;;
7699;A028725;GM1672;2016;;;;;;
7700;A028725;GM1672;2017;;;;;;
7701;A028725;GM1672;2018;;;;;;
7702;A028725;GM1672;2019;;;;;;
7703;A028725;GM1672;2020;;;;;;
7704;A028725;GM1742;2012;   13311;    9445;    3853;    3045;     808;      13
7705;A028725;GM1742;2013;   13448;    9512;    3858;    3038;     820;      78
7706;A028725;GM1742;2014;   13558;    9541;    3948;    3047;     901;      69
7707;A028725;GM1742;2015;   13653;    9615;    3977;    3055;     922;      61
7708;A028725;GM1742;2016;   13799;    9655;    4050;    3038;    1012;      94
7709;A028725;GM1742;2017;   13916;    9660;    4165;    3045;    1120;      91
7710;A028725;GM1742;2018;   14114;    9807;    4246;    3050;    1196;      61
7711;A028725;GM1742;2019;   14276;    9945;    4290;    3090;    1200;      41
7712;A028725;GM1742;2020;   14297;    9943;    4322;    3091;    1231;      32
7713;A028725;GM0603;2012;   23110;   10755;   12289;    8502;    3787;      66
7714;A028725;GM0603;2013;   23380;   10848;   12466;    8581;    3885;      66
7715;A028725;GM0603;2014;   23697;   10852;   12553;    8433;    4120;     292
7716;A028725;GM0603;2015;   23926;   11067;   12665;    8676;    3989;     194
7717;A028725;GM0603;2016;   24373;   11295;   12813;    8751;    4062;     265
7718;A028725;GM0603;2017;   24787;   11676;   12855;    8773;    4082;     256
7719;A028725;GM0603;2018;   25077;   12030;   12899;    8756;    4143;     148
7720;A028725;GM0603;2019;   25434;   12601;   12655;    8850;    3805;     178
7721;A028725;GM0603;2020;   25713;   12717;   12935;    8858;    4077;      61
7722;A028725;GM1669;2012;    8639;    6486;    2149;    1648;     501;       4
7723;A028725;GM1669;2013;    8788;    6596;    2179;    1635;     544;      13
7724;A028725;GM1669;2014;    8894;    6599;    2187;    1620;     567;     108
7725;A028725;GM1669;2015;    8933;    6634;    2194;    1627;     567;     105
7726;A028725;GM1669;2016;    8974;    6619;    2249;    1617;     632;     106
7727;A028725;GM1669;2017;    9017;    6634;    2277;    1601;     676;     106
7728;A028725;GM1669;2018;    9063;    6769;    2184;    1578;     606;     110
7729;A028725;GM1669;2019;    9104;    6795;    2296;    1601;     695;      13
7730;A028725;GM1669;2020;    9128;    6814;    2303;    1588;     715;      11
7731;A028725;GM0957;2012;   24800;   13415;   11346;    8164;    3182;      39
7732;A028725;GM0957;2013;   25066;   13522;   11528;    8276;    3252;      16
7733;A028725;GM0957;2014;   25378;   13897;   11444;    8414;    3030;      37
7734;A028725;GM0957;2015;   25583;   13941;   11588;    8516;    3072;      54
7735;A028725;GM0957;2016;   25812;   13963;   11806;    8576;    3230;      43
7736;A028725;GM0957;2017;   26045;   14142;   11852;    8576;    3276;      51
7737;A028725;GM0957;2018;   26142;   14201;   11883;    8362;    3521;      58
7738;A028725;GM0957;2019;   26279;   14588;   11644;    8259;    3385;      47
7739;A028725;GM0957;2020;   26432;   14714;   11616;    8121;    3495;     102
7740;A028725;GM0736;2012;   16410;   10793;    5527;    4160;    1367;      90
7741;A028725;GM0736;2013;   16708;   10968;    5666;    4246;    1420;      74
7742;A028725;GM0736;2014;   16720;   10954;    5681;    4268;    1413;      85
7743;A028725;GM0736;2015;   16740;   11032;    5629;    4211;    1418;      79
7744;A028725;GM0736;2016;   16842;   11075;    5690;    4223;    1467;      77
7745;A028725;GM0736;2017;   16948;   11021;    5848;    4177;    1671;      79
7746;A028725;GM0736;2018;   17372;   11432;    5854;    4250;    1604;      86
7747;A028725;GM0736;2019;   17596;   11743;    5835;    4311;    1524;      18
7748;A028725;GM0736;2020;   17783;   11826;    5941;    4320;    1621;      16
7749;A028725;GM1674;2012;   32448;   20773;   11578;    9398;    2180;      97
7750;A028725;GM1674;2013;   32564;   20912;   11582;    9439;    2143;      70
7751;A028725;GM1674;2014;   32723;   20807;   11850;    9478;    2372;      66
7752;A028725;GM1674;2015;   32934;   20803;   12084;    9626;    2458;      47
7753;A028725;GM1674;2016;   33331;   20825;   12290;    9700;    2590;     216
7754;A028725;GM1674;2017;   33507;   20859;   12422;    9709;    2713;     226
7755;A028725;GM1674;2018;   33745;   20786;   12705;    9623;    3082;     254
7756;A028725;GM1674;2019;   33817;   21430;   12357;    9629;    2728;      30
7757;A028725;GM1674;2020;   33950;   21472;   12442;    9658;    2784;      36
7758;A028725;GM0599;2012;  283143;   99955;  181214;  135659;   45555;    1974
7759;A028725;GM0599;2013;  285183;  100961;  182611;  134003;   48608;    1611
7760;A028725;GM0599;2014;  286238;  101875;  182845;  132987;   49858;    1518
7761;A028725;GM0599;2015;  289480;  102746;  185310;  136219;   49091;    1424
7762;A028725;GM0599;2016;  291854;  102714;  187232;  133435;   53797;    1908
7763;A028725;GM0599;2017;  291877;  103084;  187339;  133095;   54244;    1454
7764;A028725;GM0599;2018;  293578;  103161;  188487;  133142;   55345;    1930
7765;A028725;GM0599;2019;  294678;  106453;  187002;  134196;   52806;    1223
7766;A028725;GM0599;2020;  297713;  106639;  189809;  134532;   55277;    1265
7767;A028725;GM0277;2012;     606;     532;      74;      46;      28;       0
7768;A028725;GM0277;2013;     601;     523;      78;      46;      32;       0
7769;A028725;GM0277;2014;     608;     525;      83;      46;      37;       0
7770;A028725;GM0277;2015;     616;     534;      82;      46;      36;       0
7771;A028725;GM0277;2016;     609;     533;      76;      44;      32;       0
7772;A028725;GM0277;2017;     615;     534;      81;      46;      35;       0
7773;A028725;GM0277;2018;     634;     544;      74;      44;      30;      16
7774;A028725;GM0277;2019;     658;     574;      79;      46;      33;       5
7775;A028725;GM0277;2020;     671;     594;      73;      46;      27;       4
7776;A028725;GM0840;2012;    8860;    5875;    2973;    2682;     291;      12
7777;A028725;GM0840;2013;    8935;    5886;    2988;    2684;     304;      61
7778;A028725;GM0840;2014;    9138;    6013;    3035;    2684;     351;      90
7779;A028725;GM0840;2015;    9171;    6055;    3107;    2798;     309;       9
7780;A028725;GM0840;2016;    9210;    6089;    3055;    2662;     393;      66
7781;A028725;GM0840;2017;    9277;    6135;    3076;    2691;     385;      66
7782;A028725;GM0840;2018;    9305;    6110;    3169;    2778;     391;      26
7783;A028725;GM0840;2019;    9396;    6227;    3162;    2765;     397;       7
7784;A028725;GM0840;2020;    9522;    6282;    3231;    2802;     429;       9
7785;A028725;GM0441;2012;    8090;    4998;    3088;    2400;     688;       4
7786;A028725;GM0441;2013;   18625;   12792;    5820;    4419;    1401;      13
7787;A028725;GM0441;2014;   18772;   12804;    5820;    4376;    1444;     148
7788;A028725;GM0441;2015;   19003;   13011;    5848;    4363;    1485;     144
7789;A028725;GM0441;2016;   19078;   13116;    5829;    4351;    1478;     133
7790;A028725;GM0441;2017;   19311;   13250;    5923;    4347;    1576;     138
7791;A028725;GM0441;2018;   19439;   13383;    5910;    4371;    1539;     146
7792;A028725;GM0441;2019;   19579;   13652;    5770;    4394;    1376;     157
7793;A028725;GM0441;2020;   19650;   13721;    5777;    4393;    1384;     152
7794;A028725;GM0458;2012;    2057;    1542;     510;     363;     147;       5
7795;A028725;GM0458;2013;    2085;    1571;     509;     351;     158;       5
7796;A028725;GM0458;2014;    2095;    1570;     523;     353;     170;       2
7797;A028725;GM0458;2015;;;;;;
7798;A028725;GM0458;2016;;;;;;
7799;A028725;GM0458;2017;;;;;;
7800;A028725;GM0458;2018;;;;;;
7801;A028725;GM0458;2019;;;;;;
7802;A028725;GM0458;2020;;;;;;
7803;A028725;GM0279;2012;    3451;    2501;     947;     638;     309;       3
7804;A028725;GM0279;2013;    3497;    2512;     975;     640;     335;      10
7805;A028725;GM0279;2014;    3570;    2556;    1003;     643;     360;      11
7806;A028725;GM0279;2015;    3584;    2591;     984;     623;     361;       9
7807;A028725;GM0279;2016;    3605;    2585;    1018;     626;     392;       2
7808;A028725;GM0279;2017;    3679;    2620;    1054;     642;     412;       5
7809;A028725;GM0279;2018;    3730;    2718;     966;     632;     334;      46
7810;A028725;GM0279;2019;    3820;    2815;     992;     660;     332;      13
7811;A028725;GM0279;2020;    3858;    2817;    1037;     685;     352;       4
7812;A028725;GM0606;2012;   33649;   16767;   16873;   12140;    4733;       9
7813;A028725;GM0606;2013;   33820;   16872;   16944;   12063;    4881;       4
7814;A028725;GM0606;2014;   33988;   16873;   17113;   12109;    5004;       2
7815;A028725;GM0606;2015;   34266;   16808;   17440;   12201;    5239;      18
7816;A028725;GM0606;2016;   34472;   16929;   17517;   12195;    5322;      26
7817;A028725;GM0606;2017;   34634;   16943;   17672;   12097;    5575;      19
7818;A028725;GM0606;2018;   34770;   17092;   17635;   11739;    5896;      43
7819;A028725;GM0606;2019;   34669;   17609;   16987;   11468;    5519;      73
7820;A028725;GM0606;2020;   34934;   17756;   17088;   11328;    5760;      90
7821;A028725;GM0088;2012;     415;     213;     200;     141;      59;       2
7822;A028725;GM0088;2013;     424;     213;     209;     146;      63;       2
7823;A028725;GM0088;2014;     433;     232;     199;     142;      57;       2
7824;A028725;GM0088;2015;     435;     234;     198;     136;      62;       3
7825;A028725;GM0088;2016;     438;     234;     202;     138;      64;       2
7826;A028725;GM0088;2017;     441;     238;     202;     134;      68;       1
7827;A028725;GM0088;2018;     440;     244;     193;     131;      62;       3
7828;A028725;GM0088;2019;     448;     251;     194;     138;      56;       3
7829;A028725;GM0088;2020;     448;     251;     194;     139;      55;       3
7830;A028725;GM0844;2012;    8967;    6074;    2778;    2233;     545;     115
7831;A028725;GM0844;2013;    9225;    6272;    2903;    2299;     604;      50
7832;A028725;GM0844;2014;    9415;    6359;    2954;    2320;     634;     102
7833;A028725;GM0844;2015;    9505;    6400;    3015;    2363;     652;      90
7834;A028725;GM0844;2016;    9605;    6445;    3082;    2419;     663;      78
7835;A028725;GM0844;2017;;;;;;
7836;A028725;GM0844;2018;;;;;;
7837;A028725;GM0844;2019;;;;;;
7838;A028725;GM0844;2020;;;;;;
7839;A028725;GM0962;2012;    5476;    4133;    1334;     915;     419;       9
7840;A028725;GM0962;2013;    5479;    4148;    1325;     906;     419;       6
7841;A028725;GM0962;2014;    5476;    4155;    1319;     890;     429;       2
7842;A028725;GM0962;2015;    5505;    3991;    1514;     960;     554;       0
7843;A028725;GM0962;2016;    5552;    4019;    1531;     977;     554;       2
7844;A028725;GM0962;2017;    5599;    4060;    1538;     978;     560;       1
7845;A028725;GM0962;2018;    5592;    4212;    1372;     946;     426;       8
7846;A028725;GM0962;2019;;;;;;
7847;A028725;GM0962;2020;;;;;;
7848;A028725;GM0608;2012;    4836;    2856;    1970;    1627;     343;      10
7849;A028725;GM0608;2013;    4845;    2832;    2004;    1614;     390;       9
7850;A028725;GM0608;2014;    4916;    2860;    2049;    1665;     384;       7
7851;A028725;GM0608;2015;;;;;;
7852;A028725;GM0608;2016;;;;;;
7853;A028725;GM0608;2017;;;;;;
7854;A028725;GM0608;2018;;;;;;
7855;A028725;GM0608;2019;;;;;;
7856;A028725;GM0608;2020;;;;;;
7857;A028725;GM1676;2012;   14204;    9304;    4878;    4029;     849;      22
7858;A028725;GM1676;2013;   14426;    9477;    4928;    4029;     899;      21
7859;A028725;GM1676;2014;   14455;    9546;    4870;    3975;     895;      39
7860;A028725;GM1676;2015;   14626;    9597;    4986;    4026;     960;      43
7861;A028725;GM1676;2016;   14640;    9659;    4962;    4034;     928;      19
7862;A028725;GM1676;2017;   14744;    9684;    5036;    4068;     968;      24
7863;A028725;GM1676;2018;   14789;    9828;    4934;    4024;     910;      27
7864;A028725;GM1676;2019;   14862;   10046;    4787;    4002;     785;      29
7865;A028725;GM1676;2020;   14980;   10142;    4803;    3986;     817;      35
7866;A028725;GM0965;2012;    4606;    3013;    1586;    1187;     399;       7
7867;A028725;GM0965;2013;    4695;    3052;    1642;    1218;     424;       1
7868;A028725;GM0965;2014;    4784;    2957;    1824;    1248;     576;       3
7869;A028725;GM0965;2015;    4798;    2959;    1833;    1205;     628;       6
7870;A028725;GM0965;2016;    4779;    2970;    1804;    1211;     593;       5
7871;A028725;GM0965;2017;    4725;    2969;    1755;    1182;     573;       1
7872;A028725;GM0965;2018;    4756;    3106;    1646;    1202;     444;       4
7873;A028725;GM0965;2019;    4809;    3165;    1623;    1174;     449;      21
7874;A028725;GM0965;2020;    4836;    3151;    1666;    1195;     471;      19
7875;A028725;GM1702;2012;    4409;    3413;     967;     771;     196;      29
7876;A028725;GM1702;2013;    4420;    3426;     980;     757;     223;      14
7877;A028725;GM1702;2014;    4457;    3463;     989;     755;     234;       5
7878;A028725;GM1702;2015;    4483;    3463;    1003;     746;     257;      17
7879;A028725;GM1702;2016;    4496;    3465;    1014;     739;     275;      17
7880;A028725;GM1702;2017;    4582;    3477;    1051;     730;     321;      54
7881;A028725;GM1702;2018;    4591;    3481;    1051;     726;     325;      59
7882;A028725;GM1702;2019;    4607;    3534;    1072;     723;     349;       1
7883;A028725;GM1702;2020;    4655;    3558;    1092;     726;     366;       5
7884;A028725;GM0845;2012;   10747;    8256;    2477;    1747;     730;      14
7885;A028725;GM0845;2013;   10808;    8287;    2509;    1751;     758;      12
7886;A028725;GM0845;2014;   10953;    8315;    2613;    1806;     807;      25
7887;A028725;GM0845;2015;   11145;    8410;    2700;    1859;     841;      35
7888;A028725;GM0845;2016;   11200;    8458;    2709;    1884;     825;      33
7889;A028725;GM0845;2017;   11214;    8457;    2725;    1891;     834;      32
7890;A028725;GM0845;2018;   11368;    8717;    2625;    1918;     707;      26
7891;A028725;GM0845;2019;   11542;    8790;    2746;    1926;     820;       6
7892;A028725;GM0845;2020;   11647;    8863;    2777;    1930;     847;       7
7893;A028725;GM0846;2012;    7081;    5116;    1852;    1327;     525;     113
7894;A028725;GM0846;2013;    6994;    5125;    1863;    1309;     554;       6
7895;A028725;GM0846;2014;    7033;    5104;    1920;    1331;     589;       9
7896;A028725;GM0846;2015;    7077;    5141;    1916;    1321;     595;      20
7897;A028725;GM0846;2016;    7155;    5189;    1950;    1339;     611;      16
7898;A028725;GM0846;2017;;;;;;
7899;A028725;GM0846;2018;;;;;;
7900;A028725;GM0846;2019;;;;;;
7901;A028725;GM0846;2020;;;;;;
7902;A028725;GM1883;2012;   42494;   25131;   17222;   12641;    4581;     141
7903;A028725;GM1883;2013;   42651;   25106;   17438;   12587;    4851;     107
7904;A028725;GM1883;2014;   42984;   25394;   17285;   12535;    4750;     305
7905;A028725;GM1883;2015;   43550;   25437;   17743;   12929;    4814;     370
7906;A028725;GM1883;2016;   43810;   25443;   17972;   12910;    5062;     395
7907;A028725;GM1883;2017;   44001;   25544;   18076;   12883;    5193;     381
7908;A028725;GM1883;2018;   44161;   25955;   17789;   12745;    5044;     417
7909;A028725;GM1883;2019;   44315;   26354;   17827;   12920;    4907;     134
7910;A028725;GM1883;2020;   44348;   26311;   17894;   12784;    5110;     143
7911;A028725;GM0051;2012;   11104;    7470;    3454;    2806;     648;     180
7912;A028725;GM0051;2013;   11126;    7508;    3502;    2791;     711;     116
7913;A028725;GM0051;2014;;;;;;
7914;A028725;GM0051;2015;;;;;;
7915;A028725;GM0051;2016;;;;;;
7916;A028725;GM0051;2017;;;;;;
7917;A028725;GM0051;2018;;;;;;
7918;A028725;GM0051;2019;;;;;;
7919;A028725;GM0051;2020;;;;;;
7920;A028725;GM0610;2012;    9888;    5347;    4495;    3872;     623;      46
7921;A028725;GM0610;2013;    9944;    5401;    4526;    3834;     692;      17
7922;A028725;GM0610;2014;    9976;    5471;    4489;    3704;     785;      16
7923;A028725;GM0610;2015;   10129;    5553;    4529;    3856;     673;      47
7924;A028725;GM0610;2016;   10222;    5663;    4500;    3755;     745;      59
7925;A028725;GM0610;2017;   10322;    5757;    4495;    3760;     735;      70
7926;A028725;GM0610;2018;   10295;    5889;    4322;    3724;     598;      84
7927;A028725;GM0610;2019;   10317;    5994;    4298;    3678;     620;      25
7928;A028725;GM0610;2020;   10413;    6069;    4336;    3685;     651;       8
7929;A028725;GM0040;2012;    6185;    4599;    1577;    1232;     345;       9
7930;A028725;GM0040;2013;    6259;    4682;    1568;    1217;     351;       9
7931;A028725;GM0040;2014;    6292;    4696;    1587;    1214;     373;       9
7932;A028725;GM0040;2015;    6322;    4705;    1612;    1203;     409;       5
7933;A028725;GM0040;2016;    6422;    4797;    1620;    1196;     424;       5
7934;A028725;GM0040;2017;    6139;    4567;    1566;    1182;     384;       6
7935;A028725;GM0040;2018;;;;;;
7936;A028725;GM0040;2019;;;;;;
7937;A028725;GM0040;2020;;;;;;
7938;A028725;GM1714;2012;   10993;    7759;    3226;    2366;     860;       8
7939;A028725;GM1714;2013;   10961;    7738;    3218;    2338;     880;       5
7940;A028725;GM1714;2014;   11046;    7631;    3292;    2342;     950;     123
7941;A028725;GM1714;2015;   11069;    7669;    3263;    2304;     959;     137
7942;A028725;GM1714;2016;   11119;    7710;    3272;    2306;     966;     137
7943;A028725;GM1714;2017;   11095;    7651;    3313;    2309;    1004;     131
7944;A028725;GM1714;2018;   11070;    7751;    3183;    2260;     923;     136
7945;A028725;GM1714;2019;   11054;    7813;    3091;    2213;     878;     150
7946;A028725;GM1714;2020;   10988;    7748;    3068;    2154;     914;     172
7947;A028725;GM0090;2012;   23438;   14272;    9137;    7691;    1446;      29
7948;A028725;GM0090;2013;   23642;   14326;    9287;    7808;    1479;      29
7949;A028725;GM0090;2014;   24062;   14366;    9503;    7887;    1616;     193
7950;A028725;GM0090;2015;   24163;   14374;    9588;    7854;    1734;     201
7951;A028725;GM0090;2016;   24286;   14419;    9587;    7730;    1857;     280
7952;A028725;GM0090;2017;   24481;   14555;    9627;    7801;    1826;     299
7953;A028725;GM0090;2018;   24681;   14683;    9667;    7757;    1910;     331
7954;A028725;GM0090;2019;   24863;   15056;    9777;    7861;    1916;      30
7955;A028725;GM0090;2020;   24928;   15070;    9830;    7799;    2031;      28
7956;A028725;GM0342;2012;   19191;   12068;    7096;    4576;    2520;      27
7957;A028725;GM0342;2013;   19240;   12065;    7144;    4512;    2632;      31
7958;A028725;GM0342;2014;   19358;   12118;    7215;    4510;    2705;      25
7959;A028725;GM0342;2015;   19548;   12173;    7177;    4456;    2721;     198
7960;A028725;GM0342;2016;   19554;   12293;    7083;    4387;    2696;     178
7961;A028725;GM0342;2017;   19677;   12358;    7152;    4385;    2767;     167
7962;A028725;GM0342;2018;   19794;   12591;    7051;    4411;    2640;     152
7963;A028725;GM0342;2019;   19865;   12873;    6978;    4429;    2549;      14
7964;A028725;GM0342;2020;   20032;   12965;    6729;    4458;    2271;     338
7965;A028725;GM0847;2012;    6974;    4932;    2038;    1503;     535;       4
7966;A028725;GM0847;2013;    7058;    5025;    2029;    1484;     545;       4
7967;A028725;GM0847;2014;    7239;    5099;    2114;    1535;     579;      26
7968;A028725;GM0847;2015;    7482;    5212;    2263;    1643;     620;       7
7969;A028725;GM0847;2016;    7581;    5268;    2282;    1622;     660;      31
7970;A028725;GM0847;2017;    7641;    5327;    2277;    1609;     668;      37
7971;A028725;GM0847;2018;    7748;    5538;    2162;    1630;     532;      48
7972;A028725;GM0847;2019;    7849;    5670;    2162;    1640;     522;      17
7973;A028725;GM0847;2020;    7926;    5739;    2171;    1636;     535;      16
7974;A028725;GM0848;2012;    6158;    4672;    1484;     941;     543;       2
7975;A028725;GM0848;2013;    6463;    4778;    1684;    1121;     563;       1
7976;A028725;GM0848;2014;    6506;    4780;    1725;    1124;     601;       1
7977;A028725;GM0848;2015;    6669;    4851;    1816;    1197;     619;       2
7978;A028725;GM0848;2016;    6712;    4822;    1882;    1194;     688;       8
7979;A028725;GM0848;2017;    6768;    4848;    1898;    1156;     742;      22
7980;A028725;GM0848;2018;    6859;    5070;    1762;    1138;     624;      27
7981;A028725;GM0848;2019;    6891;    5155;    1715;    1149;     566;      21
7982;A028725;GM0848;2020;    6964;    5219;    1734;    1140;     594;      11
7983;A028725;GM0612;2012;   31426;   17307;   14114;   13050;    1064;       5
7984;A028725;GM0612;2013;   31797;   17463;   14329;   13110;    1219;       5
7985;A028725;GM0612;2014;   32313;   17771;   14534;   13127;    1407;       8
7986;A028725;GM0612;2015;;;;;;
7987;A028725;GM0612;2016;;;;;;
7988;A028725;GM0612;2017;;;;;;
7989;A028725;GM0612;2018;;;;;;
7990;A028725;GM0612;2019;;;;;;
7991;A028725;GM0612;2020;;;;;;
7992;A028725;GM0037;2012;   13960;    8654;    5292;    4489;     803;      14
7993;A028725;GM0037;2013;   14151;    8686;    5460;    4621;     839;       5
7994;A028725;GM0037;2014;   14379;    8707;    5524;    4627;     897;     148
7995;A028725;GM0037;2015;   14351;    8728;    5488;    4589;     899;     135
7996;A028725;GM0037;2016;   14368;    8720;    5500;    4478;    1022;     148
7997;A028725;GM0037;2017;   14412;    8771;    5505;    4472;    1033;     136
7998;A028725;GM0037;2018;   14445;    8692;    5596;    4484;    1112;     157
7999;A028725;GM0037;2019;   14489;    8852;    5596;    4497;    1099;      41
8000;A028725;GM0037;2020;   14483;    8842;    5579;    4450;    1129;      62
8001;A028725;GM0180;2012;    5086;    3882;    1190;     588;     602;      14
8002;A028725;GM0180;2013;    5106;    3926;    1173;     586;     587;       7
8003;A028725;GM0180;2014;    5214;    3998;    1210;     601;     609;       6
8004;A028725;GM0180;2015;    5344;    4097;    1240;     610;     630;       7
8005;A028725;GM0180;2016;    5404;    4133;    1258;     620;     638;      13
8006;A028725;GM0180;2017;    5472;    4166;    1290;     620;     670;      16
8007;A028725;GM0180;2018;    5522;    4310;    1197;     630;     567;      15
8008;A028725;GM0180;2019;    5596;    4332;    1255;     632;     623;       9
8009;A028725;GM0180;2020;    5648;    4378;    1260;     641;     619;      10
8010;A028725;GM0532;2012;    8595;    6042;    2543;    2121;     422;      10
8011;A028725;GM0532;2013;    8626;    6078;    2540;    2105;     435;       8
8012;A028725;GM0532;2014;    8740;    6060;    2673;    2167;     506;       7
8013;A028725;GM0532;2015;    8803;    6101;    2678;    2292;     386;      24
8014;A028725;GM0532;2016;    8853;    6129;    2719;    2303;     416;       5
8015;A028725;GM0532;2017;    8878;    6142;    2729;    2288;     441;       7
8016;A028725;GM0532;2018;    8931;    6255;    2668;    2271;     397;       8
8017;A028725;GM0532;2019;    9004;    6324;    2674;    2337;     337;       6
8018;A028725;GM0532;2020;    9034;    6303;    2725;    2323;     402;       6
8019;A028725;GM0851;2012;    9440;    6366;    3062;    2296;     766;      12
8020;A028725;GM0851;2013;    9514;    6420;    3083;    2326;     757;      11
8021;A028725;GM0851;2014;    9514;    6414;    3090;    2310;     780;      10
8022;A028725;GM0851;2015;    9557;    6304;    3250;    2368;     882;       3
8023;A028725;GM0851;2016;    9578;    6463;    3096;    2291;     805;      19
8024;A028725;GM0851;2017;    9720;    6489;    3202;    2327;     875;      29
8025;A028725;GM0851;2018;    9768;    6748;    3000;    2353;     647;      20
8026;A028725;GM0851;2019;    9865;    6900;    2958;    2365;     593;       7
8027;A028725;GM0851;2020;    9980;    7000;    2973;    2350;     623;       7
8028;A028725;GM1708;2012;   18055;   11413;    6525;    5136;    1389;     117
8029;A028725;GM1708;2013;   18144;   11502;    6589;    5086;    1503;      53
8030;A028725;GM1708;2014;   18252;   11574;    6631;    5096;    1535;      47
8031;A028725;GM1708;2015;   18333;   11623;    6663;    5105;    1558;      47
8032;A028725;GM1708;2016;   18344;   11684;    6610;    5037;    1573;      50
8033;A028725;GM1708;2017;   18504;   11748;    6710;    5100;    1610;      46
8034;A028725;GM1708;2018;   18723;   11996;    6672;    5070;    1602;      55
8035;A028725;GM1708;2019;   18806;   12328;    6434;    5120;    1314;      44
8036;A028725;GM1708;2020;   18976;   12460;    6473;    5061;    1412;      43
8037;A028725;GM0971;2012;   10904;    7988;    2912;    2438;     474;       4
8038;A028725;GM0971;2013;   10924;    8028;    2890;    2405;     485;       6
8039;A028725;GM0971;2014;   11097;    7973;    3081;    2429;     652;      43
8040;A028725;GM0971;2015;   11109;    7960;    3102;    2366;     736;      47
8041;A028725;GM0971;2016;   11165;    7950;    3170;    2465;     705;      45
8042;A028725;GM0971;2017;   11251;    7951;    3257;    2457;     800;      43
8043;A028725;GM0971;2018;   11283;    8101;    3132;    2501;     631;      50
8044;A028725;GM0971;2019;   11326;    8187;    3112;    2493;     619;      27
8045;A028725;GM0971;2020;   11387;    8227;    3147;    2502;     645;      13
8046;A028725;GM1904;2012;   25056;   16234;    8589;    6387;    2202;     233
8047;A028725;GM1904;2013;   25269;   16427;    8674;    6384;    2290;     168
8048;A028725;GM1904;2014;   25750;   16569;    8990;    6214;    2776;     191
8049;A028725;GM1904;2015;   25898;   16753;    8965;    6226;    2739;     180
8050;A028725;GM1904;2016;   26111;   16954;    8998;    6228;    2770;     159
8051;A028725;GM1904;2017;   26456;   17320;    9000;    6193;    2807;     136
8052;A028725;GM1904;2018;   26667;   17560;    8953;    6207;    2746;     154
8053;A028725;GM1904;2019;   26676;   17721;    8865;    6215;    2650;      90
8054;A028725;GM1904;2020;   27096;   17902;    9127;    6216;    2911;      67
8055;A028725;GM0617;2012;    3675;    2450;    1218;    1084;     134;       7
8056;A028725;GM0617;2013;    3667;    2480;    1181;    1035;     146;       6
8057;A028725;GM0617;2014;    3678;    2501;    1172;    1011;     161;       5
8058;A028725;GM0617;2015;    3723;    2533;    1185;    1022;     163;       5
8059;A028725;GM0617;2016;    3768;    2565;    1198;    1042;     156;       5
8060;A028725;GM0617;2017;    3800;    2582;    1214;    1041;     173;       4
8061;A028725;GM0617;2018;    3808;    2621;    1183;    1024;     159;       4
8062;A028725;GM0617;2019;;;;;;
8063;A028725;GM0617;2020;;;;;;
8064;A028725;GM1900;2012;   33922;   21556;   12282;   10234;    2048;      84
8065;A028725;GM1900;2013;   34976;   22357;   12527;   10256;    2271;      92
8066;A028725;GM1900;2014;   35795;   22901;   12807;   10350;    2457;      87
8067;A028725;GM1900;2015;   36418;   23061;   12844;   10328;    2516;     513
8068;A028725;GM1900;2016;   36578;   23200;   12828;   10214;    2614;     550
8069;A028725;GM1900;2017;   36782;   23397;   12812;   10133;    2679;     573
8070;A028725;GM1900;2018;   39220;   25598;   13039;   10493;    2546;     583
8071;A028725;GM1900;2019;   39605;   25999;   13530;   10842;    2688;      76
8072;A028725;GM1900;2020;   39796;   26193;   13555;   10762;    2793;      48
8073;A028725;GM0715;2012;   24127;   16865;    7259;    5058;    2201;       3
8074;A028725;GM0715;2013;   24319;   16924;    7393;    5131;    2262;       2
8075;A028725;GM0715;2014;   24461;   16774;    7655;    5124;    2531;      32
8076;A028725;GM0715;2015;   24599;   16994;    7570;    5143;    2427;      35
8077;A028725;GM0715;2016;   24862;   17049;    7557;    5120;    2437;     256
8078;A028725;GM0715;2017;   24993;   17000;    7723;    5123;    2600;     270
8079;A028725;GM0715;2018;   25019;   17358;    7406;    5040;    2366;     255
8080;A028725;GM0715;2019;   25140;   17523;    7255;    4949;    2306;     362
8081;A028725;GM0715;2020;   25129;   17540;    7167;    4883;    2284;     422
8082;A028725;GM0093;2012;    1890;    1190;     684;     434;     250;      16
8083;A028725;GM0093;2013;    1914;    1179;     689;     445;     244;      46
8084;A028725;GM0093;2014;    1921;    1216;     675;     408;     267;      30
8085;A028725;GM0093;2015;    1944;    1229;     689;     409;     280;      26
8086;A028725;GM0093;2016;    1959;    1227;     696;       0;     696;      36
8087;A028725;GM0093;2017;    1960;    1233;     694;       1;     693;      33
8088;A028725;GM0093;2018;    2028;    1287;     684;     399;     285;      57
8089;A028725;GM0093;2019;    2048;    1306;     737;     426;     311;       5
8090;A028725;GM0093;2020;    2062;    1313;     747;     424;     323;       2
8091;A028725;GM0448;2012;    5789;    3909;    1875;    1297;     578;       5
8092;A028725;GM0448;2013;    5827;    3916;    1906;    1283;     623;       5
8093;A028725;GM0448;2014;    5912;    3913;    1902;    1268;     634;      97
8094;A028725;GM0448;2015;    5928;    3934;    1896;    1251;     645;      98
8095;A028725;GM0448;2016;    5998;    3989;    1904;    1238;     666;     105
8096;A028725;GM0448;2017;    6001;    3991;    1915;    1277;     638;      95
8097;A028725;GM0448;2018;    6085;    4113;    1868;    1321;     547;     104
8098;A028725;GM0448;2019;    6127;    4171;    1919;    1336;     583;      37
8099;A028725;GM0448;2020;    6191;    4188;    1966;    1347;     619;      37
8100;A028725;GM1525;2012;   13759;    9039;    4660;    3391;    1269;      60
8101;A028725;GM1525;2013;   13800;    9028;    4739;    3397;    1342;      33
8102;A028725;GM1525;2014;   14037;    9149;    4797;    3392;    1405;      91
8103;A028725;GM1525;2015;   14103;    9213;    4819;    3400;    1419;      71
8104;A028725;GM1525;2016;   14403;    9355;    4967;    3473;    1494;      81
8105;A028725;GM1525;2017;   14540;    9507;    4970;    3463;    1507;      63
8106;A028725;GM1525;2018;   14982;    9780;    5136;    3538;    1598;      66
8107;A028725;GM1525;2019;   15085;    9952;    4964;    3514;    1450;     169
8108;A028725;GM1525;2020;   15469;   10211;    5124;    3556;    1568;     134
8109;A028725;GM0716;2012;    9787;    6898;    2886;    2459;     427;       3
8110;A028725;GM0716;2013;    9830;    6901;    2927;    2455;     472;       2
8111;A028725;GM0716;2014;    9936;    6898;    2972;    2448;     524;      66
8112;A028725;GM0716;2015;   10050;    6932;    3050;    2480;     570;      68
8113;A028725;GM0716;2016;   10063;    6936;    3051;    2476;     575;      76
8114;A028725;GM0716;2017;   10163;    7001;    3087;    2483;     604;      75
8115;A028725;GM0716;2018;   10231;    7154;    3003;    2475;     528;      74
8116;A028725;GM0716;2019;   10350;    7307;    3008;    2523;     485;      35
8117;A028725;GM0716;2020;   10399;    7367;    2992;    2499;     493;      40
8118;A028725;GM0281;2012;   16493;    9031;    7417;    6461;     956;      45
8119;A028725;GM0281;2013;   16757;    9223;    7461;    6477;     984;      73
8120;A028725;GM0281;2014;   16890;    9281;    7479;    6440;    1039;     130
8121;A028725;GM0281;2015;   16887;    9360;    7425;    6410;    1015;     102
8122;A028725;GM0281;2016;   17001;    9564;    7336;    6255;    1081;     101
8123;A028725;GM0281;2017;   17158;    9502;    7549;    6299;    1250;     107
8124;A028725;GM0281;2018;   17307;    9552;    7666;    6343;    1323;      89
8125;A028725;GM0281;2019;   17428;    9914;    7500;    6273;    1227;      14
8126;A028725;GM0281;2020;   17536;   10033;    7489;    6179;    1310;      14
8127;A028725;GM0855;2012;   87380;   47025;   40333;   30284;   10049;      22
8128;A028725;GM0855;2013;   87989;   47224;   40747;   30116;   10631;      18
8129;A028725;GM0855;2014;   89854;   47504;   42272;   31181;   11091;      78
8130;A028725;GM0855;2015;   91018;   47720;   43187;   31484;   11703;     111
8131;A028725;GM0855;2016;   92060;   48158;   43735;   31067;   12668;     167
8132;A028725;GM0855;2017;   92929;   48299;   44360;   31127;   13233;     270
8133;A028725;GM0855;2018;   94272;   48599;   45333;   31484;   13849;     340
8134;A028725;GM0855;2019;   95878;   49370;   46309;   31892;   14417;     199
8135;A028725;GM0855;2020;   97308;   49693;   47113;   32041;   15072;     502
8136;A028725;GM0183;2012;    7484;    5486;    1925;     947;     978;      73
8137;A028725;GM0183;2013;    7616;    5568;    1967;     970;     997;      81
8138;A028725;GM0183;2014;    7699;    5592;    2035;     993;    1042;      72
8139;A028725;GM0183;2015;    7725;    5642;    2011;     991;    1020;      72
8140;A028725;GM0183;2016;    7797;    5663;    2066;    1006;    1060;      68
8141;A028725;GM0183;2017;    7878;    5708;    2096;    1010;    1086;      74
8142;A028725;GM0183;2018;    7968;    5987;    1902;    1009;     893;      79
8143;A028725;GM0183;2019;    7968;    5793;    2140;    1025;    1115;      35
8144;A028725;GM0183;2020;    8058;    5856;    2146;    1037;    1109;      56
8145;A028725;GM1700;2012;   12283;    8100;    4148;    3506;     642;      35
8146;A028725;GM1700;2013;   12401;    8236;    4150;    3474;     676;      15
8147;A028725;GM1700;2014;   12783;    8363;    4279;    3481;     798;     141
8148;A028725;GM1700;2015;   12893;    8435;    4283;    3523;     760;     175
8149;A028725;GM1700;2016;   12961;    8498;    4292;    3431;     861;     171
8150;A028725;GM1700;2017;   12948;    8473;    4302;    3424;     878;     173
8151;A028725;GM1700;2018;   13038;    8610;    4253;    3462;     791;     175
8152;A028725;GM1700;2019;   13080;    8603;    4457;    3597;     860;      20
8153;A028725;GM1700;2020;   13153;    8683;    4449;    3538;     911;      21
8154;A028725;GM1730;2012;   13114;    9793;    3246;    2228;    1018;      75
8155;A028725;GM1730;2013;   13214;    9843;    3319;    2201;    1118;      52
8156;A028725;GM1730;2014;   13278;    9909;    3361;    2189;    1172;       8
8157;A028725;GM1730;2015;   13317;    9958;    3351;    2187;    1164;       8
8158;A028725;GM1730;2016;   13409;   10038;    3362;    2175;    1187;       9
8159;A028725;GM1730;2017;   13597;   10080;    3436;    2187;    1249;      81
8160;A028725;GM1730;2018;   13716;   10442;    3186;    2188;     998;      88
8161;A028725;GM1730;2019;   13871;   10669;    3144;    2197;     947;      58
8162;A028725;GM1730;2020;   14011;   10803;    3157;    2170;     987;      51
8163;A028725;GM0737;2012;   12668;    9202;    3439;    2773;     666;      27
8164;A028725;GM0737;2013;   12847;    9368;    3466;    2754;     712;      13
8165;A028725;GM0737;2014;   12993;    9391;    3530;    2645;     885;      72
8166;A028725;GM0737;2015;   13091;    9461;    3549;    2736;     813;      81
8167;A028725;GM0737;2016;   13184;    9503;    3593;    2710;     883;      88
8168;A028725;GM0737;2017;   13252;    9591;    3580;    2670;     910;      81
8169;A028725;GM0737;2018;   13298;    9687;    3533;    2655;     878;      78
8170;A028725;GM0737;2019;   13332;    9836;    3490;    2590;     900;       6
8171;A028725;GM0737;2020;   13535;    9912;    3606;    2634;     972;      17
8172;A028725;GM0282;2012;    3913;    2554;    1359;    1118;     241;       0
8173;A028725;GM0282;2013;    4023;    2609;    1414;    1131;     283;       0
8174;A028725;GM0282;2014;    4069;    2607;    1462;    1156;     306;       0
8175;A028725;GM0282;2015;;;;;;
8176;A028725;GM0282;2016;;;;;;
8177;A028725;GM0282;2017;;;;;;
8178;A028725;GM0282;2018;;;;;;
8179;A028725;GM0282;2019;;;;;;
8180;A028725;GM0282;2020;;;;;;
8181;A028725;GM0856;2012;   16635;   10635;    5982;    4849;    1133;      18
8182;A028725;GM0856;2013;   16868;   10772;    6084;    4883;    1201;      12
8183;A028725;GM0856;2014;   17178;   10860;    6170;    4885;    1285;     148
8184;A028725;GM0856;2015;   17405;   10941;    6248;    4842;    1406;     216
8185;A028725;GM0856;2016;   17575;   11052;    6313;    4896;    1417;     210
8186;A028725;GM0856;2017;   17727;   11152;    6363;    4889;    1474;     212
8187;A028725;GM0856;2018;   17987;   11338;    6432;    4946;    1486;     217
8188;A028725;GM0856;2019;   18164;   11419;    6735;    5181;    1554;      10
8189;A028725;GM0856;2020;   18470;   11495;    6964;    5281;    1683;      11
8190;A028725;GM0450;2012;    5045;    3604;    1430;    1193;     237;      11
8191;A028725;GM0450;2013;    5133;    3671;    1455;    1204;     251;       7
8192;A028725;GM0450;2014;    5318;    3719;    1548;    1249;     299;      51
8193;A028725;GM0450;2015;    5370;    3778;    1544;    1248;     296;      48
8194;A028725;GM0450;2016;    5412;    3817;    1546;    1245;     301;      49
8195;A028725;GM0450;2017;    5435;    3871;    1519;    1211;     308;      45
8196;A028725;GM0450;2018;    5487;    3981;    1446;    1247;     199;      60
8197;A028725;GM0450;2019;    5478;    3982;    1486;    1245;     241;      10
8198;A028725;GM0450;2020;    5566;    4031;    1525;    1245;     280;      10
8199;A028725;GM0451;2012;   11790;    6770;    4967;    4050;     917;      53
8200;A028725;GM0451;2013;   11856;    6841;    4962;    4077;     885;      53
8201;A028725;GM0451;2014;   11943;    6962;    4979;    4037;     942;       2
8202;A028725;GM0451;2015;   12104;    7039;    5060;    4067;     993;       5
8203;A028725;GM0451;2016;   12377;    7179;    5192;    4107;    1085;       6
8204;A028725;GM0451;2017;   12338;    7190;    5142;    4010;    1132;       6
8205;A028725;GM0451;2018;   12426;    7413;    5004;    3960;    1044;       9
8206;A028725;GM0451;2019;   12376;    7471;    4900;    3940;     960;       5
8207;A028725;GM0451;2020;   12370;    7480;    4885;    3881;    1004;       5
8208;A028725;GM0184;2012;    5142;    4221;     920;     702;     218;       1
8209;A028725;GM0184;2013;    5176;    4239;     935;     699;     236;       2
8210;A028725;GM0184;2014;    5660;    4477;    1092;     812;     280;      91
8211;A028725;GM0184;2015;    5841;    4578;    1162;     850;     312;     101
8212;A028725;GM0184;2016;    5934;    4641;    1192;     854;     338;     101
8213;A028725;GM0184;2017;    6029;    4697;    1236;     865;     371;      96
8214;A028725;GM0184;2018;    6126;    4754;    1276;     896;     380;      96
8215;A028725;GM0184;2019;    6219;    4865;    1327;     891;     436;      27
8216;A028725;GM0184;2020;    6334;    4945;    1363;     917;     446;      26
8217;A028725;GM0344;2012;  134049;   62074;   68442;   46760;   21682;    3533
8218;A028725;GM0344;2013;  136461;   63252;   71582;   47169;   24413;    1627
8219;A028725;GM0344;2014;  138723;   63250;   73703;   46963;   26740;    1770
8220;A028725;GM0344;2015;  140404;   63796;   74566;   48907;   25659;    2042
8221;A028725;GM0344;2016;  142111;   64571;   75902;   48465;   27437;    1638
8222;A028725;GM0344;2017;  143470;   65907;   75703;   47852;   27851;    1860
8223;A028725;GM0344;2018;  143826;   65393;   76890;   47979;   28911;    1543
8224;A028725;GM0344;2019;  146641;   68479;   77833;   48589;   29244;     329
8225;A028725;GM0344;2020;  149695;   68858;   80490;   48475;   32015;     347
8226;A028725;GM1581;2012;   19213;   12481;    6563;    4413;    2150;     169
8227;A028725;GM1581;2013;   19179;   12481;    6636;    4583;    2053;      62
8228;A028725;GM1581;2014;   19375;   12605;    6701;    4611;    2090;      69
8229;A028725;GM1581;2015;   19520;   12655;    6811;    4649;    2162;      54
8230;A028725;GM1581;2016;   19720;   12743;    6922;    4718;    2204;      55
8231;A028725;GM1581;2017;   19994;   12944;    6966;    4766;    2200;      84
8232;A028725;GM1581;2018;   20153;   13086;    6969;    4812;    2157;      98
8233;A028725;GM1581;2019;   20288;   13437;    6806;    4933;    1873;      45
8234;A028725;GM1581;2020;   20440;   13502;    6893;    4998;    1895;      45
8235;A028725;GM0981;2012;    4529;    2182;    2339;    1553;     786;       8
8236;A028725;GM0981;2013;    4604;    2195;    2387;    1547;     840;      22
8237;A028725;GM0981;2014;    4638;    2198;    2433;    1532;     901;       7
8238;A028725;GM0981;2015;    4664;    2193;    2468;    1531;     937;       3
8239;A028725;GM0981;2016;    4662;    2217;    2442;    1533;     909;       3
8240;A028725;GM0981;2017;    4801;    2222;    2574;    1526;    1048;       5
8241;A028725;GM0981;2018;    4969;    2297;    2669;    1542;    1127;       3
8242;A028725;GM0981;2019;    5238;    2329;    2818;    1539;    1279;      91
8243;A028725;GM0981;2020;    5299;    2356;    2844;    1564;    1280;      99
8244;A028725;GM0994;2012;    7309;    4619;    2674;    1546;    1128;      16
8245;A028725;GM0994;2013;    7309;    4613;    2683;    1525;    1158;      13
8246;A028725;GM0994;2014;    7455;    4628;    2736;    1504;    1232;      91
8247;A028725;GM0994;2015;    7517;    4448;    2959;    1512;    1447;     110
8248;A028725;GM0994;2016;    7550;    4476;    2947;    1486;    1461;     127
8249;A028725;GM0994;2017;    7582;    4516;    2937;    1463;    1474;     129
8250;A028725;GM0994;2018;    7585;    4681;    2776;    1455;    1321;     128
8251;A028725;GM0994;2019;    7708;    4752;    2930;    1485;    1445;      26
8252;A028725;GM0994;2020;    7741;    4774;    2945;    1444;    1501;      22
8253;A028725;GM0858;2012;   12994;    8172;    4801;    3862;     939;      21
8254;A028725;GM0858;2013;   13455;    8246;    5189;    4077;    1112;      20
8255;A028725;GM0858;2014;   13537;    8272;    5215;    4083;    1132;      50
8256;A028725;GM0858;2015;   13588;    8271;    5249;    4093;    1156;      68
8257;A028725;GM0858;2016;   13665;    8339;    5273;    4019;    1254;      53
8258;A028725;GM0858;2017;   13830;    8356;    5421;    4160;    1261;      53
8259;A028725;GM0858;2018;   13958;    8474;    5432;    4132;    1300;      52
8260;A028725;GM0858;2019;   14116;    8553;    5560;    4189;    1371;       3
8261;A028725;GM0858;2020;   14253;    8603;    5645;    4197;    1448;       5
8262;A028725;GM0047;2012;   12033;    8039;    3969;    2959;    1010;      25
8263;A028725;GM0047;2013;   12074;    8081;    3988;    2912;    1076;       5
8264;A028725;GM0047;2014;   12178;    8031;    4058;    2939;    1119;      89
8265;A028725;GM0047;2015;   12227;    8012;    4130;    2967;    1163;      85
8266;A028725;GM0047;2016;   12244;    7973;    4184;    2975;    1209;      87
8267;A028725;GM0047;2017;   12288;    7980;    4228;    2978;    1250;      80
8268;A028725;GM0047;2018;   12349;    8148;    4109;    2963;    1146;      92
8269;A028725;GM0047;2019;   12405;    8186;    4199;    3070;    1129;      20
8270;A028725;GM0047;2020;   12480;    8200;    4264;    3082;    1182;      16
8271;A028725;GM0345;2012;   23947;   14158;    9779;    8519;    1260;      10
8272;A028725;GM0345;2013;   24760;   14609;   10149;    8715;    1434;       2
8273;A028725;GM0345;2014;   25238;   14895;   10337;    8753;    1584;       6
8274;A028725;GM0345;2015;   25719;   15092;   10624;    8736;    1888;       3
8275;A028725;GM0345;2016;   25997;   15397;   10599;    8747;    1852;       1
8276;A028725;GM0345;2017;   26349;   15479;   10857;    8759;    2098;      13
8277;A028725;GM0345;2018;   26825;   15716;   11093;    8811;    2282;      16
8278;A028725;GM0345;2019;   27133;   16082;   11036;    8826;    2210;      15
8279;A028725;GM0345;2020;   27685;   16496;   11176;    8875;    2301;      13
8280;A028725;GM0717;2012;    8904;    6965;    1934;    1155;     779;       5
8281;A028725;GM0717;2013;    8948;    7003;    1942;    1174;     768;       3
8282;A028725;GM0717;2014;    9008;    7058;    1947;    1170;     777;       3
8283;A028725;GM0717;2015;    9048;    7090;    1951;    1186;     765;       7
8284;A028725;GM0717;2016;    9134;    7150;    1926;    1174;     752;      58
8285;A028725;GM0717;2017;    9110;    7168;    1893;    1136;     757;      49
8286;A028725;GM0717;2018;    9159;    7333;    1770;    1127;     643;      56
8287;A028725;GM0717;2019;    9189;    7434;    1728;    1123;     605;      27
8288;A028725;GM0717;2020;    9233;    7469;    1724;    1102;     622;      40
8289;A028725;GM0860;2012;   14568;   10464;    4039;    2984;    1055;      65
8290;A028725;GM0860;2013;   14621;   10612;    3989;    2923;    1066;      20
8291;A028725;GM0860;2014;   14825;   10651;    4107;    2960;    1147;      67
8292;A028725;GM0860;2015;   14959;   10696;    4193;    2898;    1295;      70
8293;A028725;GM0860;2016;   15192;   10792;    4347;    3065;    1282;      53
8294;A028725;GM0860;2017;;;;;;
8295;A028725;GM0860;2018;;;;;;
8296;A028725;GM0860;2019;;;;;;
8297;A028725;GM0860;2020;;;;;;
8298;A028725;GM0861;2012;   18071;   12373;    5661;    4536;    1125;      37
8299;A028725;GM0861;2013;   18407;   12435;    5936;    4702;    1234;      36
8300;A028725;GM0861;2014;   18474;   12508;    5933;    4650;    1283;      33
8301;A028725;GM0861;2015;   18585;   12548;    6005;    4688;    1317;      32
8302;A028725;GM0861;2016;   18701;   12646;    6045;    4680;    1365;      10
8303;A028725;GM0861;2017;   18839;   12740;    6091;    4671;    1420;       8
8304;A028725;GM0861;2018;   18955;   12869;    6069;    4665;    1404;      17
8305;A028725;GM0861;2019;   19171;   13115;    6055;    4744;    1311;       1
8306;A028725;GM0861;2020;   19359;   13256;    6102;    4682;    1420;       1
8307;A028725;GM0453;2012;   28508;   15648;   12767;   10492;    2275;      93
8308;A028725;GM0453;2013;   28672;   15743;   12863;   10511;    2352;      66
8309;A028725;GM0453;2014;   28921;   15879;   12992;   10561;    2431;      50
8310;A028725;GM0453;2015;   29071;   15968;   13056;   10620;    2436;      47
8311;A028725;GM0453;2016;   29133;   16110;   12984;   10477;    2507;      39
8312;A028725;GM0453;2017;   29577;   16216;   13221;   10340;    2881;     140
8313;A028725;GM0453;2018;   29663;   16810;   12812;   10321;    2491;      41
8314;A028725;GM0453;2019;   29976;   17086;   12808;   10953;    1855;      82
8315;A028725;GM0453;2020;   30212;   17214;   12908;   10940;    1968;      90
8316;A028725;GM0983;2012;   43180;   25789;   17353;   12906;    4447;      38
8317;A028725;GM0983;2013;   43488;   25739;   17716;   13025;    4691;      33
8318;A028725;GM0983;2014;   43810;   26150;   17631;   13093;    4538;      29
8319;A028725;GM0983;2015;   43985;   26132;   17823;   13088;    4735;      30
8320;A028725;GM0983;2016;   44265;   26255;   17977;   13013;    4964;      33
8321;A028725;GM0983;2017;   44655;   26316;   18274;   13105;    5169;      65
8322;A028725;GM0983;2018;   45079;   26682;   18288;   13128;    5160;     109
8323;A028725;GM0983;2019;   45279;   26995;   18252;   13113;    5139;      32
8324;A028725;GM0983;2020;   45604;   27139;   18402;   13182;    5220;      63
8325;A028725;GM0984;2012;   17209;   11048;    6098;    4742;    1356;      63
8326;A028725;GM0984;2013;   17394;   11137;    6241;    4825;    1416;      16
8327;A028725;GM0984;2014;   17614;   11113;    6455;    4888;    1567;      46
8328;A028725;GM0984;2015;   17859;   11206;    6617;    5024;    1593;      36
8329;A028725;GM0984;2016;   17999;   11263;    6684;    5041;    1643;      52
8330;A028725;GM0984;2017;   18054;   11276;    6714;    4968;    1746;      64
8331;A028725;GM0984;2018;   18110;   11621;    6435;    4964;    1471;      54
8332;A028725;GM0984;2019;   18205;   11872;    6280;    4919;    1361;      53
8333;A028725;GM0984;2020;   18386;   11946;    6372;    4988;    1384;      68
8334;A028725;GM0620;2012;    7867;    4896;    2968;    2593;     375;       3
8335;A028725;GM0620;2013;    7910;    4956;    2952;    2577;     375;       2
8336;A028725;GM0620;2014;    7935;    4980;    2952;    2561;     391;       3
8337;A028725;GM0620;2015;    7970;    5010;    2956;    2576;     380;       4
8338;A028725;GM0620;2016;    7967;    5002;    2960;    2578;     382;       5
8339;A028725;GM0620;2017;    8118;    5054;    3061;    2658;     403;       3
8340;A028725;GM0620;2018;    8210;    5170;    3028;    2620;     408;      12
8341;A028725;GM0620;2019;;;;;;
8342;A028725;GM0620;2020;;;;;;
8343;A028725;GM1961;2012;;;;;;
8344;A028725;GM1961;2013;;;;;;
8345;A028725;GM1961;2014;;;;;;
8346;A028725;GM1961;2015;;;;;;
8347;A028725;GM1961;2016;;;;;;
8348;A028725;GM1961;2017;;;;;;
8349;A028725;GM1961;2018;;;;;;
8350;A028725;GM1961;2019;   22523;   13990;    8494;    7133;    1361;      39
8351;A028725;GM1961;2020;   22988;   14378;    8586;    7186;    1400;      24
8352;A028725;GM0622;2012;   32421;   14983;   17420;   15513;    1907;      18
8353;A028725;GM0622;2013;   32277;   15084;   17186;   15211;    1975;       7
8354;A028725;GM0622;2014;   32518;   15019;   17493;   15296;    2197;       6
8355;A028725;GM0622;2015;   32885;   15051;   17823;   15529;    2294;      11
8356;A028725;GM0622;2016;   33022;   15244;   17745;   15291;    2454;      33
8357;A028725;GM0622;2017;   33165;   15321;   17803;   15319;    2484;      41
8358;A028725;GM0622;2018;   33155;   15595;   17430;   15086;    2344;     130
8359;A028725;GM0622;2019;   33287;   16020;   17247;   14876;    2371;      20
8360;A028725;GM0622;2020;   33718;   16223;   17452;   14986;    2466;      43
8361;A028725;GM0048;2012;    6828;    4727;    2090;    1658;     432;      11
8362;A028725;GM0048;2013;    6881;    4725;    2154;    1655;     499;       2
8363;A028725;GM0048;2014;    6920;    4647;    2223;    1703;     520;      50
8364;A028725;GM0048;2015;    7000;    4694;    2266;    1717;     549;      40
8365;A028725;GM0048;2016;    7013;    4681;    2286;    1711;     575;      46
8366;A028725;GM0048;2017;    7052;    4666;    2339;    1707;     632;      47
8367;A028725;GM0048;2018;;;;;;
8368;A028725;GM0048;2019;;;;;;
8369;A028725;GM0048;2020;;;;;;
8370;A028725;GM0096;2012;     460;     193;     265;     197;      68;       2
8371;A028725;GM0096;2013;     464;     197;     266;     191;      75;       1
8372;A028725;GM0096;2014;     458;     199;     258;     191;      67;       1
8373;A028725;GM0096;2015;     457;     198;     254;     179;      75;       5
8374;A028725;GM0096;2016;     459;     199;     254;     183;      71;       6
8375;A028725;GM0096;2017;     458;     198;     254;     179;      75;       6
8376;A028725;GM0096;2018;     480;     199;     273;     186;      87;       8
8377;A028725;GM0096;2019;     486;     207;     273;     183;      90;       6
8378;A028725;GM0096;2020;     494;     201;     288;     184;     104;       5
8379;A028725;GM0718;2012;   20473;   11731;    8729;    6842;    1887;      13
8380;A028725;GM0718;2013;   20586;   11766;    8726;    6783;    1943;      94
8381;A028725;GM0718;2014;   20907;   11741;    8976;    6799;    2177;     190
8382;A028725;GM0718;2015;   20982;   11762;    9016;    6780;    2236;     204
8383;A028725;GM0718;2016;   21030;   11800;    9021;    6746;    2275;     209
8384;A028725;GM0718;2017;   21142;   11795;    9075;    6740;    2335;     272
8385;A028725;GM0718;2018;   21379;   11911;    9259;    6758;    2501;     209
8386;A028725;GM0718;2019;   21439;   12167;    9228;    6571;    2657;      44
8387;A028725;GM0718;2020;   21381;   12137;    9192;    6493;    2699;      52
8388;A028725;GM0623;2012;    3715;    2488;    1220;    1019;     201;       7
8389;A028725;GM0623;2013;    3744;    2506;    1232;    1004;     228;       6
8390;A028725;GM0623;2014;    3766;    2536;    1229;     997;     232;       1
8391;A028725;GM0623;2015;;;;;;
8392;A028725;GM0623;2016;;;;;;
8393;A028725;GM0623;2017;;;;;;
8394;A028725;GM0623;2018;;;;;;
8395;A028725;GM0623;2019;;;;;;
8396;A028725;GM0623;2020;;;;;;
8397;A028725;GM0986;2012;    5180;    3716;    1461;    1092;     369;       3
8398;A028725;GM0986;2013;    5297;    3773;    1520;    1140;     380;       4
8399;A028725;GM0986;2014;    5365;    3787;    1515;    1117;     398;      63
8400;A028725;GM0986;2015;    5333;    3836;    1494;    1098;     396;       3
8401;A028725;GM0986;2016;    5432;    3838;    1512;    1092;     420;      82
8402;A028725;GM0986;2017;    5450;    3830;    1543;    1116;     427;      77
8403;A028725;GM0986;2018;    5497;    3949;    1474;    1142;     332;      74
8404;A028725;GM0986;2019;    5514;    3984;    1518;    1145;     373;      12
8405;A028725;GM0986;2020;    5554;    3971;    1572;    1167;     405;      11
8406;A028725;GM0626;2012;   10212;    6626;    3579;    2138;    1441;       7
8407;A028725;GM0626;2013;   10398;    6653;    3739;    2308;    1431;       6
8408;A028725;GM0626;2014;   10486;    6664;    3817;    2362;    1455;       5
8409;A028725;GM0626;2015;   10593;    6806;    3783;    2402;    1381;       4
8410;A028725;GM0626;2016;   10663;    6819;    3791;    2403;    1388;      53
8411;A028725;GM0626;2017;   10773;    6897;    3860;    2433;    1427;      16
8412;A028725;GM0626;2018;   10899;    6902;    3949;    2437;    1512;      48
8413;A028725;GM0626;2019;   10915;    7028;    3845;    2365;    1480;      42
8414;A028725;GM0626;2020;   11028;    7050;    3963;    2443;    1520;      15
8415;A028725;GM0285;2012;    9011;    6140;    2795;    2217;     578;      76
8416;A028725;GM0285;2013;    9053;    6178;    2849;    2231;     618;      26
8417;A028725;GM0285;2014;    9212;    6180;    2990;    2232;     758;      42
8418;A028725;GM0285;2015;    9319;    6258;    3049;    2336;     713;      12
8419;A028725;GM0285;2016;    9419;    6357;    2963;    2300;     663;      99
8420;A028725;GM0285;2017;    9742;    6521;    3100;    2376;     724;     121
8421;A028725;GM0285;2018;    9797;    6636;    3039;    2364;     675;     122
8422;A028725;GM0285;2019;    9865;    6722;    3132;    2447;     685;      11
8423;A028725;GM0285;2020;    9959;    6833;    3114;    2425;     689;      12
8424;A028725;GM0865;2012;   10203;    6285;    3901;    2999;     902;      17
8425;A028725;GM0865;2013;   10334;    6335;    3985;    3040;     945;      14
8426;A028725;GM0865;2014;   10584;    6328;    4190;    2931;    1259;      66
8427;A028725;GM0865;2015;   10698;    6457;    4184;    2945;    1239;      57
8428;A028725;GM0865;2016;   10771;    6589;    4131;    2931;    1200;      51
8429;A028725;GM0865;2017;   10830;    6690;    4087;    2993;    1094;      53
8430;A028725;GM0865;2018;   10896;    6863;    3978;    2967;    1011;      55
8431;A028725;GM0865;2019;   10942;    6960;    3980;    2929;    1051;       2
8432;A028725;GM0865;2020;   11056;    6989;    4065;    2898;    1167;       2
8433;A028725;GM1949;2012;;;;;;
8434;A028725;GM1949;2013;;;;;;
8435;A028725;GM1949;2014;;;;;;
8436;A028725;GM1949;2015;;;;;;
8437;A028725;GM1949;2016;;;;;;
8438;A028725;GM1949;2017;;;;;;
8439;A028725;GM1949;2018;   19945;   13672;    6167;    4925;    1242;     106
8440;A028725;GM1949;2019;   20041;   13737;    6287;    5105;    1182;      17
8441;A028725;GM1949;2020;   20139;   13777;    6342;    5063;    1279;      20
8442;A028725;GM0866;2012;    6730;    5248;    1476;    1123;     353;       6
8443;A028725;GM0866;2013;    6733;    5235;    1495;    1111;     384;       3
8444;A028725;GM0866;2014;    7063;    5389;    1672;    1209;     463;       2
8445;A028725;GM0866;2015;    7157;    5382;    1773;    1289;     484;       2
8446;A028725;GM0866;2016;    7228;    5480;    1744;    1274;     470;       4
8447;A028725;GM0866;2017;    7196;    5474;    1718;    1271;     447;       4
8448;A028725;GM0866;2018;    7246;    5554;    1688;    1262;     426;       4
8449;A028725;GM0866;2019;    7253;    5572;    1678;    1252;     426;       3
8450;A028725;GM0866;2020;    7418;    5657;    1758;    1242;     516;       3
8451;A028725;GM0867;2012;   19329;   11668;    7646;    6371;    1275;      15
8452;A028725;GM0867;2013;   19573;   11749;    7811;    6435;    1376;      13
8453;A028725;GM0867;2014;   19837;   11808;    7933;    6446;    1487;      96
8454;A028725;GM0867;2015;   20067;   11910;    8023;    6534;    1489;     134
8455;A028725;GM0867;2016;   20243;   12009;    8098;    6583;    1515;     136
8456;A028725;GM0867;2017;   20487;   12137;    8236;    6621;    1615;     114
8457;A028725;GM0867;2018;   20696;   12582;    8006;    6489;    1517;     108
8458;A028725;GM0867;2019;   20956;   12860;    8070;    6644;    1426;      26
8459;A028725;GM0867;2020;   21165;   12940;    8199;    6605;    1594;      26
8460;A028725;GM0627;2012;   10079;    5988;    4082;    3183;     899;       9
8461;A028725;GM0627;2013;   10127;    6049;    4076;    3194;     882;       2
8462;A028725;GM0627;2014;   10407;    6182;    4164;    3272;     892;      61
8463;A028725;GM0627;2015;   10542;    6292;    4193;    3289;     904;      57
8464;A028725;GM0627;2016;   10748;    6412;    4289;    3371;     918;      47
8465;A028725;GM0627;2017;   10912;    6583;    4291;    3366;     925;      38
8466;A028725;GM0627;2018;   11336;    6933;    4362;    3363;     999;      41
8467;A028725;GM0627;2019;   11622;    7269;    4349;    3405;     944;       4
8468;A028725;GM0627;2020;   11961;    7600;    4353;    3386;     967;       8
8469;A028725;GM0289;2012;   13842;    6493;    6744;    5168;    1576;     605
8470;A028725;GM0289;2013;   17575;    6716;    9595;    5157;    4438;    1264
8471;A028725;GM0289;2014;   18033;    6744;   10331;    5301;    5030;     958
8472;A028725;GM0289;2015;   18165;    6766;   10502;    7150;    3352;     897
8473;A028725;GM0289;2016;   18273;    6826;   10545;    6865;    3680;     902
8474;A028725;GM0289;2017;   16085;    6829;    9003;    5584;    3419;     253
8475;A028725;GM0289;2018;   16420;    6958;    9260;    6181;    3079;     202
8476;A028725;GM0289;2019;   16707;    7243;    9447;    6711;    2736;      17
8477;A028725;GM0289;2020;   16970;    7336;    9623;    6812;    2811;      11
8478;A028725;GM0629;2012;   10988;    5957;    4916;    3107;    1809;     115
8479;A028725;GM0629;2013;   10983;    5951;    4931;    3069;    1862;     101
8480;A028725;GM0629;2014;   11008;    6000;    4912;    3035;    1877;      96
8481;A028725;GM0629;2015;   11107;    6112;    4955;    3130;    1825;      40
8482;A028725;GM0629;2016;   11185;    6216;    4901;    3125;    1776;      68
8483;A028725;GM0629;2017;   11211;    6252;    4893;    3111;    1782;      66
8484;A028725;GM0629;2018;   11164;    6259;    4833;    3083;    1750;      72
8485;A028725;GM0629;2019;   11195;    6380;    4747;    3111;    1636;      68
8486;A028725;GM0629;2020;   11181;    6405;    4706;    3097;    1609;      70
8487;A028725;GM0852;2012;    6693;    4503;    2167;    1803;     364;      23
8488;A028725;GM0852;2013;    6707;    4511;    2173;    1796;     377;      23
8489;A028725;GM0852;2014;    6745;    4539;    2189;    1794;     395;      17
8490;A028725;GM0852;2015;    6909;    4627;    2273;    1821;     452;       9
8491;A028725;GM0852;2016;    7002;    4720;    2277;    1853;     424;       5
8492;A028725;GM0852;2017;    7004;    4718;    2283;    1854;     429;       3
8493;A028725;GM0852;2018;    7001;    4817;    2175;    1849;     326;       9
8494;A028725;GM0852;2019;    7013;    4882;    2125;    1837;     288;       6
8495;A028725;GM0852;2020;    7055;    4899;    2151;    1839;     312;       5
8496;A028725;GM0988;2012;   20308;   14011;    6271;    4756;    1515;      26
8497;A028725;GM0988;2013;   20544;   14092;    6397;    4815;    1582;      55
8498;A028725;GM0988;2014;   20934;   14153;    6766;    5051;    1715;      15
8499;A028725;GM0988;2015;   21092;   13877;    7200;    5058;    2142;      15
8500;A028725;GM0988;2016;   21214;   13960;    7222;    5055;    2167;      32
8501;A028725;GM0988;2017;   21439;   14059;    7356;    5135;    2221;      24
8502;A028725;GM0988;2018;   21579;   14393;    7155;    4899;    2256;      31
8503;A028725;GM0988;2019;   21746;   14700;    6991;    5212;    1779;      55
8504;A028725;GM0988;2020;   21973;   14793;    7123;    5191;    1932;      57
8505;A028725;GM0457;2012;    8032;    4275;    3754;    3073;     681;       3
8506;A028725;GM0457;2013;    8076;    4302;    3770;    3080;     690;       4
8507;A028725;GM0457;2014;    8192;    4320;    3779;    3044;     735;      93
8508;A028725;GM0457;2015;    8276;    4391;    3784;    3059;     725;     101
8509;A028725;GM0457;2016;    8350;    4502;    3744;    3003;     741;     104
8510;A028725;GM0457;2017;    8420;    4532;    3793;    3007;     786;      95
8511;A028725;GM0457;2018;    8595;    4668;    3829;    2981;     848;      98
8512;A028725;GM0457;2019;    8668;    4798;    3863;    2972;     891;       7
8513;A028725;GM0457;2020;    8801;    4891;    3897;    2951;     946;      13
8514;A028725;GM0870;2012;    9829;    6424;    3391;    2901;     490;      14
8515;A028725;GM0870;2013;    9853;    6467;    3366;    2877;     489;      20
8516;A028725;GM0870;2014;    9854;    6484;    3351;    2840;     511;      19
8517;A028725;GM0870;2015;    9984;    6584;    3390;    2853;     537;      10
8518;A028725;GM0870;2016;   10109;    6707;    3391;    2831;     560;      11
8519;A028725;GM0870;2017;   10219;    6805;    3407;    2843;     564;       7
8520;A028725;GM0870;2018;   10405;    7012;    3383;    2854;     529;      10
8521;A028725;GM0870;2019;;;;;;
8522;A028725;GM0870;2020;;;;;;
8523;A028725;GM1960;2012;;;;;;
8524;A028725;GM1960;2013;;;;;;
8525;A028725;GM1960;2014;;;;;;
8526;A028725;GM1960;2015;;;;;;
8527;A028725;GM1960;2016;;;;;;
8528;A028725;GM1960;2017;;;;;;
8529;A028725;GM1960;2018;;;;;;
8530;A028725;GM1960;2019;   19890;   14306;    5456;    4422;    1034;     128
8531;A028725;GM1960;2020;   20108;   14517;    5443;    4400;    1043;     148
8532;A028725;GM0668;2012;    7196;    5103;    2023;    1560;     463;      70
8533;A028725;GM0668;2013;    7280;    5117;    2102;    1593;     509;      61
8534;A028725;GM0668;2014;    7388;    5165;    2158;    1605;     553;      65
8535;A028725;GM0668;2015;    7566;    5264;    2218;    1639;     579;      84
8536;A028725;GM0668;2016;    7617;    5386;    2156;    1629;     527;      75
8537;A028725;GM0668;2017;    7633;    5358;    2204;    1623;     581;      71
8538;A028725;GM0668;2018;    7693;    5442;    2198;    1620;     578;      53
8539;A028725;GM0668;2019;    7778;    5582;    2181;    1630;     551;      15
8540;A028725;GM0668;2020;    7888;    5677;    2193;    1623;     570;      18
8541;A028725;GM1969;2012;;;;;;
8542;A028725;GM1969;2013;;;;;;
8543;A028725;GM1969;2014;;;;;;
8544;A028725;GM1969;2015;;;;;;
8545;A028725;GM1969;2016;;;;;;
8546;A028725;GM1969;2017;;;;;;
8547;A028725;GM1969;2018;;;;;;
8548;A028725;GM1969;2019;   26161;   18946;    7169;    5587;    1582;      46
8549;A028725;GM1969;2020;   26447;   19178;    7218;    5554;    1664;      51
8550;A028725;GM1701;2012;    7686;    5564;    2105;    1478;     627;      17
8551;A028725;GM1701;2013;    7791;    5620;    2132;    1474;     658;      39
8552;A028725;GM1701;2014;    7794;    5628;    2125;    1443;     682;      41
8553;A028725;GM1701;2015;    7844;    5654;    2186;    1461;     725;       4
8554;A028725;GM1701;2016;    7857;    5686;    2129;    1421;     708;      42
8555;A028725;GM1701;2017;    7931;    5717;    2148;    1413;     735;      66
8556;A028725;GM1701;2018;    8026;    5992;    1974;    1426;     548;      60
8557;A028725;GM1701;2019;    8097;    6102;    1990;    1484;     506;       5
8558;A028725;GM1701;2020;    8125;    6126;    1993;    1470;     523;       6
8559;A028725;GM0293;2012;    6270;    3605;    2663;    2151;     512;       2
8560;A028725;GM0293;2013;    6279;    3623;    2655;    2130;     525;       1
8561;A028725;GM0293;2014;    6356;    3637;    2718;    2167;     551;       1
8562;A028725;GM0293;2015;    6410;    3653;    2756;    2203;     553;       1
8563;A028725;GM0293;2016;    6463;    3697;    2766;    2206;     560;       0
8564;A028725;GM0293;2017;    6505;    3727;    2778;    2055;     723;       0
8565;A028725;GM0293;2018;    6554;    3789;    2762;    2056;     706;       3
8566;A028725;GM0293;2019;    6581;    3861;    2705;    2078;     627;      15
8567;A028725;GM0293;2020;    6617;    3903;    2699;    2073;     626;      15
8568;A028725;GM1950;2012;;;;;;
8569;A028725;GM1950;2013;;;;;;
8570;A028725;GM1950;2014;;;;;;
8571;A028725;GM1950;2015;;;;;;
8572;A028725;GM1950;2016;;;;;;
8573;A028725;GM1950;2017;;;;;;
8574;A028725;GM1950;2018;   10979;    7674;    3232;    2482;     750;      73
8575;A028725;GM1950;2019;   11012;    7713;    3278;    2525;     753;      21
8576;A028725;GM1950;2020;   11034;    7737;    3274;    2524;     750;      23
8577;A028725;GM1783;2012;   38797;   25984;   12754;   10349;    2405;      59
8578;A028725;GM1783;2013;   39383;   26347;   13004;   10368;    2636;      32
8579;A028725;GM1783;2014;   39835;   26497;   13298;   10503;    2795;      40
8580;A028725;GM1783;2015;   40653;   27024;   13600;   10486;    3114;      29
8581;A028725;GM1783;2016;   41028;   27498;   13442;   10577;    2865;      88
8582;A028725;GM1783;2017;   41557;   27909;   13626;   10547;    3079;      22
8583;A028725;GM1783;2018;   42139;   28255;   13821;   10573;    3248;      63
8584;A028725;GM1783;2019;   42976;   29591;   13274;   10651;    2623;     111
8585;A028725;GM1783;2020;   43604;   30054;   13481;   10697;    2784;      69
8586;A028725;GM0098;2012;   10652;    6526;    4120;    3304;     816;       6
8587;A028725;GM0098;2013;   10687;    6556;    4127;    3274;     853;       4
8588;A028725;GM0098;2014;   10727;    6605;    4119;    3231;     888;       3
8589;A028725;GM0098;2015;   10810;    6659;    4145;    3256;     889;       6
8590;A028725;GM0098;2016;   10866;    6683;    4178;    3265;     913;       5
8591;A028725;GM0098;2017;   10941;    6758;    4180;    3228;     952;       3
8592;A028725;GM0098;2018;   11025;    7086;    3923;    3198;     725;      16
8593;A028725;GM0098;2019;   11041;    7205;    3821;    3115;     706;      15
8594;A028725;GM0098;2020;   11147;    7290;    3841;    3134;     707;      16
8595;A028725;GM0614;2012;    6000;    4259;    1732;     303;    1429;       9
8596;A028725;GM0614;2013;    5993;    4243;    1745;     300;    1445;       5
8597;A028725;GM0614;2014;    6133;    4292;    1794;     304;    1490;      47
8598;A028725;GM0614;2015;    6227;    4459;    1717;     303;    1414;      51
8599;A028725;GM0614;2016;    6321;    4521;    1751;     309;    1442;      49
8600;A028725;GM0614;2017;    6328;    4555;    1728;     304;    1424;      45
8601;A028725;GM0614;2018;    6403;    4631;    1724;     336;    1388;      48
8602;A028725;GM0614;2019;    6474;    4741;    1722;     369;    1353;      11
8603;A028725;GM0614;2020;    6515;    4801;    1705;     366;    1339;       9
8604;A028725;GM0189;2012;    8712;    6446;    2254;    1716;     538;      12
8605;A028725;GM0189;2013;    8759;    6513;    2237;    1681;     556;       9
8606;A028725;GM0189;2014;    8842;    6564;    2268;    1670;     598;      10
8607;A028725;GM0189;2015;    8975;    6657;    2305;    1660;     645;      13
8608;A028725;GM0189;2016;    9038;    6720;    2309;    1618;     691;       9
8609;A028725;GM0189;2017;    9153;    6761;    2388;    1673;     715;       4
8610;A028725;GM0189;2018;    9259;    6871;    2383;    1682;     701;       5
8611;A028725;GM0189;2019;    9326;    6861;    2423;    1712;     711;      42
8612;A028725;GM0189;2020;    9443;    6907;    2443;    1660;     783;      93
8613;A028725;GM0296;2012;   16458;   11086;    5363;    4310;    1053;       9
8614;A028725;GM0296;2013;   16699;   11125;    5568;    4444;    1124;       6
8615;A028725;GM0296;2014;   16995;   11233;    5628;    4455;    1173;     134
8616;A028725;GM0296;2015;   17037;   11284;    5615;    4258;    1357;     138
8617;A028725;GM0296;2016;   17103;   11361;    5613;    4394;    1219;     129
8618;A028725;GM0296;2017;   17175;   11364;    5676;    4358;    1318;     135
8619;A028725;GM0296;2018;   17344;   11623;    5584;    4339;    1245;     137
8620;A028725;GM0296;2019;   17482;   11849;    5572;    4479;    1093;      61
8621;A028725;GM0296;2020;   17611;   11958;    5596;    4456;    1140;      57
8622;A028725;GM1696;2012;    9331;    6455;    2819;    2009;     810;      57
8623;A028725;GM1696;2013;    9443;    6476;    2925;    1994;     931;      42
8624;A028725;GM1696;2014;    9521;    6485;    3010;    2007;    1003;      26
8625;A028725;GM1696;2015;    9535;    6491;    3021;    1998;    1023;      23
8626;A028725;GM1696;2016;    9620;    6525;    3067;    1998;    1069;      28
8627;A028725;GM1696;2017;    9751;    6599;    3110;    1962;    1148;      42
8628;A028725;GM1696;2018;    9789;    6782;    2962;    1963;     999;      45
8629;A028725;GM1696;2019;    9893;    6895;    2979;    2006;     973;      19
8630;A028725;GM1696;2020;    9954;    6952;    2987;    2032;     955;      15
8631;A028725;GM0352;2012;    9008;    6070;    2936;    2330;     606;       2
8632;A028725;GM0352;2013;    9160;    6155;    2989;    2297;     692;      16
8633;A028725;GM0352;2014;    9309;    6251;    3035;    2246;     789;      23
8634;A028725;GM0352;2015;    9465;    6362;    3075;    2389;     686;      28
8635;A028725;GM0352;2016;    9589;    6529;    3034;    2321;     713;      26
8636;A028725;GM0352;2017;    9635;    6574;    3021;    2343;     678;      40
8637;A028725;GM0352;2018;    9718;    6659;    3018;    2313;     705;      41
8638;A028725;GM0352;2019;    9726;    6863;    2845;    2317;     528;      18
8639;A028725;GM0352;2020;    9903;    6991;    2894;    2334;     560;      18
8640;A028725;GM0053;2012;    5661;    4033;    1624;    1406;     218;       4
8641;A028725;GM0053;2013;    5718;    4087;    1628;    1399;     229;       3
8642;A028725;GM0053;2014;    5827;    4082;    1743;    1424;     319;       2
8643;A028725;GM0053;2015;    5825;    4070;    1755;    1471;     284;       0
8644;A028725;GM0053;2016;    5818;    4057;    1761;    1427;     334;       0
8645;A028725;GM0053;2017;    5834;    4067;    1766;    1427;     339;       1
8646;A028725;GM0053;2018;    5852;    4061;    1789;    1424;     365;       2
8647;A028725;GM0053;2019;;;;;;
8648;A028725;GM0053;2020;;;;;;
8649;A028725;GM0294;2012;   11531;    8175;    3339;    2187;    1152;      17
8650;A028725;GM0294;2013;   12035;    8473;    3548;    2248;    1300;      14
8651;A028725;GM0294;2014;   12149;    8491;    3655;    2185;    1470;       3
8652;A028725;GM0294;2015;   12259;    8534;    3714;    2221;    1493;      11
8653;A028725;GM0294;2016;   12294;    8586;    3699;    2179;    1520;       9
8654;A028725;GM0294;2017;   12377;    8622;    3746;    2192;    1554;       9
8655;A028725;GM0294;2018;   12428;    8844;    3562;    2216;    1346;      22
8656;A028725;GM0294;2019;   12528;    8923;    3597;    2312;    1285;       8
8657;A028725;GM0294;2020;   12573;    8950;    3612;    2287;    1325;      11
8658;A028725;GM0873;2012;    8800;    6345;    2300;    1743;     557;     155
8659;A028725;GM0873;2013;    8871;    6497;    2357;    1754;     603;      17
8660;A028725;GM0873;2014;    8996;    6562;    2421;    1738;     683;      13
8661;A028725;GM0873;2015;    9109;    6576;    2524;    1775;     749;       9
8662;A028725;GM0873;2016;    9131;    6585;    2532;    1734;     798;      14
8663;A028725;GM0873;2017;    9211;    6616;    2570;    1725;     845;      25
8664;A028725;GM0873;2018;    9267;    6677;    2568;    1762;     806;      22
8665;A028725;GM0873;2019;    9319;    6798;    2486;    1832;     654;      35
8666;A028725;GM0873;2020;    9326;    6812;    2490;    1809;     681;      24
8667;A028725;GM0632;2012;   19825;   13387;    6423;    4489;    1934;      15
8668;A028725;GM0632;2013;   20071;   13522;    6539;    4851;    1688;      10
8669;A028725;GM0632;2014;   20368;   13615;    6648;    4876;    1772;     105
8670;A028725;GM0632;2015;   20561;   13700;    6723;    4866;    1857;     138
8671;A028725;GM0632;2016;   20779;   13807;    6838;    4913;    1925;     134
8672;A028725;GM0632;2017;   20969;   13963;    6879;    4913;    1966;     127
8673;A028725;GM0632;2018;   21118;   14218;    6773;    4913;    1860;     127
8674;A028725;GM0632;2019;   21383;   14389;    6964;    4971;    1993;      30
8675;A028725;GM0632;2020;   21458;   14431;    7021;    4937;    2084;       6
8676;A028725;GM1690;2012;    9185;    6885;    2285;    1647;     638;      15
8677;A028725;GM1690;2013;    9214;    6904;    2296;    1637;     659;      14
8678;A028725;GM1690;2014;    9306;    6968;    2282;    1616;     666;      56
8679;A028725;GM1690;2015;    9522;    7002;    2419;    1729;     690;     101
8680;A028725;GM1690;2016;    9623;    7079;    2313;    1602;     711;     231
8681;A028725;GM1690;2017;    9650;    7055;    2351;    1544;     807;     244
8682;A028725;GM1690;2018;    9726;    7206;    2276;    1602;     674;     244
8683;A028725;GM1690;2019;    9854;    7331;    2507;    1775;     732;      16
8684;A028725;GM1690;2020;    9988;    7430;    2540;    1798;     742;      18
8685;A028725;GM0880;2012;    6293;    3939;    2336;    2011;     325;      18
8686;A028725;GM0880;2013;    6324;    3955;    2352;    2026;     326;      17
8687;A028725;GM0880;2014;    6470;    4003;    2427;    2018;     409;      40
8688;A028725;GM0880;2015;    6488;    4032;    2431;    2010;     421;      25
8689;A028725;GM0880;2016;    6473;    4060;    2374;    1925;     449;      39
8690;A028725;GM0880;2017;    6550;    4124;    2386;    1921;     465;      40
8691;A028725;GM0880;2018;    6629;    4312;    2276;    1925;     351;      41
8692;A028725;GM0880;2019;    6794;    4383;    2381;    2054;     327;      30
8693;A028725;GM0880;2020;    6733;    4369;    2356;    1980;     376;       8
8694;A028725;GM0351;2012;    4482;    3148;    1322;    1040;     282;      12
8695;A028725;GM0351;2013;    4664;    3252;    1404;    1100;     304;       8
8696;A028725;GM0351;2014;    4691;    3283;    1402;    1096;     306;       6
8697;A028725;GM0351;2015;    4705;    3310;    1390;    1087;     303;       5
8698;A028725;GM0351;2016;    4725;    3325;    1395;    1059;     336;       5
8699;A028725;GM0351;2017;    4806;    3357;    1432;    1034;     398;      17
8700;A028725;GM0351;2018;    4871;    3421;    1435;    1070;     365;      15
8701;A028725;GM0351;2019;    4944;    3607;    1327;    1061;     266;      10
8702;A028725;GM0351;2020;    5053;    3668;    1381;    1074;     307;       4
8703;A028725;GM0874;2012;    5431;    3464;    1947;    1673;     274;      20
8704;A028725;GM0874;2013;    5489;    3529;    1943;    1667;     276;      17
8705;A028725;GM0874;2014;    5544;    3572;    1968;    1660;     308;       4
8706;A028725;GM0874;2015;    5612;    3639;    1970;    1668;     302;       3
8707;A028725;GM0874;2016;    5694;    3746;    1946;    1645;     301;       2
8708;A028725;GM0874;2017;    5760;    3816;    1942;    1619;     323;       2
8709;A028725;GM0874;2018;    5862;    3928;    1930;    1616;     314;       4
8710;A028725;GM0874;2019;;;;;;
8711;A028725;GM0874;2020;;;;;;
8712;A028725;GM0479;2012;   62394;   32737;   29646;   25681;    3965;      11
8713;A028725;GM0479;2013;   63369;   33329;   30028;   25766;    4262;      12
8714;A028725;GM0479;2014;   64116;   33841;   30203;   25523;    4680;      72
8715;A028725;GM0479;2015;   64464;   34224;   30233;   25394;    4839;       7
8716;A028725;GM0479;2016;   65088;   34711;   30261;   25367;    4894;     116
8717;A028725;GM0479;2017;   65738;   35112;   30506;   25317;    5189;     120
8718;A028725;GM0479;2018;   66191;   36089;   29951;   25214;    4737;     151
8719;A028725;GM0479;2019;   66447;   36606;   29778;   25211;    4567;      63
8720;A028725;GM0479;2020;   66851;   36833;   29929;   25096;    4833;      89
8721;A028725;GM0297;2012;    9651;    6685;    2958;    2450;     508;       8
8722;A028725;GM0297;2013;    9836;    6794;    3033;    2488;     545;       9
8723;A028725;GM0297;2014;   10183;    6878;    3240;    2553;     687;      65
8724;A028725;GM0297;2015;   10362;    6983;    3316;    2608;     708;      63
8725;A028725;GM0297;2016;   10521;    7050;    3410;    2584;     826;      61
8726;A028725;GM0297;2017;   10600;    7120;    3426;    2565;     861;      54
8727;A028725;GM0297;2018;   10764;    7255;    3435;    2572;     863;      74
8728;A028725;GM0297;2019;   10954;    7433;    3515;    2693;     822;       6
8729;A028725;GM0297;2020;   11175;    7568;    3599;    2700;     899;       8
8730;A028725;GM0473;2012;    7852;    4210;    3608;    2841;     767;      34
8731;A028725;GM0473;2013;    7906;    4204;    3660;    2841;     819;      42
8732;A028725;GM0473;2014;    7904;    4191;    3697;    2842;     855;      16
8733;A028725;GM0473;2015;    7951;    4266;    3676;    2776;     900;       9
8734;A028725;GM0473;2016;    8020;    4352;    3659;    2796;     863;       9
8735;A028725;GM0473;2017;    8164;    4408;    3690;    2806;     884;      66
8736;A028725;GM0473;2018;    8179;    4465;    3635;    2804;     831;      79
8737;A028725;GM0473;2019;    8179;    4482;    3632;    2839;     793;      65
8738;A028725;GM0473;2020;    8243;    4518;    3677;    2853;     824;      48
8739;A028725;GM0707;2012;    4940;    3500;    1437;    1165;     272;       3
8740;A028725;GM0707;2013;    5030;    3562;    1465;    1171;     294;       3
8741;A028725;GM0707;2014;    5183;    3612;    1511;    1206;     305;      60
8742;A028725;GM0707;2015;    5220;    3631;    1527;    1218;     309;      62
8743;A028725;GM0707;2016;    5237;    3668;    1507;    1194;     313;      62
8744;A028725;GM0707;2017;    5317;    3719;    1531;    1226;     305;      67
8745;A028725;GM0707;2018;    5357;    3788;    1502;    1236;     266;      67
8746;A028725;GM0707;2019;;;;;;
8747;A028725;GM0707;2020;;;;;;
8748;A028725;GM0478;2012;    2446;    1918;     528;     451;      77;       0
8749;A028725;GM0478;2013;    2458;    1921;     537;     454;      83;       0
8750;A028725;GM0478;2014;    2473;    1937;     536;     445;      91;       0
8751;A028725;GM0478;2015;    2485;    1936;     545;     445;     100;       4
8752;A028725;GM0478;2016;;;;;;
8753;A028725;GM0478;2017;;;;;;
8754;A028725;GM0478;2018;;;;;;
8755;A028725;GM0478;2019;;;;;;
8756;A028725;GM0478;2020;;;;;;
8757;A028725;GM0050;2012;    7641;    5122;    2492;    1968;     524;      27
8758;A028725;GM0050;2013;    7698;    5169;    2512;    1967;     545;      17
8759;A028725;GM0050;2014;    7776;    5189;    2571;    1978;     593;      16
8760;A028725;GM0050;2015;    7903;    5299;    2588;    1965;     623;      16
8761;A028725;GM0050;2016;    7957;    5358;    2582;    1960;     622;      17
8762;A028725;GM0050;2017;    8117;    5481;    2619;    1978;     641;      17
8763;A028725;GM0050;2018;    8149;    5575;    2556;    1963;     593;      18
8764;A028725;GM0050;2019;    8367;    5886;    2478;    1986;     492;       3
8765;A028725;GM0050;2020;    8452;    5970;    2478;    1959;     519;       4
8766;A028725;GM0355;2012;   25241;   12999;   12139;    9219;    2920;     103
8767;A028725;GM0355;2013;   25513;   13235;   12178;    9190;    2988;     100
8768;A028725;GM0355;2014;   25722;   13306;   12177;    9019;    3158;     239
8769;A028725;GM0355;2015;   26296;   13404;   12466;    9114;    3352;     426
8770;A028725;GM0355;2016;   26556;   13624;   12486;    8552;    3934;     446
8771;A028725;GM0355;2017;   26823;   13881;   12493;    8440;    4053;     449
8772;A028725;GM0355;2018;   27063;   13940;   12697;    8505;    4192;     426
8773;A028725;GM0355;2019;   27291;   14507;   12736;    8473;    4263;      48
8774;A028725;GM0355;2020;   27783;   14799;   12890;    8459;    4431;      94
8775;A028725;GM0299;2012;   13617;    8279;    5321;    4209;    1112;      17
8776;A028725;GM0299;2013;   14018;    8668;    5335;    4170;    1165;      15
8777;A028725;GM0299;2014;   14133;    8671;    5444;    4169;    1275;      18
8778;A028725;GM0299;2015;   14234;    8741;    5453;    4176;    1277;      40
8779;A028725;GM0299;2016;   14234;    8777;    5427;    4154;    1273;      30
8780;A028725;GM0299;2017;   14370;    8904;    5424;    4148;    1276;      42
8781;A028725;GM0299;2018;   19099;   11971;    7079;    5602;    1477;      49
8782;A028725;GM0299;2019;   19259;   12256;    6986;    5663;    1323;      17
8783;A028725;GM0299;2020;   19438;   12400;    7026;    5671;    1355;      12
8784;A028725;GM0476;2012;    4475;    3244;    1218;     879;     339;      13
8785;A028725;GM0476;2013;;;;;;
8786;A028725;GM0476;2014;;;;;;
8787;A028725;GM0476;2015;;;;;;
8788;A028725;GM0476;2016;;;;;;
8789;A028725;GM0476;2017;;;;;;
8790;A028725;GM0476;2018;;;;;;
8791;A028725;GM0476;2019;;;;;;
8792;A028725;GM0476;2020;;;;;;
8793;A028725;GM0637;2012;   51660;   27180;   24465;   19375;    5090;      15
8794;A028725;GM0637;2013;   52283;   27492;   24790;   19734;    5056;       1
8795;A028725;GM0637;2014;   53224;   27993;   24893;   19780;    5113;     338
8796;A028725;GM0637;2015;   53619;   28441;   24879;   19815;    5064;     299
8797;A028725;GM0637;2016;   53904;   28763;   24867;   19535;    5332;     274
8798;A028725;GM0637;2017;   54231;   29272;   24766;   19463;    5303;     193
8799;A028725;GM0637;2018;   54427;   29731;   24509;   19308;    5201;     187
8800;A028725;GM0637;2019;   54596;   30164;   24361;   19398;    4963;      71
8801;A028725;GM0637;2020;   54701;   30415;   24213;   19146;    5067;      73
8802;A028725;GM0638;2012;    3040;    2235;     795;     607;     188;      10
8803;A028725;GM0638;2013;    3074;    2284;     780;     598;     182;      10
8804;A028725;GM0638;2014;    3138;    2293;     799;     605;     194;      46
8805;A028725;GM0638;2015;    3202;    2376;     777;     606;     171;      49
8806;A028725;GM0638;2016;    3220;    2392;     779;     597;     182;      49
8807;A028725;GM0638;2017;    3354;    2494;     802;     615;     187;      58
8808;A028725;GM0638;2018;    3355;    2486;     847;     636;     211;      22
8809;A028725;GM0638;2019;    3370;    2536;     832;     632;     200;       2
8810;A028725;GM0638;2020;    3417;    2558;     855;     634;     221;       4
8811;A028725;GM0056;2012;    7187;    5444;    1704;    1292;     412;      39
8812;A028725;GM0056;2013;    7196;    5452;    1711;    1293;     418;      33
8813;A028725;GM0056;2014;    7412;    5561;    1840;    1362;     478;      11
8814;A028725;GM0056;2015;    7426;    5538;    1877;    1389;     488;      11
8815;A028725;GM0056;2016;    7483;    5614;    1857;    1326;     531;      12
8816;A028725;GM0056;2017;    7501;    5608;    1882;    1342;     540;      11
8817;A028725;GM0056;2018;    7602;    5798;    1790;    1336;     454;      14
8818;A028725;GM0056;2019;;;;;;
8819;A028725;GM0056;2020;;;;;;
8820;A028725;GM1892;2012;   15639;   10244;    5368;    4585;     783;      27
8821;A028725;GM1892;2013;   15792;   10382;    5399;    4712;     687;      11
8822;A028725;GM1892;2014;   16217;   10614;    5473;    4725;     748;     130
8823;A028725;GM1892;2015;   16203;   10706;    5386;    4657;     729;     111
8824;A028725;GM1892;2016;   16304;   10834;    5353;    4611;     742;     117
8825;A028725;GM1892;2017;   16522;   11051;    5360;    4621;     739;     111
8826;A028725;GM1892;2018;   16709;   10934;    5660;    4669;     991;     115
8827;A028725;GM1892;2019;   17049;   11566;    5424;    4689;     735;      59
8828;A028725;GM1892;2020;   17502;   11925;    5514;    4767;     747;      63
8829;A028725;GM0879;2012;    8360;    6337;    2022;    1148;     874;       1
8830;A028725;GM0879;2013;    8395;    6369;    2026;    1170;     856;       0
8831;A028725;GM0879;2014;    8413;    6347;    2066;    1173;     893;       0
8832;A028725;GM0879;2015;    8457;    6366;    2088;    1153;     935;       3
8833;A028725;GM0879;2016;    8578;    6398;    2177;    1197;     980;       3
8834;A028725;GM0879;2017;    8655;    6426;    2224;    1228;     996;       5
8835;A028725;GM0879;2018;    8768;    6471;    2274;    1235;    1039;      23
8836;A028725;GM0879;2019;    8836;    6692;    2129;    1228;     901;      15
8837;A028725;GM0879;2020;    8856;    6732;    2114;    1222;     892;      10
8838;A028725;GM0301;2012;   20122;   11213;    8858;    6146;    2712;      51
8839;A028725;GM0301;2013;   20498;   11274;    9126;    6259;    2867;      98
8840;A028725;GM0301;2014;   20798;   11367;    9278;    6573;    2705;     153
8841;A028725;GM0301;2015;   20651;   11357;    9203;    6273;    2930;      91
8842;A028725;GM0301;2016;   20881;   11458;    9288;    6995;    2293;     135
8843;A028725;GM0301;2017;   20958;   11478;    9346;    6964;    2382;     134
8844;A028725;GM0301;2018;   21137;   11864;    9134;    6767;    2367;     139
8845;A028725;GM0301;2019;   21324;   12061;    9238;    6863;    2375;      25
8846;A028725;GM0301;2020;   21487;   12202;    9267;    6863;    2404;      18
8847;A028725;GM1896;2012;    7911;    5584;    2237;    1757;     480;      90
8848;A028725;GM1896;2013;    7984;    5650;    2274;    1741;     533;      60
8849;A028725;GM1896;2014;    8034;    5663;    2303;    1725;     578;      68
8850;A028725;GM1896;2015;    8149;    5736;    2329;    1726;     603;      84
8851;A028725;GM1896;2016;    8256;    5791;    2369;    1743;     626;      96
8852;A028725;GM1896;2017;    8306;    5811;    2423;    1757;     666;      72
8853;A028725;GM1896;2018;    8414;    6029;    2311;    1738;     573;      74
8854;A028725;GM1896;2019;    8466;    6146;    2300;    1772;     528;      20
8855;A028725;GM1896;2020;    8535;    6207;    2307;    1766;     541;      21
8856;A028725;GM0642;2012;   19430;   10583;    8830;    7711;    1119;      17
8857;A028725;GM0642;2013;   19499;   10643;    8840;    7676;    1164;      16
8858;A028725;GM0642;2014;   19495;   10713;    8758;    7571;    1187;      24
8859;A028725;GM0642;2015;   19547;   10769;    8762;    7571;    1191;      16
8860;A028725;GM0642;2016;   19566;   10777;    8747;    7483;    1264;      42
8861;A028725;GM0642;2017;   19525;   10860;    8649;    7389;    1260;      16
8862;A028725;GM0642;2018;   19607;   10996;    8573;    7345;    1228;      38
8863;A028725;GM0642;2019;   19717;   11235;    8459;    7379;    1080;      23
8864;A028725;GM0642;2020;   19863;   11358;    8493;    7366;    1127;      12
8865;A028725;GM0193;2012;   51298;   27496;   23704;   17678;    6026;      98
8866;A028725;GM0193;2013;   51981;   27787;   24093;   17771;    6322;     101
8867;A028725;GM0193;2014;   52399;   28012;   24265;   17763;    6502;     122
8868;A028725;GM0193;2015;   53050;   28286;   24617;   18087;    6530;     147
8869;A028725;GM0193;2016;   53891;   28524;   25152;   18204;    6948;     215
8870;A028725;GM0193;2017;   54425;   28918;   25347;   18219;    7128;     160
8871;A028725;GM0193;2018;   55084;   29129;   25756;   18396;    7360;     199
8872;A028725;GM0193;2019;   56125;   30229;   25826;   18671;    7155;      70
8873;A028725;GM0193;2020;   56910;   30527;   26210;   18789;    7421;     173
8874;A028726;NL01  ;2012;  411535;  165266;  198998;   78896;  120102;   47271
8875;A028726;NL01  ;2013;  394193;  157655;  201914;   79847;  122067;   34624
8876;A028726;NL01  ;2014;  392152;  150729;  200038;   75058;  124980;   41385
8877;A028726;NL01  ;2015;  376735;  147604;  187186;   70391;  116795;   41945
8878;A028726;NL01  ;2016;  365139;  142027;  179707;   62953;  116754;   43405
8879;A028726;NL01  ;2017;  355034;  132856;  181234;   62153;  119081;   40944
8880;A028726;NL01  ;2018;  342930;  126167;  180690;   60873;  119817;   36073
8881;A028726;NL01  ;2019;  345556;  139578;  197078;   70414;  126664;    8900
8882;A028726;NL01  ;2020;  344199;  137837;  196482;   69429;  127053;    9880
8883;A028726;LD01  ;2012;   48179;   20551;   21269;    8727;   12542;    6359
8884;A028726;LD01  ;2013;   41173;   18030;   19605;    8192;   11413;    3538
8885;A028726;LD01  ;2014;   41014;   16981;   20309;    8192;   12117;    3724
8886;A028726;LD01  ;2015;   39692;   16419;   19759;    8339;   11420;    3514
8887;A028726;LD01  ;2016;   38462;   15866;   18843;    7594;   11249;    3753
8888;A028726;LD01  ;2017;   36723;   14851;   18118;    7243;   10875;    3754
8889;A028726;LD01  ;2018;   36233;   14048;   18605;    7214;   11391;    3580
8890;A028726;LD01  ;2019;   36501;   15252;   20089;    8611;   11478;    1160
8891;A028726;LD01  ;2020;   35744;   14663;   19762;    8450;   11312;    1319
8892;A028726;LD02  ;2012;   74745;   30675;   32811;   13308;   19503;   11259
8893;A028726;LD02  ;2013;   73112;   28970;   35749;   14158;   21591;    8393
8894;A028726;LD02  ;2014;   70238;   27344;   33968;   12251;   21717;    8926
8895;A028726;LD02  ;2015;   68343;   27087;   32256;   12438;   19818;    9000
8896;A028726;LD02  ;2016;   65851;   25783;   30971;   11342;   19629;    9097
8897;A028726;LD02  ;2017;   62867;   24017;   29787;   10316;   19471;    9063
8898;A028726;LD02  ;2018;   58446;   22757;   29192;   10104;   19088;    6497
8899;A028726;LD02  ;2019;   58757;   25251;   32084;   12199;   19885;    1422
8900;A028726;LD02  ;2020;   58152;   25469;   31494;   11263;   20231;    1189
8901;A028726;LD03  ;2012;  211716;   81380;  109275;   42534;   66741;   21061
8902;A028726;LD03  ;2013;  205002;   78685;  109886;   43007;   66879;   16431
8903;A028726;LD03  ;2014;  203902;   75511;  108468;   39702;   68766;   19923
8904;A028726;LD03  ;2015;  195435;   73865;  100582;   36519;   64063;   20988
8905;A028726;LD03  ;2016;  189364;   71322;   97377;   32475;   64902;   20665
8906;A028726;LD03  ;2017;  186058;   66890;   99093;   33158;   65935;   20075
8907;A028726;LD03  ;2018;  180948;   64058;   98238;   32731;   65507;   18652
8908;A028726;LD03  ;2019;  183234;   70237;  108234;   37425;   70809;    4763
8909;A028726;LD03  ;2020;  184223;   69532;  108918;   37395;   71523;    5773
8910;A028726;LD04  ;2012;   76860;   32651;   35628;   14327;   21301;    8581
8911;A028726;LD04  ;2013;   74882;   31964;   36662;   14490;   22172;    6256
8912;A028726;LD04  ;2014;   76996;   30892;   37292;   14913;   22379;    8812
8913;A028726;LD04  ;2015;   73265;   30233;   34589;   13095;   21494;    8443
8914;A028726;LD04  ;2016;   71462;   29056;   32516;   11542;   20974;    9890
8915;A028726;LD04  ;2017;   69386;   27098;   34236;   11436;   22800;    8052
8916;A028726;LD04  ;2018;   67303;   25304;   34655;   10824;   23831;    7344
8917;A028726;LD04  ;2019;   67064;   28838;   36671;   12179;   24492;    1555
8918;A028726;LD04  ;2020;   66080;   28173;   36308;   12321;   23987;    1599
8919;A028726;PV20  ;2012;   14386;    5393;    7204;    3210;    3994;    1789
8920;A028726;PV20  ;2013;   13917;    5169;    7292;    3362;    3930;    1456
8921;A028726;PV20  ;2014;   13793;    5032;    7436;    3334;    4102;    1325
8922;A028726;PV20  ;2015;   13316;    4833;    7443;    3807;    3636;    1040
8923;A028726;PV20  ;2016;   13078;    4682;    7229;    3582;    3647;    1167
8924;A028726;PV20  ;2017;   12810;    4331;    7148;    3325;    3823;    1331
8925;A028726;PV20  ;2018;   12490;    4052;    7155;    3235;    3920;    1283
8926;A028726;PV20  ;2019;   12926;    4485;    7761;    3640;    4121;     680
8927;A028726;PV20  ;2020;   12873;    4437;    7709;    3486;    4223;     727
8928;A028726;Friesland (PV)  ;2012;   16889;    8374;    7134;    2730;    4404;    1381
8929;A028726;Friesland (PV)  ;2013;   15762;    7790;    7123;    2828;    4295;     849
8930;A028726;Friesland (PV)  ;2014;   15255;    7061;    7121;    2838;    4283;    1073
8931;A028726;Friesland (PV)  ;2015;   15040;    6854;    6964;    2542;    4422;    1222
8932;A028726;Friesland (PV)  ;2016;   14898;    6620;    6861;    2399;    4462;    1417
8933;A028726;Friesland (PV)  ;2017;   14269;    6326;    6586;    2375;    4211;    1357
8934;A028726;Friesland (PV)  ;2018;   14196;    6049;    6835;    2336;    4499;    1312
8935;A028726;Friesland (PV)  ;2019;   14102;    6600;    7206;    2695;    4511;     296
8936;A028726;Friesland (PV)  ;2020;   14025;    6477;    7173;    2751;    4422;     375
8937;A028726;Drenthe (PV)  ;2012;   16904;    6784;    6931;    2787;    4144;    3189
8938;A028726;Drenthe (PV)  ;2013;   11494;    5071;    5190;    2002;    3188;    1233
8939;A028726;Drenthe (PV)  ;2014;   11966;    4888;    5752;    2020;    3732;    1326
8940;A028726;Drenthe (PV)  ;2015;   11336;    4732;    5352;    1990;    3362;    1252
8941;A028726;Drenthe (PV)  ;2016;   10486;    4564;    4753;    1613;    3140;    1169
8942;A028726;Drenthe (PV)  ;2017;    9644;    4194;    4384;    1543;    2841;    1066
8943;A028726;Drenthe (PV)  ;2018;    9547;    3947;    4615;    1643;    2972;     985
8944;A028726;Drenthe (PV)  ;2019;    9473;    4167;    5122;    2276;    2846;     184
8945;A028726;Drenthe (PV)  ;2020;    8846;    3749;    4880;    2213;    2667;     217
8946;A028726;Overijssel (PV)  ;2012;   25385;   10599;   12371;    5434;    6937;    2415
8947;A028726;Overijssel (PV)  ;2013;   24201;    9992;   12275;    5497;    6778;    1934
8948;A028726;Overijssel (PV)  ;2014;   23139;    9102;   11314;    4956;    6358;    2723
8949;A028726;Overijssel (PV)  ;2015;   22210;    8986;   10490;    4859;    5631;    2734
8950;A028726;Overijssel (PV)  ;2016;   21462;    8630;   10427;    4578;    5849;    2405
8951;A028726;Overijssel (PV)  ;2017;   20611;    8089;   10097;    4338;    5759;    2425
8952;A028726;Overijssel (PV)  ;2018;   19839;    7766;   10037;    3994;    6043;    2036
8953;A028726;Overijssel (PV)  ;2019;   20425;    8772;   11292;    4447;    6845;     361
8954;A028726;Overijssel (PV)  ;2020;   20143;    8745;   11012;    4251;    6761;     386
8955;A028726;Flevoland (PV)  ;2012;    6425;    2720;    2590;     997;    1593;    1115
8956;A028726;Flevoland (PV)  ;2013;    6438;    2592;    3297;    1102;    2195;     549
8957;A028726;Flevoland (PV)  ;2014;    6255;    2514;    3467;     947;    2520;     274
8958;A028726;Flevoland (PV)  ;2015;    6066;    2481;    3225;     943;    2282;     360
8959;A028726;Flevoland (PV)  ;2016;    4914;    2090;    2541;     834;    1707;     283
8960;A028726;Flevoland (PV)  ;2017;    4752;    1890;    2585;     761;    1824;     277
8961;A028726;Flevoland (PV)  ;2018;    4700;    1872;    2520;     794;    1726;     308
8962;A028726;Flevoland (PV)  ;2019;    4899;    1984;    2870;    1051;    1819;      45
8963;A028726;Flevoland (PV)  ;2020;    5388;    2233;    3088;    1073;    2015;      67
8964;A028726;Gelderland (PV)  ;2012;   42935;   17356;   17850;    6877;   10973;    7729
8965;A028726;Gelderland (PV)  ;2013;   42473;   16386;   20177;    7559;   12618;    5910
8966;A028726;Gelderland (PV)  ;2014;   40844;   15728;   19187;    6348;   12839;    5929
8967;A028726;Gelderland (PV)  ;2015;   40067;   15620;   18541;    6636;   11905;    5906
8968;A028726;Gelderland (PV)  ;2016;   39475;   15063;   18003;    5930;   12073;    6409
8969;A028726;Gelderland (PV)  ;2017;   37504;   14038;   17105;    5217;   11888;    6361
8970;A028726;Gelderland (PV)  ;2018;   33907;   13119;   16635;    5316;   11319;    4153
8971;A028726;Gelderland (PV)  ;2019;   33433;   14495;   17922;    6701;   11221;    1016
8972;A028726;Gelderland (PV)  ;2020;   32621;   14491;   17394;    5939;   11455;     736
8973;A028726;Utrecht (PV)  ;2012;   26581;   10426;   12269;    4507;    7762;    3886
8974;A028726;Utrecht (PV)  ;2013;   26090;    9990;   12910;    4627;    8283;    3190
8975;A028726;Utrecht (PV)  ;2014;   24114;    8928;   12233;    4555;    7678;    2953
8976;A028726;Utrecht (PV)  ;2015;   22688;    8571;   11208;    4091;    7117;    2909
8977;A028726;Utrecht (PV)  ;2016;   22191;    8317;   10840;    3699;    7141;    3034
8978;A028726;Utrecht (PV)  ;2017;   23077;    7575;   12309;    4318;    7991;    3193
8979;A028726;Utrecht (PV)  ;2018;   21737;    7397;   11247;    3759;    7488;    3093
8980;A028726;Utrecht (PV)  ;2019;   22200;    8824;   12935;    3974;    8961;     441
8981;A028726;Utrecht (PV)  ;2020;   21644;    8523;   12702;    4083;    8619;     419
8982;A028726;Noord-Holland (PV)  ;2012;   69596;   26105;   37326;   15284;   22042;    6165
8983;A028726;Noord-Holland (PV)  ;2013;   68591;   26302;   37403;   15165;   22238;    4886
8984;A028726;Noord-Holland (PV)  ;2014;   67940;   25418;   37217;   13778;   23439;    5305
8985;A028726;Noord-Holland (PV)  ;2015;   64827;   25206;   34673;   12585;   22088;    4948
8986;A028726;Noord-Holland (PV)  ;2016;   63870;   23951;   34589;   11309;   23280;    5330
8987;A028726;Noord-Holland (PV)  ;2017;   62863;   22609;   34765;   11245;   23520;    5489
8988;A028726;Noord-Holland (PV)  ;2018;   63646;   22237;   36422;   12562;   23860;    4987
8989;A028726;Noord-Holland (PV)  ;2019;   65998;   23699;   41229;   14154;   27075;    1070
8990;A028726;Noord-Holland (PV)  ;2020;   65938;   23922;   40443;   13425;   27018;    1573
8991;A028726;Zuid-Holland (PV)  ;2012;   97041;   35002;   52051;   20827;   31224;    9988
8992;A028726;Zuid-Holland (PV)  ;2013;   94311;   34198;   52465;   21190;   31275;    7648
8993;A028726;Zuid-Holland (PV)  ;2014;   95545;   32972;   52105;   19578;   32527;   10468
8994;A028726;Zuid-Holland (PV)  ;2015;   92319;   32167;   47866;   18157;   29709;   12286
8995;A028726;Zuid-Holland (PV)  ;2016;   87631;   31052;   45335;   15918;   29417;   11244
8996;A028726;Zuid-Holland (PV)  ;2017;   84564;   28883;   45223;   16084;   29139;   10458
8997;A028726;Zuid-Holland (PV)  ;2018;   80075;   26857;   43618;   14929;   28689;    9600
8998;A028726;Zuid-Holland (PV)  ;2019;   79313;   29278;   48275;   17633;   30642;    1760
8999;A028726;Zuid-Holland (PV)  ;2020;   80501;   28990;   49733;   17985;   31748;    1778
9000;A028726;Zeeland (PV)  ;2012;   18498;    9847;    7629;    1916;    5713;    1022
9001;A028726;Zeeland (PV)  ;2013;   16010;    8195;    7108;    2025;    5083;     707
9002;A028726;Zeeland (PV)  ;2014;   16303;    8193;    6913;    1791;    5122;    1197
9003;A028726;Zeeland (PV)  ;2015;   15601;    7921;    6835;    1686;    5149;     845
9004;A028726;Zeeland (PV)  ;2016;   15672;    8002;    6613;    1549;    5064;    1057
9005;A028726;Zeeland (PV)  ;2017;   15554;    7823;    6796;    1511;    5285;     935
9006;A028726;Zeeland (PV)  ;2018;   15490;    7567;    6951;    1481;    5470;     972
9007;A028726;Zeeland (PV)  ;2019;   15723;    8436;    5795;    1664;    4131;    1492
9008;A028726;Zeeland (PV)  ;2020;   16140;    8097;    6040;    1902;    4138;    2003
9009;A028726;Noord-Brabant (PV)  ;2012;   45433;   20742;   20020;    8612;   11408;    4671
9010;A028726;Noord-Brabant (PV)  ;2013;   44303;   20213;   20662;    8500;   12162;    3428
9011;A028726;Noord-Brabant (PV)  ;2014;   45647;   19607;   21307;    8860;   12447;    4733
9012;A028726;Noord-Brabant (PV)  ;2015;   43512;   19114;   19893;    7864;   12029;    4505
9013;A028726;Noord-Brabant (PV)  ;2016;   43093;   18295;   18558;    6813;   11745;    6240
9014;A028726;Noord-Brabant (PV)  ;2017;   41523;   16976;   19700;    6666;   13034;    4847
9015;A028726;Noord-Brabant (PV)  ;2018;   40323;   16083;   19903;    6416;   13487;    4337
9016;A028726;Noord-Brabant (PV)  ;2019;   40700;   18202;   21660;    7430;   14230;     838
9017;A028726;Noord-Brabant (PV)  ;2020;   40281;   17983;   21417;    7536;   13881;     881
9018;A028726;Limburg (PV)  ;2012;   31427;   11909;   15608;    5715;    9893;    3910
9019;A028726;Limburg (PV)  ;2013;   30579;   11751;   16000;    5990;   10010;    2828
9020;A028726;Limburg (PV)  ;2014;   31349;   11285;   15985;    6053;    9932;    4079
9021;A028726;Limburg (PV)  ;2015;   29753;   11119;   14696;    5231;    9465;    3938
9022;A028726;Limburg (PV)  ;2016;   28369;   10761;   13958;    4729;    9229;    3650
9023;A028726;Limburg (PV)  ;2017;   27863;   10122;   14536;    4770;    9766;    3205
9024;A028726;Limburg (PV)  ;2018;   26980;    9221;   14752;    4408;   10344;    3007
9025;A028726;Limburg (PV)  ;2019;   26364;   10636;   15011;    4749;   10262;     717
9026;A028726;Limburg (PV)  ;2020;   25799;   10190;   14891;    4785;   10106;     718
9027;A028726;CR01  ;2012;    3751;    1585;    1833;     848;     985;     333
9028;A028726;CR01  ;2013;    3428;    1538;    1640;     801;     839;     250
9029;A028726;CR01  ;2014;    3526;    1489;    1624;     787;     837;     413
9030;A028726;CR01  ;2015;    3637;    1470;    1649;     820;     829;     518
9031;A028726;CR01  ;2016;    3642;    1448;    1614;     754;     860;     580
9032;A028726;CR01  ;2017;    3605;    1268;    1610;     702;     908;     727
9033;A028726;CR01  ;2018;    3223;    1051;    1513;     624;     889;     659
9034;A028726;CR01  ;2019;    3138;    1215;    1470;     787;     683;     453
9035;A028726;CR01  ;2020;    3098;    1154;    1477;     794;     683;     467
9036;A028726;CR02  ;2012;    1296;     494;     729;     350;     379;      73
9037;A028726;CR02  ;2013;    1372;     516;     790;     448;     342;      66
9038;A028726;CR02  ;2014;    1459;     499;     935;     580;     355;      25
9039;A028726;CR02  ;2015;    1448;     475;     943;     598;     345;      30
9040;A028726;CR02  ;2016;    1517;     480;     934;     594;     340;     103
9041;A028726;CR02  ;2017;    1529;     478;     948;     592;     356;     103
9042;A028726;CR02  ;2018;    1585;     446;    1032;     586;     446;     107
9043;A028726;CR02  ;2019;    1677;     439;    1227;     673;     554;      11
9044;A028726;CR02  ;2020;    1682;     444;    1230;     673;     557;       8
9045;A028726;CR03  ;2012;    9339;    3314;    4642;    2012;    2630;    1383
9046;A028726;CR03  ;2013;    9117;    3115;    4862;    2113;    2749;    1140
9047;A028726;CR03  ;2014;    8808;    3044;    4877;    1967;    2910;     887
9048;A028726;CR03  ;2015;    8231;    2888;    4851;    2389;    2462;     492
9049;A028726;CR03  ;2016;    7919;    2754;    4681;    2234;    2447;     484
9050;A028726;CR03  ;2017;    7676;    2585;    4590;    2031;    2559;     501
9051;A028726;CR03  ;2018;    7682;    2555;    4610;    2025;    2585;     517
9052;A028726;CR03  ;2019;    8111;    2831;    5064;    2180;    2884;     216
9053;A028726;CR03  ;2020;    8093;    2839;    5002;    2019;    2983;     252
9054;A028726;CR04  ;2012;    8138;    3699;    3625;    1444;    2181;     814
9055;A028726;CR04  ;2013;    7491;    3360;    3665;    1467;    2198;     466
9056;A028726;CR04  ;2014;    7427;    3190;    3698;    1436;    2262;     539
9057;A028726;CR04  ;2015;    7420;    3113;    3718;    1221;    2497;     589
9058;A028726;CR04  ;2016;    7325;    2971;    3645;    1129;    2516;     709
9059;A028726;CR04  ;2017;    7075;    2853;    3519;    1273;    2246;     703
9060;A028726;CR04  ;2018;    7095;    2705;    3762;    1371;    2391;     628
9061;A028726;CR04  ;2019;    6956;    3036;    3824;    1622;    2202;      96
9062;A028726;CR04  ;2020;    7170;    2969;    4030;    1698;    2332;     171
9063;A028726;CR05  ;2012;    4241;    2607;    1443;     343;    1100;     191
9064;A028726;CR05  ;2013;    4034;    2339;    1516;     459;    1057;     179
9065;A028726;CR05  ;2014;    4235;    2398;    1606;     459;    1147;     231
9066;A028726;CR05  ;2015;    3980;    2303;    1396;     386;    1010;     281
9067;A028726;CR05  ;2016;    3872;    2208;    1412;     447;     965;     252
9068;A028726;CR05  ;2017;    3739;    2114;    1366;     348;    1018;     259
9069;A028726;CR05  ;2018;    3760;    2081;    1423;     354;    1069;     256
9070;A028726;CR05  ;2019;    3708;    2215;    1360;     416;     944;     133
9071;A028726;CR05  ;2020;    3770;    2142;    1470;     510;     960;     158
9072;A028726;CR06  ;2012;    4510;    2068;    2066;     943;    1123;     376
9073;A028726;CR06  ;2013;    4237;    2091;    1942;     902;    1040;     204
9074;A028726;CR06  ;2014;    3593;    1473;    1817;     943;     874;     303
9075;A028726;CR06  ;2015;    3640;    1438;    1850;     935;     915;     352
9076;A028726;CR06  ;2016;    3701;    1441;    1804;     823;     981;     456
9077;A028726;CR06  ;2017;    3455;    1359;    1701;     754;     947;     395
9078;A028726;CR06  ;2018;    3341;    1263;    1650;     611;    1039;     428
9079;A028726;CR06  ;2019;    3438;    1349;    2022;     657;    1365;      67
9080;A028726;CR06  ;2020;    3085;    1366;    1673;     543;    1130;      46
9081;A028726;CR07  ;2012;    5700;    2415;    1821;     587;    1234;    1464
9082;A028726;CR07  ;2013;    4615;    2080;    1891;     751;    1140;     644
9083;A028726;CR07  ;2014;    4423;    2022;    2149;     833;    1316;     252
9084;A028726;CR07  ;2015;    4259;    2003;    1850;     796;    1054;     406
9085;A028726;CR07  ;2016;    3770;    1885;    1512;     528;     984;     373
9086;A028726;CR07  ;2017;    3688;    1760;    1524;     541;     983;     404
9087;A028726;CR07  ;2018;    3812;    1651;    1738;     645;    1093;     423
9088;A028726;CR07  ;2019;    3632;    1718;    1819;     639;    1180;      95
9089;A028726;CR07  ;2020;    3525;    1573;    1831;     680;    1151;     121
9090;A028726;CR08  ;2012;    8826;    3117;    4139;    1774;    2365;    1570
9091;A028726;CR08  ;2013;    4528;    1777;    2318;     823;    1495;     433
9092;A028726;CR08  ;2014;    4651;    1695;    2296;     764;    1532;     660
9093;A028726;CR08  ;2015;    4367;    1676;    2166;     665;    1501;     525
9094;A028726;CR08  ;2016;    4068;    1625;    2042;     681;    1361;     401
9095;A028726;CR08  ;2017;    3356;    1417;    1622;     577;    1045;     317
9096;A028726;CR08  ;2018;    3248;    1327;    1639;     574;    1065;     282
9097;A028726;CR08  ;2019;    3356;    1463;    1856;     889;     967;      37
9098;A028726;CR08  ;2020;    2839;    1209;    1602;     918;     684;      28
9099;A028726;CR09  ;2012;    2378;    1252;     971;     426;     545;     155
9100;A028726;CR09  ;2013;    2351;    1214;     981;     428;     553;     156
9101;A028726;CR09  ;2014;    2892;    1171;    1307;     423;     884;     414
9102;A028726;CR09  ;2015;    2710;    1053;    1336;     529;     807;     321
9103;A028726;CR09  ;2016;    2648;    1054;    1199;     404;     795;     395
9104;A028726;CR09  ;2017;    2600;    1017;    1238;     425;     813;     345
9105;A028726;CR09  ;2018;    2487;     969;    1238;     424;     814;     280
9106;A028726;CR09  ;2019;    2485;     986;    1447;     748;     699;      52
9107;A028726;CR09  ;2020;    2482;     967;    1447;     615;     832;      68
9108;A028726;CR10  ;2012;    8710;    4006;    3787;    1357;    2430;     917
9109;A028726;CR10  ;2013;    8169;    3769;    3646;    1414;    2232;     754
9110;A028726;CR10  ;2014;    7029;    3024;    3252;    1363;    1889;     753
9111;A028726;CR10  ;2015;    6588;    3069;    2926;    1150;    1776;     593
9112;A028726;CR10  ;2016;    6264;    2910;    2858;    1037;    1821;     496
9113;A028726;CR10  ;2017;    6120;    2755;    2875;    1060;    1815;     490
9114;A028726;CR10  ;2018;    5981;    2632;    2926;    1047;    1879;     423
9115;A028726;CR10  ;2019;    6061;    2935;    3004;    1199;    1805;     122
9116;A028726;CR10  ;2020;    6018;    2874;    3012;    1147;    1865;     132
9117;A028726;CR11  ;2012;    2857;    1279;    1305;     587;     718;     273
9118;A028726;CR11  ;2013;    2837;    1204;    1428;     642;     786;     205
9119;A028726;CR11  ;2014;    3005;    1196;    1601;     767;     834;     208
9120;A028726;CR11  ;2015;    2761;    1021;    1212;     471;     741;     528
9121;A028726;CR11  ;2016;    2888;    1066;    1573;     708;     865;     249
9122;A028726;CR11  ;2017;    2424;     929;    1252;     495;     757;     243
9123;A028726;CR11  ;2018;    2183;     846;    1225;     516;     709;     112
9124;A028726;CR11  ;2019;    2322;     938;    1323;     517;     806;      61
9125;A028726;CR11  ;2020;    2325;     911;    1366;     504;     862;      48
9126;A028726;CR12  ;2012;   13818;    5314;    7279;    3490;    3789;    1225
9127;A028726;CR12  ;2013;   13195;    5019;    7201;    3441;    3760;     975
9128;A028726;CR12  ;2014;   13105;    4882;    6461;    2826;    3635;    1762
9129;A028726;CR12  ;2015;   12861;    4896;    6352;    3238;    3114;    1613
9130;A028726;CR12  ;2016;   12310;    4654;    5996;    2833;    3163;    1660
9131;A028726;CR12  ;2017;   12067;    4405;    5970;    2783;    3187;    1692
9132;A028726;CR12  ;2018;   11675;    4288;    5886;    2431;    3455;    1501
9133;A028726;CR12  ;2019;   12042;    4899;    6965;    2731;    4234;     178
9134;A028726;CR12  ;2020;   11800;    4960;    6634;    2600;    4034;     206
9135;A028726;CR13  ;2012;   17745;    6421;    6297;    1942;    4355;    5027
9136;A028726;CR13  ;2013;   17135;    5696;    7648;    2063;    5585;    3791
9137;A028726;CR13  ;2014;   16201;    5532;    7318;    1541;    5777;    3351
9138;A028726;CR13  ;2015;   15929;    5526;    7111;    1821;    5290;    3292
9139;A028726;CR13  ;2016;   16107;    5428;    7082;    1761;    5321;    3597
9140;A028726;CR13  ;2017;   15136;    5190;    6538;    1472;    5066;    3408
9141;A028726;CR13  ;2018;   12578;    4810;    5997;    1510;    4487;    1771
9142;A028726;CR13  ;2019;   12286;    5281;    6636;    2360;    4276;     369
9143;A028726;CR13  ;2020;   11826;    5237;    6437;    2022;    4415;     152
9144;A028726;CR14  ;2012;    8045;    3899;    3378;    1459;    1919;     768
9145;A028726;CR14  ;2013;    7775;    3810;    3314;    1356;    1958;     651
9146;A028726;CR14  ;2014;    7947;    3683;    3369;    1349;    2020;     895
9147;A028726;CR14  ;2015;    7503;    3535;    3146;    1394;    1752;     822
9148;A028726;CR14  ;2016;    6895;    3310;    2750;    1001;    1749;     835
9149;A028726;CR14  ;2017;    6616;    3109;    2793;    1017;    1776;     714
9150;A028726;CR14  ;2018;    6344;    2947;    2754;     997;    1757;     643
9151;A028726;CR14  ;2019;    6376;    3174;    3150;    1295;    1855;      52
9152;A028726;CR14  ;2020;    6280;    3217;    2993;    1142;    1851;      70
9153;A028726;CR15  ;2012;   12865;    5084;    6505;    2722;    3783;    1276
9154;A028726;CR15  ;2013;   13462;    4984;    7453;    3232;    4221;    1025
9155;A028726;CR15  ;2014;   12860;    4649;    6937;    2755;    4182;    1274
9156;A028726;CR15  ;2015;   12771;    4719;    6734;    2720;    4014;    1318
9157;A028726;CR15  ;2016;   12599;    4444;    6681;    2560;    4121;    1474
9158;A028726;CR15  ;2017;   12018;    4040;    6274;    2183;    4091;    1704
9159;A028726;CR15  ;2018;   11402;    3819;    6334;    2323;    4011;    1249
9160;A028726;CR15  ;2019;   11132;    4127;    6596;    2445;    4151;     409
9161;A028726;CR15  ;2020;   10969;    4103;    6506;    2314;    4192;     360
9162;A028726;CR16  ;2012;    4280;    1952;    1670;     754;     916;     658
9163;A028726;CR16  ;2013;    4101;    1896;    1762;     908;     854;     443
9164;A028726;CR16  ;2014;    3836;    1864;    1563;     703;     860;     409
9165;A028726;CR16  ;2015;    3864;    1840;    1550;     701;     849;     474
9166;A028726;CR16  ;2016;    3874;    1881;    1490;     608;     882;     503
9167;A028726;CR16  ;2017;    3734;    1699;    1500;     545;     955;     535
9168;A028726;CR16  ;2018;    3583;    1543;    1550;     486;    1064;     490
9169;A028726;CR16  ;2019;    3639;    1913;    1540;     601;     939;     186
9170;A028726;CR16  ;2020;    3546;    1934;    1458;     461;     997;     154
9171;A028726;CR17  ;2012;   26581;   10426;   12269;    4507;    7762;    3886
9172;A028726;CR17  ;2013;   26090;    9990;   12910;    4627;    8283;    3190
9173;A028726;CR17  ;2014;   24114;    8928;   12233;    4555;    7678;    2953
9174;A028726;CR17  ;2015;   22688;    8571;   11208;    4091;    7117;    2909
9175;A028726;CR17  ;2016;   22191;    8317;   10840;    3699;    7141;    3034
9176;A028726;CR17  ;2017;   23077;    7575;   12309;    4318;    7991;    3193
9177;A028726;CR17  ;2018;   21737;    7397;   11247;    3759;    7488;    3093
9178;A028726;CR17  ;2019;   22200;    8824;   12935;    3974;    8961;     441
9179;A028726;CR17  ;2020;   21644;    8523;   12702;    4083;    8619;     419
9180;A028726;CR18  ;2012;    5952;    3191;    2310;    1021;    1289;     451
9181;A028726;CR18  ;2013;    6331;    3240;    2658;    1271;    1387;     433
9182;A028726;CR18  ;2014;    6940;    3188;    2915;    1179;    1736;     837
9183;A028726;CR18  ;2015;    6699;    3221;    2855;    1336;    1519;     623
9184;A028726;CR18  ;2016;    6568;    3206;    2796;    1363;    1433;     566
9185;A028726;CR18  ;2017;    6431;    3053;    2676;    1181;    1495;     702
9186;A028726;CR18  ;2018;    6297;    2841;    2857;    1257;    1600;     599
9187;A028726;CR18  ;2019;    6168;    3115;    2889;    1149;    1740;     164
9188;A028726;CR18  ;2020;    6218;    3089;    2889;    1102;    1787;     240
9189;A028726;CR19  ;2012;    4700;    2337;    1825;     557;    1268;     538
9190;A028726;CR19  ;2013;    4861;    2363;    2033;     612;    1421;     465
9191;A028726;CR19  ;2014;    4856;    2288;    1978;     566;    1412;     590
9192;A028726;CR19  ;2015;    4951;    2286;    1921;     510;    1411;     744
9193;A028726;CR19  ;2016;    4662;    2229;    1754;     519;    1235;     679
9194;A028726;CR19  ;2017;    4453;    2114;    1745;     554;    1191;     594
9195;A028726;CR19  ;2018;    4559;    2131;    1806;     495;    1311;     622
9196;A028726;CR19  ;2019;    4393;    2199;    2145;     608;    1537;      49
9197;A028726;CR19  ;2020;    4442;    2257;    2106;     567;    1539;      79
9198;A028726;CR20  ;2012;    3510;    1564;    1625;     698;     927;     321
9199;A028726;CR20  ;2013;    3484;    1560;    1709;     820;     889;     215
9200;A028726;CR20  ;2014;    3959;    1474;    2290;     581;    1709;     195
9201;A028726;CR20  ;2015;    3771;    1484;    2103;     591;    1512;     184
9202;A028726;CR20  ;2016;    3515;    1400;    1934;     518;    1416;     181
9203;A028726;CR20  ;2017;    3328;    1279;    1778;     634;    1144;     271
9204;A028726;CR20  ;2018;    2997;    1195;    1635;     631;    1004;     167
9205;A028726;CR20  ;2019;    3090;    1345;    1673;     761;     912;      72
9206;A028726;CR20  ;2020;    3093;    1409;    1624;     701;     923;      60
9207;A028726;CR21  ;2012;    5994;    2629;    2891;     781;    2110;     474
9208;A028726;CR21  ;2013;    5826;    2641;    2842;     767;    2075;     343
9209;A028726;CR21  ;2014;    5606;    2531;    2667;     631;    2036;     408
9210;A028726;CR21  ;2015;    5688;    2464;    2785;     778;    2007;     439
9211;A028726;CR21  ;2016;    5551;    2391;    2658;     625;    2033;     502
9212;A028726;CR21  ;2017;    5406;    2180;    2830;     775;    2055;     396
9213;A028726;CR21  ;2018;    5673;    2275;    2935;     773;    2162;     463
9214;A028726;CR21  ;2019;    5700;    2326;    3123;     901;    2222;     251
9215;A028726;CR21  ;2020;    5755;    2348;    3101;     813;    2288;     306
9216;A028726;CR22  ;2012;    2932;    1274;    1563;    1038;     525;      95
9217;A028726;CR22  ;2013;    2929;    1278;    1554;     953;     601;      97
9218;A028726;CR22  ;2014;    2663;    1076;    1481;     895;     586;     106
9219;A028726;CR22  ;2015;    2293;    1014;    1224;     708;     516;      55
9220;A028726;CR22  ;2016;    2084;     968;    1028;     603;     425;      88
9221;A028726;CR22  ;2017;    1952;     885;     994;     580;     414;      73
9222;A028726;CR22  ;2018;    2008;     852;    1073;     626;     447;      83
9223;A028726;CR22  ;2019;    2123;     897;    1198;     685;     513;      28
9224;A028726;CR22  ;2020;    2334;     962;    1341;     766;     575;      31
9225;A028726;CR23  ;2012;   40669;   12285;   24386;   10076;   14310;    3998
9226;A028726;CR23  ;2013;   38922;   12321;   23653;    9781;   13872;    2948
9227;A028726;CR23  ;2014;   37462;   12088;   22679;    8933;   13746;    2695
9228;A028726;CR23  ;2015;   35365;   12052;   20968;    7766;   13202;    2345
9229;A028726;CR23  ;2016;   35883;   11133;   21961;    7057;   14904;    2789
9230;A028726;CR23  ;2017;   35519;   10771;   22066;    6812;   15254;    2682
9231;A028726;CR23  ;2018;   36464;   10669;   23460;    8066;   15394;    2335
9232;A028726;CR23  ;2019;   38847;   11367;   27108;    9054;   18054;     372
9233;A028726;CR23  ;2020;   38376;   11326;   26336;    8546;   17790;     714
9234;A028726;CR24  ;2012;    5839;    2825;    2726;    1113;    1613;     288
9235;A028726;CR24  ;2013;    6238;    2899;    2954;     961;    1993;     385
9236;A028726;CR24  ;2014;    6454;    2773;    3207;     993;    2214;     474
9237;A028726;CR24  ;2015;    6060;    2685;    2817;     896;    1921;     558
9238;A028726;CR24  ;2016;    5607;    2624;    2458;     624;    1834;     525
9239;A028726;CR24  ;2017;    5774;    2327;    2676;     709;    1967;     771
9240;A028726;CR24  ;2018;    5648;    2274;    2656;     714;    1942;     718
9241;A028726;CR24  ;2019;    5677;    2450;    3093;     996;    2097;     134
9242;A028726;CR24  ;2020;    5720;    2531;    3046;     930;    2116;     143
9243;A028726;CR25  ;2012;   10032;    4359;    4623;    1624;    2999;    1050
9244;A028726;CR25  ;2013;    9561;    4238;    4630;    1426;    3204;     693
9245;A028726;CR25  ;2014;    8950;    3727;    4366;    1375;    2991;     857
9246;A028726;CR25  ;2015;    8449;    3652;    3909;    1246;    2663;     888
9247;A028726;CR25  ;2016;    8595;    3608;    4048;    1121;    2927;     939
9248;A028726;CR25  ;2017;    8251;    3370;    3814;    1146;    2668;    1067
9249;A028726;CR25  ;2018;    7293;    3015;    3346;     885;    2461;     932
9250;A028726;CR25  ;2019;    7853;    3273;    4361;    1331;    3030;     219
9251;A028726;CR25  ;2020;    7967;    3335;    4407;    1296;    3111;     225
9252;A028726;CR26  ;2012;   28900;   10108;   16305;    3766;   12539;    2487
9253;A028726;CR26  ;2013;   29337;    9922;   16638;    4211;   12427;    2777
9254;A028726;CR26  ;2014;   31145;    9641;   16530;    3964;   12566;    4974
9255;A028726;CR26  ;2015;   29903;    9269;   15621;    4001;   11620;    5013
9256;A028726;CR26  ;2016;   28732;    8921;   15037;    3429;   11608;    4774
9257;A028726;CR26  ;2017;   27855;    8720;   15350;    3815;   11535;    3785
9258;A028726;CR26  ;2018;   25394;    8414;   13812;    2860;   10952;    3168
9259;A028726;CR26  ;2019;   25928;    9577;   15598;    4123;   11475;     753
9260;A028726;CR26  ;2020;   25987;    9329;   15826;    4351;   11475;     832
9261;A028726;CR27  ;2012;    4723;    1768;    2194;    1022;    1172;     761
9262;A028726;CR27  ;2013;    4619;    1810;    2274;     940;    1334;     535
9263;A028726;CR27  ;2014;    4435;    1635;    2278;     878;    1400;     522
9264;A028726;CR27  ;2015;    4393;    1666;    2188;     975;    1213;     539
9265;A028726;CR27  ;2016;    4232;    1581;    2047;     774;    1273;     604
9266;A028726;CR27  ;2017;    4231;    1369;    2262;     916;    1346;     600
9267;A028726;CR27  ;2018;    3933;    1344;    2110;     683;    1427;     479
9268;A028726;CR27  ;2019;    4012;    1686;    2093;     866;    1227;     233
9269;A028726;CR27  ;2020;    3912;    1703;    2089;     843;    1246;     120
9270;A028726;CR28  ;2012;    5042;    2436;    2202;     909;    1293;     404
9271;A028726;CR28  ;2013;    5141;    2430;    2396;    1038;    1358;     315
9272;A028726;CR28  ;2014;    5280;    2419;    2414;     863;    1551;     447
9273;A028726;CR28  ;2015;    5732;    2574;    2613;     927;    1686;     545
9274;A028726;CR28  ;2016;    5355;    2622;    2253;     758;    1495;     480
9275;A028726;CR28  ;2017;    5310;    2428;    2361;     917;    1444;     521
9276;A028726;CR28  ;2018;    4984;    2221;    2246;     791;    1455;     517
9277;A028726;CR28  ;2019;    4601;    2299;    2245;     817;    1428;      57
9278;A028726;CR28  ;2020;    4638;    2296;    2279;     730;    1549;      63
9279;A028726;CR29  ;2012;   39915;   12772;   22824;   11627;   11197;    4319
9280;A028726;CR29  ;2013;   37571;   12507;   22346;   11316;   11030;    2718
9281;A028726;CR29  ;2014;   38022;   12480;   22492;   10526;   11966;    3050
9282;A028726;CR29  ;2015;   36612;   11956;   20064;    9302;   10762;    4592
9283;A028726;CR29  ;2016;   33136;   11208;   18125;    7856;   10269;    3803
9284;A028726;CR29  ;2017;   31260;   10058;   17397;    7268;   10129;    3805
9285;A028726;CR29  ;2018;   30992;    9143;   18007;    7711;   10296;    3842
9286;A028726;CR29  ;2019;   30266;    9758;   20092;    8595;   11497;     416
9287;A028726;CR29  ;2020;   31382;    9664;   21253;    9020;   12233;     465
9288;A028726;CR30  ;2012;    8429;    3559;    3903;    1879;    2024;     967
9289;A028726;CR30  ;2013;    8082;    3291;    4181;    2259;    1922;     610
9290;A028726;CR30  ;2014;    7713;    3070;    4025;    1972;    2053;     618
9291;A028726;CR30  ;2015;    7230;    3050;    3471;    1706;    1765;     709
9292;A028726;CR30  ;2016;    7581;    3112;    3825;    1980;    1845;     644
9293;A028726;CR30  ;2017;    7657;    2938;    4039;    2022;    2017;     680
9294;A028726;CR30  ;2018;    7479;    2720;    4097;    1999;    2098;     662
9295;A028726;CR30  ;2019;    6653;    2685;    3886;    1901;    1985;      82
9296;A028726;CR30  ;2020;    6615;    2663;    3879;    1745;    2134;      73
9297;A028726;CR31  ;2012;    8002;    4776;    3052;     582;    2470;     174
9298;A028726;CR31  ;2013;    5439;    3142;    2164;     546;    1618;     133
9299;A028726;CR31  ;2014;    5760;    3154;    2286;     551;    1735;     320
9300;A028726;CR31  ;2015;    5618;    2989;    2416;     511;    1905;     213
9301;A028726;CR31  ;2016;    5737;    2941;    2473;     513;    1960;     323
9302;A028726;CR31  ;2017;    5615;    2850;    2521;     489;    2032;     244
9303;A028726;CR31  ;2018;    5642;    2615;    2763;     577;    2186;     264
9304;A028726;CR31  ;2019;    5922;    3142;    2029;     581;    1448;     751
9305;A028726;CR31  ;2020;    6060;    3002;    2064;     642;    1422;     994
9306;A028726;CR32  ;2012;   10496;    5071;    4577;    1334;    3243;     848
9307;A028726;CR32  ;2013;   10571;    5053;    4944;    1479;    3465;     574
9308;A028726;CR32  ;2014;   10543;    5039;    4627;    1240;    3387;     877
9309;A028726;CR32  ;2015;    9983;    4932;    4419;    1175;    3244;     632
9310;A028726;CR32  ;2016;    9935;    5061;    4140;    1036;    3104;     734
9311;A028726;CR32  ;2017;    9939;    4973;    4275;    1022;    3253;     691
9312;A028726;CR32  ;2018;    9848;    4952;    4188;     904;    3284;     708
9313;A028726;CR32  ;2019;    9801;    5294;    3766;    1083;    2683;     741
9314;A028726;CR32  ;2020;   10080;    5095;    3976;    1260;    2716;    1009
9315;A028726;CR33  ;2012;   11990;    5405;    5626;    2563;    3063;     959
9316;A028726;CR33  ;2013;   12030;    5375;    6014;    2521;    3493;     641
9317;A028726;CR33  ;2014;   12197;    5285;    6169;    2718;    3451;     743
9318;A028726;CR33  ;2015;   11687;    5249;    5720;    2475;    3245;     718
9319;A028726;CR33  ;2016;   10855;    4933;    5027;    2005;    3022;     895
9320;A028726;CR33  ;2017;   10803;    4505;    5443;    2012;    3431;     855
9321;A028726;CR33  ;2018;   10086;    4187;    5194;    1799;    3395;     705
9322;A028726;CR33  ;2019;   10236;    4651;    5374;    2125;    3249;     211
9323;A028726;CR33  ;2020;   10382;    4598;    5564;    2149;    3415;     220
9324;A028726;CR34  ;2012;    8197;    3619;    3910;    1682;    2228;     668
9325;A028726;CR34  ;2013;    7743;    3456;    3868;    1607;    2261;     419
9326;A028726;CR34  ;2014;    8845;    3307;    4529;    1778;    2751;    1009
9327;A028726;CR34  ;2015;    8772;    3285;    4566;    1812;    2754;     921
9328;A028726;CR34  ;2016;    8256;    3290;    4067;    1297;    2770;     899
9329;A028726;CR34  ;2017;    7682;    3015;    4015;    1165;    2850;     652
9330;A028726;CR34  ;2018;    7805;    2868;    4229;    1241;    2988;     708
9331;A028726;CR34  ;2019;    7599;    3240;    4203;    1529;    2674;     156
9332;A028726;CR34  ;2020;    7324;    3187;    3989;    1451;    2538;     148
9333;A028726;CR35  ;2012;   10969;    5216;    4279;    1640;    2639;    1474
9334;A028726;CR35  ;2013;   10790;    5118;    4458;    1654;    2804;    1214
9335;A028726;CR35  ;2014;   10876;    4980;    4348;    1496;    2852;    1548
9336;A028726;CR35  ;2015;   10693;    4846;    4259;    1428;    2831;    1588
9337;A028726;CR35  ;2016;   10634;    4720;    4048;    1431;    2617;    1866
9338;A028726;CR35  ;2017;   10092;    4379;    4326;    1291;    3035;    1387
9339;A028726;CR35  ;2018;   10067;    4219;    4411;    1342;    3069;    1437
9340;A028726;CR35  ;2019;   10372;    4865;    5225;    1710;    3515;     282
9341;A028726;CR35  ;2020;   10179;    4796;    5020;    1647;    3373;     363
9342;A028726;CR36  ;2012;   14277;    6502;    6205;    2727;    3478;    1570
9343;A028726;CR36  ;2013;   13740;    6264;    6322;    2718;    3604;    1154
9344;A028726;CR36  ;2014;   13729;    6035;    6261;    2868;    3393;    1433
9345;A028726;CR36  ;2015;   12360;    5734;    5348;    2149;    3199;    1278
9346;A028726;CR36  ;2016;   13348;    5352;    5416;    2080;    3336;    2580
9347;A028726;CR36  ;2017;   12946;    5077;    5916;    2198;    3718;    1953
9348;A028726;CR36  ;2018;   12365;    4809;    6069;    2034;    4035;    1487
9349;A028726;CR36  ;2019;   12493;    5446;    6858;    2066;    4792;     189
9350;A028726;CR36  ;2020;   12396;    5402;    6844;    2289;    4555;     150
9351;A028726;CR37  ;2012;    6125;    2493;    3058;    1199;    1859;     574
9352;A028726;CR37  ;2013;    6012;    2534;    3028;     999;    2029;     450
9353;A028726;CR37  ;2014;    5711;    2366;    2860;     938;    1922;     485
9354;A028726;CR37  ;2015;    5489;    2335;    2573;     822;    1751;     581
9355;A028726;CR37  ;2016;    5050;    2242;    2323;     655;    1668;     485
9356;A028726;CR37  ;2017;    4836;    2055;    2424;     742;    1682;     357
9357;A028726;CR37  ;2018;    4535;    1867;    2364;     573;    1791;     304
9358;A028726;CR37  ;2019;    4555;    2153;    2318;     717;    1601;      84
9359;A028726;CR37  ;2020;    4451;    2091;    2256;     597;    1659;     104
9360;A028726;CR38  ;2012;    5078;    2422;    2238;     954;    1284;     418
9361;A028726;CR38  ;2013;    5036;    2346;    2407;    1027;    1380;     283
9362;A028726;CR38  ;2014;    5588;    2230;    2250;     859;    1391;    1108
9363;A028726;CR38  ;2015;    5397;    2209;    1982;     690;    1292;    1206
9364;A028726;CR38  ;2016;    4965;    2148;    1960;     640;    1320;     857
9365;A028726;CR38  ;2017;    4371;    1997;    1789;     490;    1299;     585
9366;A028726;CR38  ;2018;    4430;    1847;    2007;     524;    1483;     576
9367;A028726;CR38  ;2019;    4450;    2082;    2221;     715;    1506;     147
9368;A028726;CR38  ;2020;    4470;    2097;    2211;     719;    1492;     162
9369;A028726;CR39  ;2012;   20224;    6994;   10312;    3562;    6750;    2918
9370;A028726;CR39  ;2013;   19531;    6871;   10565;    3964;    6601;    2095
9371;A028726;CR39  ;2014;   20050;    6689;   10875;    4256;    6619;    2486
9372;A028726;CR39  ;2015;   18867;    6575;   10141;    3719;    6422;    2151
9373;A028726;CR39  ;2016;   18354;    6371;    9675;    3434;    6241;    2308
9374;A028726;CR39  ;2017;   18656;    6070;   10323;    3538;    6785;    2263
9375;A028726;CR39  ;2018;   18015;    5507;   10381;    3311;    7070;    2127
9376;A028726;CR39  ;2019;   17359;    6401;   10472;    3317;    7155;     486
9377;A028726;CR39  ;2020;   16878;    6002;   10424;    3469;    6955;     452
9378;A028726;CR40  ;2012;    6425;    2720;    2590;     997;    1593;    1115
9379;A028726;CR40  ;2013;    6438;    2592;    3297;    1102;    2195;     549
9380;A028726;CR40  ;2014;    6255;    2514;    3467;     947;    2520;     274
9381;A028726;CR40  ;2015;    6066;    2481;    3225;     943;    2282;     360
9382;A028726;CR40  ;2016;    4914;    2090;    2541;     834;    1707;     283
9383;A028726;CR40  ;2017;    4752;    1890;    2585;     761;    1824;     277
9384;A028726;CR40  ;2018;    4700;    1872;    2520;     794;    1726;     308
9385;A028726;CR40  ;2019;    4899;    1984;    2870;    1051;    1819;      45
9386;A028726;CR40  ;2020;    5388;    2233;    3088;    1073;    2015;      67
9387;A028726;GM1680;2012;    1888;     694;     359;      45;     314;     835
9388;A028726;GM1680;2013;     802;     368;     238;      66;     172;     196
9389;A028726;GM1680;2014;     621;     318;     257;      84;     173;      46
9390;A028726;GM1680;2015;     600;     304;     238;      98;     140;      58
9391;A028726;GM1680;2016;     542;     283;     183;      45;     138;      76
9392;A028726;GM1680;2017;     543;     274;     196;      47;     149;      73
9393;A028726;GM1680;2018;     560;     274;     212;      53;     159;      74
9394;A028726;GM1680;2019;     581;     300;     276;     139;     137;       5
9395;A028726;GM1680;2020;     418;     230;     185;     120;      65;       3
9396;A028726;GM0738;2012;     292;     207;      79;      28;      51;       6
9397;A028726;GM0738;2013;     311;     207;      99;      40;      59;       5
9398;A028726;GM0738;2014;     348;     207;      99;      41;      58;      42
9399;A028726;GM0738;2015;     329;     189;      89;      37;      52;      51
9400;A028726;GM0738;2016;     323;     204;     109;      65;      44;      10
9401;A028726;GM0738;2017;     312;     180;     127;      59;      68;       5
9402;A028726;GM0738;2018;     285;     152;     107;      52;      55;      26
9403;A028726;GM0738;2019;;;;;;
9404;A028726;GM0738;2020;;;;;;
9405;A028726;GM0358;2012;     651;     332;     262;      58;     204;      57
9406;A028726;GM0358;2013;     643;     314;     297;      48;     249;      32
9407;A028726;GM0358;2014;     748;     330;     351;     105;     246;      67
9408;A028726;GM0358;2015;     654;     302;     293;      67;     226;      59
9409;A028726;GM0358;2016;     588;     297;     219;      36;     183;      72
9410;A028726;GM0358;2017;     557;     227;     265;      68;     197;      65
9411;A028726;GM0358;2018;     471;     198;     234;      64;     170;      39
9412;A028726;GM0358;2019;     522;     238;     282;      60;     222;       2
9413;A028726;GM0358;2020;     535;     257;     276;      78;     198;       2
9414;A028726;GM0197;2012;     688;     360;     298;     104;     194;      30
9415;A028726;GM0197;2013;     527;     343;     171;      66;     105;      13
9416;A028726;GM0197;2014;     644;     332;     206;      99;     107;     106
9417;A028726;GM0197;2015;     583;     301;     185;      85;     100;      97
9418;A028726;GM0197;2016;     513;     264;     150;      58;      92;      99
9419;A028726;GM0197;2017;     518;     246;     168;      51;     117;     104
9420;A028726;GM0197;2018;     535;     247;     181;      61;     120;     107
9421;A028726;GM0197;2019;     485;     243;     239;      56;     183;       3
9422;A028726;GM0197;2020;     385;     236;     141;      51;      90;       8
9423;A028726;GM0059;2012;     386;     219;     140;      74;      66;      27
9424;A028726;GM0059;2013;     357;     204;     147;      73;      74;       6
9425;A028726;GM0059;2014;     374;     223;     141;      86;      55;      10
9426;A028726;GM0059;2015;     344;     212;     122;      79;      43;      10
9427;A028726;GM0059;2016;     311;     189;     109;      73;      36;      13
9428;A028726;GM0059;2017;     361;     191;     154;     108;      46;      16
9429;A028726;GM0059;2018;     346;     179;     149;      94;      55;      18
9430;A028726;GM0059;2019;     361;     209;     149;      97;      52;       3
9431;A028726;GM0059;2020;     340;     188;     152;     101;      51;       0
9432;A028726;GM0482;2012;     363;     166;     194;      83;     111;       3
9433;A028726;GM0482;2013;     312;     148;     162;      79;      83;       2
9434;A028726;GM0482;2014;     284;     137;     145;      73;      72;       2
9435;A028726;GM0482;2015;     269;     134;     123;      77;      46;      12
9436;A028726;GM0482;2016;     281;     133;     133;      86;      47;      15
9437;A028726;GM0482;2017;     289;     146;     140;      83;      57;       3
9438;A028726;GM0482;2018;     265;     119;     138;      72;      66;       8
9439;A028726;GM0482;2019;     276;     151;     123;      70;      53;       2
9440;A028726;GM0482;2020;     263;     115;     145;      85;      60;       3
9441;A028726;GM0613;2012;     374;     192;     121;      45;      76;      61
9442;A028726;GM0613;2013;     320;     177;     117;      34;      83;      26
9443;A028726;GM0613;2014;     387;     175;     127;      36;      91;      85
9444;A028726;GM0613;2015;     351;     160;     108;      36;      72;      83
9445;A028726;GM0613;2016;     333;     156;      94;      32;      62;      83
9446;A028726;GM0613;2017;     351;     149;     117;      46;      71;      85
9447;A028726;GM0613;2018;     363;     149;     130;      46;      84;      84
9448;A028726;GM0613;2019;     325;     142;     177;      90;      87;       6
9449;A028726;GM0613;2020;     356;     168;     183;      95;      88;       5
9450;A028726;GM0361;2012;    1603;     649;     785;     337;     448;     169
9451;A028726;GM0361;2013;    1759;     687;     919;     375;     544;     153
9452;A028726;GM0361;2014;    1786;     673;     867;     379;     488;     246
9453;A028726;GM0361;2015;    1974;     737;     831;     333;     498;     406
9454;A028726;GM0361;2016;    1924;     701;     831;     361;     470;     392
9455;A028726;GM0361;2017;    1756;     626;     801;     348;     453;     329
9456;A028726;GM0361;2018;    1662;     633;     771;     296;     475;     258
9457;A028726;GM0361;2019;    1719;     700;    1008;     341;     667;      11
9458;A028726;GM0361;2020;    1616;     709;     893;     321;     572;      14
9459;A028726;GM0141;2012;    1623;     539;    1012;     622;     390;      72
9460;A028726;GM0141;2013;    1518;     475;     980;     581;     399;      63
9461;A028726;GM0141;2014;    1568;     489;    1020;     585;     435;      59
9462;A028726;GM0141;2015;    1572;     489;     982;     584;     398;     101
9463;A028726;GM0141;2016;    1546;     476;     942;     517;     425;     128
9464;A028726;GM0141;2017;    1620;     452;    1088;     532;     556;      80
9465;A028726;GM0141;2018;    1432;     467;     886;     373;     513;      79
9466;A028726;GM0141;2019;    1454;     539;     903;     385;     518;      12
9467;A028726;GM0141;2020;    1447;     496;     939;     439;     500;      12
9468;A028726;GM0034;2012;    2211;    1032;    1099;     517;     582;      80
9469;A028726;GM0034;2013;    2263;     969;    1250;     609;     641;      44
9470;A028726;GM0034;2014;    2001;     886;    1073;     436;     637;      42
9471;A028726;GM0034;2015;    1916;     945;     896;     387;     509;      75
9472;A028726;GM0034;2016;    1730;     867;     781;     329;     452;      82
9473;A028726;GM0034;2017;    1669;     758;     829;     321;     508;      82
9474;A028726;GM0034;2018;    1769;     750;     921;     346;     575;      98
9475;A028726;GM0034;2019;    1873;     753;    1107;     556;     551;      13
9476;A028726;GM0034;2020;    2145;     875;    1248;     569;     679;      22
9477;A028726;GM0484;2012;    1058;     506;     489;     237;     252;      63
9478;A028726;GM0484;2013;     990;     443;     488;     217;     271;      59
9479;A028726;GM0484;2014;    1481;     710;     672;     261;     411;      99
9480;A028726;GM0484;2015;    1329;     690;     542;     199;     343;      97
9481;A028726;GM0484;2016;    1273;     664;     494;     179;     315;     115
9482;A028726;GM0484;2017;    1427;     600;     671;     310;     361;     156
9483;A028726;GM0484;2018;    1307;     554;     647;     277;     370;     106
9484;A028726;GM0484;2019;    1231;     639;     575;     229;     346;      17
9485;A028726;GM0484;2020;    1219;     622;     577;     202;     375;      20
9486;A028726;GM1723;2012;     349;     166;     149;      35;     114;      34
9487;A028726;GM1723;2013;     305;     166;     107;      18;      89;      32
9488;A028726;GM1723;2014;     295;     158;     122;      17;     105;      15
9489;A028726;GM1723;2015;     289;     147;     113;      21;      92;      29
9490;A028726;GM1723;2016;     270;     142;     105;      13;      92;      23
9491;A028726;GM1723;2017;     276;     137;     112;      17;      95;      27
9492;A028726;GM1723;2018;     275;     135;     120;      21;      99;      20
9493;A028726;GM1723;2019;     277;     159;     116;      27;      89;       2
9494;A028726;GM1723;2020;     260;     152;     105;      26;      79;       3
9495;A028726;GM1959;2012;;;;;;
9496;A028726;GM1959;2013;;;;;;
9497;A028726;GM1959;2014;;;;;;
9498;A028726;GM1959;2015;;;;;;
9499;A028726;GM1959;2016;;;;;;
9500;A028726;GM1959;2017;;;;;;
9501;A028726;GM1959;2018;;;;;;
9502;A028726;GM1959;2019;     893;     556;     307;     139;     168;      30
9503;A028726;GM1959;2020;     808;     498;     299;     122;     177;      11
9504;A028726;GM0060;2012;     185;     112;      47;       0;      47;      26
9505;A028726;GM0060;2013;     183;     112;      43;       0;      43;      28
9506;A028726;GM0060;2014;     211;     109;      50;       0;      50;      52
9507;A028726;GM0060;2015;     218;     105;      58;       0;      58;      55
9508;A028726;GM0060;2016;     223;      99;      61;       0;      61;      63
9509;A028726;GM0060;2017;     208;      86;      59;       0;      59;      63
9510;A028726;GM0060;2018;     216;      84;      65;       0;      65;      67
9511;A028726;GM0060;2019;     226;     132;      87;       0;      87;       7
9512;A028726;GM0060;2020;     227;     129;      88;       0;      88;      10
9513;A028726;GM0307;2012;    3078;    1270;    1625;     710;     915;     183
9514;A028726;GM0307;2013;    2492;     980;    1406;     681;     725;     106
9515;A028726;GM0307;2014;    2328;     837;    1343;     698;     645;     148
9516;A028726;GM0307;2015;    1987;     805;    1088;     469;     619;      94
9517;A028726;GM0307;2016;    1845;     670;    1000;     428;     572;     175
9518;A028726;GM0307;2017;    2057;     677;    1260;     533;     727;     120
9519;A028726;GM0307;2018;    1899;     610;    1182;     538;     644;     107
9520;A028726;GM0307;2019;    1618;     597;    1008;     427;     581;      13
9521;A028726;GM0307;2020;    1592;     604;     973;     437;     536;      15
9522;A028726;GM0362;2012;    2576;     982;    1241;     287;     954;     353
9523;A028726;GM0362;2013;    2450;     970;    1227;     259;     968;     253
9524;A028726;GM0362;2014;    2788;     967;    1624;     523;    1101;     197
9525;A028726;GM0362;2015;    2444;     865;    1476;     421;    1055;     103
9526;A028726;GM0362;2016;    2215;     754;    1244;     241;    1003;     217
9527;A028726;GM0362;2017;    2690;     787;    1287;     266;    1021;     616
9528;A028726;GM0362;2018;    2855;     790;    1402;     277;    1125;     663
9529;A028726;GM0362;2019;    2613;     746;    1850;     264;    1586;      17
9530;A028726;GM0362;2020;    2706;     785;    1884;     315;    1569;      37
9531;A028726;GM0363;2012;   30581;    7968;   19741;    8458;   11283;    2872
9532;A028726;GM0363;2013;   29129;    8019;   19083;    8102;   10981;    2027
9533;A028726;GM0363;2014;   27484;    7897;   17913;    7230;   10683;    1674
9534;A028726;GM0363;2015;   26536;    8292;   16791;    6343;   10448;    1453
9535;A028726;GM0363;2016;   27446;    7557;   18290;    5951;   12339;    1599
9536;A028726;GM0363;2017;   27319;    7465;   18379;    5788;   12591;    1475
9537;A028726;GM0363;2018;   28089;    7430;   19488;    6851;   12637;    1171
9538;A028726;GM0363;2019;   29925;    7831;   21784;    7316;   14468;     310
9539;A028726;GM0363;2020;   28995;    7591;   20780;    6957;   13823;     624
9540;A028726;GM0200;2012;    3558;    1124;    1979;     671;    1308;     455
9541;A028726;GM0200;2013;    3352;    1061;    1964;     638;    1326;     327
9542;A028726;GM0200;2014;    3105;    1110;    1757;     441;    1316;     238
9543;A028726;GM0200;2015;    2869;    1134;    1605;     486;    1119;     130
9544;A028726;GM0200;2016;    2882;    1116;    1619;     440;    1179;     147
9545;A028726;GM0200;2017;    2870;    1095;    1585;     490;    1095;     190
9546;A028726;GM0200;2018;    2657;     997;    1516;     455;    1061;     144
9547;A028726;GM0200;2019;    2728;    1101;    1582;     625;     957;      45
9548;A028726;GM0200;2020;    2639;    1074;    1543;     514;    1029;      22
9549;A028726;GM0003;2012;     305;      84;     217;     115;     102;       4
9550;A028726;GM0003;2013;     356;      92;     261;     202;      59;       3
9551;A028726;GM0003;2014;     322;      84;     236;     169;      67;       2
9552;A028726;GM0003;2015;     276;      73;     200;     153;      47;       3
9553;A028726;GM0003;2016;     259;      71;     186;     132;      54;       2
9554;A028726;GM0003;2017;     252;      82;     167;     116;      51;       3
9555;A028726;GM0003;2018;     287;      79;     186;     122;      64;      22
9556;A028726;GM0003;2019;     411;      76;     335;     181;     154;       0
9557;A028726;GM0003;2020;     403;      92;     311;     175;     136;       0
9558;A028726;GM0202;2012;    3335;    1055;    1845;     757;    1088;     435
9559;A028726;GM0202;2013;    3542;     986;    2412;     978;    1434;     144
9560;A028726;GM0202;2014;    3393;     935;    2258;     720;    1538;     200
9561;A028726;GM0202;2015;    3451;     994;    2160;     712;    1448;     297
9562;A028726;GM0202;2016;    3340;     839;    2055;     602;    1453;     446
9563;A028726;GM0202;2017;    3258;     808;    1999;     602;    1397;     451
9564;A028726;GM0202;2018;    2892;     736;    1931;     705;    1226;     225
9565;A028726;GM0202;2019;    2838;     764;    1959;     706;    1253;     115
9566;A028726;GM0202;2020;    2875;     765;    2029;     714;    1315;      81
9567;A028726;GM0106;2012;    1073;     403;     559;     283;     276;     111
9568;A028726;GM0106;2013;    1280;     410;     733;     389;     344;     137
9569;A028726;GM0106;2014;    1323;     399;     862;     405;     457;      62
9570;A028726;GM0106;2015;    1324;     390;     758;     360;     398;     176
9571;A028726;GM0106;2016;    1029;     365;     554;     185;     369;     110
9572;A028726;GM0106;2017;    1050;     337;     591;     224;     367;     122
9573;A028726;GM0106;2018;    1213;     316;     737;     314;     423;     160
9574;A028726;GM0106;2019;    1005;     316;     634;     226;     408;      55
9575;A028726;GM0106;2020;    1061;     299;     709;     287;     422;      53
9576;A028726;GM0743;2012;     210;     105;      83;      49;      34;      22
9577;A028726;GM0743;2013;     226;     123;      84;      50;      34;      19
9578;A028726;GM0743;2014;     221;     122;      79;      33;      46;      20
9579;A028726;GM0743;2015;     168;      89;      69;      35;      34;      10
9580;A028726;GM0743;2016;     149;      84;      55;      21;      34;      10
9581;A028726;GM0743;2017;     150;      82;      60;      27;      33;       8
9582;A028726;GM0743;2018;     168;      87;      70;      32;      38;      11
9583;A028726;GM0743;2019;     169;      91;      76;      33;      43;       2
9584;A028726;GM0743;2020;     182;      96;      83;      49;      34;       3
9585;A028726;GM0744;2012;     190;     109;      65;       9;      56;      16
9586;A028726;GM0744;2013;     210;     123;      72;       8;      64;      15
9587;A028726;GM0744;2014;     230;     134;      80;       7;      73;      16
9588;A028726;GM0744;2015;     221;     132;      78;       7;      71;      11
9589;A028726;GM0744;2016;     217;     132;      73;       6;      67;      12
9590;A028726;GM0744;2017;     224;     132;      77;       7;      70;      15
9591;A028726;GM0744;2018;     213;     125;      78;       5;      73;      10
9592;A028726;GM0744;2019;     197;     122;      65;      10;      55;      10
9593;A028726;GM0744;2020;     191;     125;      53;       7;      46;      13
9594;A028726;GM0308;2012;     737;     310;     293;     124;     169;     134
9595;A028726;GM0308;2013;     917;     299;     473;     218;     255;     145
9596;A028726;GM0308;2014;     990;     302;     471;     159;     312;     217
9597;A028726;GM0308;2015;     971;     284;     390;      81;     309;     297
9598;A028726;GM0308;2016;     902;     267;     338;      67;     271;     297
9599;A028726;GM0308;2017;     970;     265;     364;      84;     280;     341
9600;A028726;GM0308;2018;     778;     228;     318;      77;     241;     232
9601;A028726;GM0308;2019;     775;     240;     533;     127;     406;       2
9602;A028726;GM0308;2020;     719;     238;     475;     114;     361;       6
9603;A028726;GM0489;2012;     552;     260;     207;      63;     144;      85
9604;A028726;GM0489;2013;     568;     263;     279;      63;     216;      26
9605;A028726;GM0489;2014;     588;     266;     311;     102;     209;      11
9606;A028726;GM0489;2015;     534;     278;     244;      69;     175;      12
9607;A028726;GM0489;2016;     449;     254;     183;      42;     141;      12
9608;A028726;GM0489;2017;     449;     252;     178;      46;     132;      19
9609;A028726;GM0489;2018;     408;     228;     161;      49;     112;      19
9610;A028726;GM0489;2019;     401;     215;     183;      93;      90;       3
9611;A028726;GM0489;2020;     451;     245;     198;      88;     110;       8
9612;A028726;GM0203;2012;     981;     485;     368;      89;     279;     128
9613;A028726;GM0203;2013;     949;     453;     373;      84;     289;     123
9614;A028726;GM0203;2014;     961;     433;     369;     106;     263;     159
9615;A028726;GM0203;2015;     979;     448;     370;     113;     257;     161
9616;A028726;GM0203;2016;     881;     450;     312;      76;     236;     119
9617;A028726;GM0203;2017;     887;     415;     344;      86;     258;     128
9618;A028726;GM0203;2018;     948;     414;     347;      92;     255;     187
9619;A028726;GM0203;2019;     960;     480;     475;     152;     323;       5
9620;A028726;GM0203;2020;     929;     481;     439;     137;     302;       9
9621;A028726;GM0005;2012;     172;      70;     100;      47;      53;       2
9622;A028726;GM0005;2013;     182;      66;     114;      46;      68;       2
9623;A028726;GM0005;2014;     180;      67;     108;      24;      84;       5
9624;A028726;GM0005;2015;     201;      66;     131;      82;      49;       4
9625;A028726;GM0005;2016;     195;      59;     130;      97;      33;       6
9626;A028726;GM0005;2017;     145;      52;      86;      42;      44;       7
9627;A028726;GM0005;2018;     162;      53;     102;      55;      47;       7
9628;A028726;GM0005;2019;;;;;;
9629;A028726;GM0005;2020;;;;;;
9630;A028726;GM0888;2012;     241;     143;      85;      19;      66;      13
9631;A028726;GM0888;2013;     271;     154;      99;      31;      68;      18
9632;A028726;GM0888;2014;     302;     166;     118;      59;      59;      18
9633;A028726;GM0888;2015;     259;     163;      80;      21;      59;      16
9634;A028726;GM0888;2016;     252;     149;      87;      31;      56;      16
9635;A028726;GM0888;2017;     257;     136;     104;      35;      69;      17
9636;A028726;GM0888;2018;     258;     129;     110;      32;      78;      19
9637;A028726;GM0888;2019;     257;     133;     119;      36;      83;       5
9638;A028726;GM0888;2020;     285;     155;     127;      54;      73;       3
9639;A028726;GM1954;2012;;;;;;
9640;A028726;GM1954;2013;;;;;;
9641;A028726;GM1954;2014;;;;;;
9642;A028726;GM1954;2015;;;;;;
9643;A028726;GM1954;2016;;;;;;
9644;A028726;GM1954;2017;;;;;;
9645;A028726;GM1954;2018;;;;;;
9646;A028726;GM1954;2019;     957;     494;     446;     102;     344;      17
9647;A028726;GM1954;2020;     864;     466;     381;      58;     323;      17
9648;A028726;GM0370;2012;     124;      74;      46;      15;      31;       4
9649;A028726;GM0370;2013;     108;      68;      38;       6;      32;       2
9650;A028726;GM0370;2014;     132;      74;      50;       9;      41;       8
9651;A028726;GM0370;2015;     127;      72;      50;      10;      40;       5
9652;A028726;GM0370;2016;     118;      68;      48;      11;      37;       2
9653;A028726;GM0370;2017;     132;      75;      52;      10;      42;       5
9654;A028726;GM0370;2018;     118;      67;      50;       6;      44;       1
9655;A028726;GM0370;2019;     126;      81;      43;       7;      36;       2
9656;A028726;GM0370;2020;     138;      82;      51;       8;      43;       5
9657;A028726;GM0889;2012;     220;      99;      77;      44;      33;      44
9658;A028726;GM0889;2013;     222;      99;      95;      59;      36;      28
9659;A028726;GM0889;2014;     184;      94;      82;      53;      29;       8
9660;A028726;GM0889;2015;     205;     105;      91;      66;      25;       9
9661;A028726;GM0889;2016;     171;     101;      61;      40;      21;       9
9662;A028726;GM0889;2017;     153;      93;      52;      27;      25;       8
9663;A028726;GM0889;2018;     158;      75;      75;      48;      27;       8
9664;A028726;GM0889;2019;     138;      91;      47;      32;      15;       0
9665;A028726;GM0889;2020;     135;      82;      52;      38;      14;       1
9666;A028726;GM0007;2012;     288;     132;     131;      65;      66;      25
9667;A028726;GM0007;2013;     243;     123;      98;      52;      46;      22
9668;A028726;GM0007;2014;     248;     141;      88;      35;      53;      19
9669;A028726;GM0007;2015;     247;     133;      95;      40;      55;      19
9670;A028726;GM0007;2016;     237;     131;      87;      35;      52;      19
9671;A028726;GM0007;2017;     220;     120;      81;      23;      58;      19
9672;A028726;GM0007;2018;;;;;;
9673;A028726;GM0007;2019;;;;;;
9674;A028726;GM0007;2020;;;;;;
9675;A028726;GM1945;2012;;;;;;
9676;A028726;GM1945;2013;;;;;;
9677;A028726;GM1945;2014;;;;;;
9678;A028726;GM1945;2015;;;;;;
9679;A028726;GM1945;2016;     664;     314;     292;     119;     173;      58
9680;A028726;GM1945;2017;     565;     243;     258;      80;     178;      64
9681;A028726;GM1945;2018;     535;     206;     256;      83;     173;      73
9682;A028726;GM1945;2019;     570;     247;     269;     101;     168;      54
9683;A028726;GM1945;2020;     522;     244;     215;      66;     149;      63
9684;A028726;GM0491;2012;     267;     127;     118;      80;      38;      22
9685;A028726;GM0491;2013;     220;     120;      78;      31;      47;      22
9686;A028726;GM0491;2014;     250;     122;     119;      74;      45;       9
9687;A028726;GM0491;2015;;;;;;
9688;A028726;GM0491;2016;;;;;;
9689;A028726;GM0491;2017;;;;;;
9690;A028726;GM0491;2018;;;;;;
9691;A028726;GM0491;2019;;;;;;
9692;A028726;GM0491;2020;;;;;;
9693;A028726;GM1724;2012;     399;     272;     103;      19;      84;      24
9694;A028726;GM1724;2013;     407;     256;     126;      33;      93;      25
9695;A028726;GM1724;2014;     403;     248;     105;      19;      86;      50
9696;A028726;GM1724;2015;     361;     230;      97;      20;      77;      34
9697;A028726;GM1724;2016;     371;     237;     105;      29;      76;      29
9698;A028726;GM1724;2017;     327;     209;      89;      18;      71;      29
9699;A028726;GM1724;2018;     315;     190;      96;      23;      73;      29
9700;A028726;GM1724;2019;     330;     224;     102;      34;      68;       4
9701;A028726;GM1724;2020;     332;     227;     102;      36;      66;       3
9702;A028726;GM0893;2012;     202;     132;      59;      18;      41;      11
9703;A028726;GM0893;2013;     211;     136;      73;      11;      62;       2
9704;A028726;GM0893;2014;     209;     115;      92;      28;      64;       2
9705;A028726;GM0893;2015;     228;     132;      92;      40;      52;       4
9706;A028726;GM0893;2016;     217;     138;      75;      20;      55;       4
9707;A028726;GM0893;2017;     221;     127;      88;      22;      66;       6
9708;A028726;GM0893;2018;     214;     123;      87;      23;      64;       4
9709;A028726;GM0893;2019;     198;     129;      64;      30;      34;       5
9710;A028726;GM0893;2020;     217;     123;      88;      42;      46;       6
9711;A028726;GM0373;2012;    1787;     969;     544;      45;     499;     274
9712;A028726;GM0373;2013;    1754;     972;     545;      47;     498;     237
9713;A028726;GM0373;2014;    1735;     940;     550;      31;     519;     245
9714;A028726;GM0373;2015;    1710;     947;     521;      37;     484;     242
9715;A028726;GM0373;2016;    1610;     936;     503;      30;     473;     171
9716;A028726;GM0373;2017;    1583;     923;     494;      27;     467;     166
9717;A028726;GM0373;2018;    1596;     934;     525;      49;     476;     137
9718;A028726;GM0373;2019;    1599;     954;     612;      66;     546;      33
9719;A028726;GM0373;2020;    1609;     933;     617;      48;     569;      59
9720;A028726;GM0748;2012;    1758;     621;    1050;     465;     585;      87
9721;A028726;GM0748;2013;    1596;     563;     989;     482;     507;      44
9722;A028726;GM0748;2014;    1586;     517;    1027;     519;     508;      42
9723;A028726;GM0748;2015;    1624;     513;    1056;     582;     474;      55
9724;A028726;GM0748;2016;    1314;     529;     741;     418;     323;      44
9725;A028726;GM0748;2017;    1413;     478;     882;     501;     381;      53
9726;A028726;GM0748;2018;    1299;     467;     782;     389;     393;      50
9727;A028726;GM0748;2019;    1332;     492;     816;     421;     395;      24
9728;A028726;GM0748;2020;    1386;     486;     886;     454;     432;      14
9729;A028726;GM1859;2012;     935;     421;     393;     141;     252;     121
9730;A028726;GM1859;2013;    1024;     450;     459;     194;     265;     115
9731;A028726;GM1859;2014;    1098;     474;     534;     234;     300;      90
9732;A028726;GM1859;2015;     847;     415;     364;     145;     219;      68
9733;A028726;GM1859;2016;     876;     386;     387;     141;     246;     103
9734;A028726;GM1859;2017;     819;     357;     386;     160;     226;      76
9735;A028726;GM1859;2018;     751;     349;     340;     122;     218;      62
9736;A028726;GM1859;2019;     751;     399;     344;     205;     139;       8
9737;A028726;GM1859;2020;     692;     384;     300;     148;     152;       8
9738;A028726;GM1721;2012;     425;     238;     160;      73;      87;      27
9739;A028726;GM1721;2013;     402;     221;     162;      47;     115;      19
9740;A028726;GM1721;2014;     620;     233;     303;      74;     229;      84
9741;A028726;GM1721;2015;     637;     231;     328;      77;     251;      78
9742;A028726;GM1721;2016;     593;     231;     279;      75;     204;      83
9743;A028726;GM1721;2017;     525;     234;     249;      49;     200;      42
9744;A028726;GM1721;2018;     537;     216;     283;      73;     210;      38
9745;A028726;GM1721;2019;     523;     291;     224;      42;     182;       8
9746;A028726;GM1721;2020;     476;     290;     184;      52;     132;       2
9747;A028726;GM0568;2012;     275;     104;     126;      49;      77;      45
9748;A028726;GM0568;2013;     343;     156;     150;      22;     128;      37
9749;A028726;GM0568;2014;     334;     163;     161;      26;     135;      10
9750;A028726;GM0568;2015;;;;;;
9751;A028726;GM0568;2016;;;;;;
9752;A028726;GM0568;2017;;;;;;
9753;A028726;GM0568;2018;;;;;;
9754;A028726;GM0568;2019;;;;;;
9755;A028726;GM0568;2020;;;;;;
9756;A028726;GM0753;2012;     393;     225;     157;      69;      88;      11
9757;A028726;GM0753;2013;     366;     217;     139;      46;      93;      10
9758;A028726;GM0753;2014;     446;     168;     173;      79;      94;     105
9759;A028726;GM0753;2015;     311;     182;     111;      35;      76;      18
9760;A028726;GM0753;2016;     282;     161;     109;      39;      70;      12
9761;A028726;GM0753;2017;     431;     196;     194;      83;     111;      41
9762;A028726;GM0753;2018;     327;     136;     146;      27;     119;      45
9763;A028726;GM0753;2019;     329;     144;     173;      57;     116;      12
9764;A028726;GM0753;2020;     326;     148;     175;      50;     125;       3
9765;A028726;GM0209;2012;     312;     139;     159;      49;     110;      14
9766;A028726;GM0209;2013;     273;     145;     114;      35;      79;      14
9767;A028726;GM0209;2014;     316;     139;     160;      69;      91;      17
9768;A028726;GM0209;2015;     287;     152;     116;      48;      68;      19
9769;A028726;GM0209;2016;     297;     137;     137;      39;      98;      23
9770;A028726;GM0209;2017;     345;     145;     164;      51;     113;      36
9771;A028726;GM0209;2018;     306;     133;     140;      48;      92;      33
9772;A028726;GM0209;2019;     279;     121;     153;      37;     116;       5
9773;A028726;GM0209;2020;     245;     141;      97;      36;      61;       7
9774;A028726;GM0375;2012;     973;     405;     517;     267;     250;      51
9775;A028726;GM0375;2013;    1026;     395;     601;     333;     268;      30
9776;A028726;GM0375;2014;     991;     372;     589;     119;     470;      30
9777;A028726;GM0375;2015;     970;     394;     543;     139;     404;      33
9778;A028726;GM0375;2016;     894;     394;     461;     176;     285;      39
9779;A028726;GM0375;2017;     921;     384;     492;     153;     339;      45
9780;A028726;GM0375;2018;     919;     319;     567;     276;     291;      33
9781;A028726;GM0375;2019;     953;     375;     569;     194;     375;       9
9782;A028726;GM0375;2020;     867;     366;     491;     144;     347;      10
9783;A028726;GM0063;2012;     271;     100;     168;      74;      94;       3
9784;A028726;GM0063;2013;     262;     104;     156;      71;      85;       2
9785;A028726;GM0063;2014;     301;     118;     180;     101;      79;       3
9786;A028726;GM0063;2015;     253;     117;     123;      77;      46;      13
9787;A028726;GM0063;2016;     218;     115;      95;      49;      46;       8
9788;A028726;GM0063;2017;     199;     113;      72;      25;      47;      14
9789;A028726;GM0063;2018;;;;;;
9790;A028726;GM0063;2019;;;;;;
9791;A028726;GM0063;2020;;;;;;
9792;A028726;GM0310;2012;    1127;     464;     496;     147;     349;     167
9793;A028726;GM0310;2013;    1130;     462;     503;     135;     368;     165
9794;A028726;GM0310;2014;     961;     360;     468;     170;     298;     133
9795;A028726;GM0310;2015;     845;     356;     401;     111;     290;      88
9796;A028726;GM0310;2016;     793;     341;     372;      84;     288;      80
9797;A028726;GM0310;2017;     729;     291;     358;      64;     294;      80
9798;A028726;GM0310;2018;     716;     271;     386;      55;     331;      59
9799;A028726;GM0310;2019;     862;     394;     450;     179;     271;      18
9800;A028726;GM0310;2020;     785;     367;     395;     131;     264;      23
9801;A028726;GM0585;2012;     563;     242;     226;     145;      81;      95
9802;A028726;GM0585;2013;     556;     242;     270;     180;      90;      44
9803;A028726;GM0585;2014;     551;     230;     293;     217;      76;      28
9804;A028726;GM0585;2015;     472;     242;     204;     134;      70;      26
9805;A028726;GM0585;2016;     482;     273;     180;     131;      49;      29
9806;A028726;GM0585;2017;     493;     266;     197;     135;      62;      30
9807;A028726;GM0585;2018;     495;     260;     216;     138;      78;      19
9808;A028726;GM0585;2019;;;;;;
9809;A028726;GM0585;2020;;;;;;
9810;A028726;GM1728;2012;     397;     225;     155;      58;      97;      17
9811;A028726;GM1728;2013;     337;     207;     120;      31;      89;      10
9812;A028726;GM1728;2014;     350;     196;     129;      28;     101;      25
9813;A028726;GM1728;2015;     317;     180;     106;      20;      86;      31
9814;A028726;GM1728;2016;     318;     170;     105;      24;      81;      43
9815;A028726;GM1728;2017;     295;     150;     106;      26;      80;      39
9816;A028726;GM1728;2018;     313;     150;     122;      29;      93;      41
9817;A028726;GM1728;2019;     330;     195;     132;      23;     109;       3
9818;A028726;GM1728;2020;     343;     193;     143;      25;     118;       7
9819;A028726;GM0376;2012;     229;     133;      86;       9;      77;      10
9820;A028726;GM0376;2013;     231;     121;      78;      11;      67;      32
9821;A028726;GM0376;2014;     242;     124;     105;      16;      89;      13
9822;A028726;GM0376;2015;     218;     117;      86;       8;      78;      15
9823;A028726;GM0376;2016;     229;     133;      82;      13;      69;      14
9824;A028726;GM0376;2017;     249;     131;     104;      20;      84;      14
9825;A028726;GM0376;2018;     253;     144;      98;      19;      79;      11
9826;A028726;GM0376;2019;     223;     144;      72;      19;      53;       7
9827;A028726;GM0376;2020;     264;     155;      73;      13;      60;      36
9828;A028726;GM0377;2012;     549;     279;     257;     110;     147;      13
9829;A028726;GM0377;2013;     464;     263;     196;      37;     159;       5
9830;A028726;GM0377;2014;     469;     271;     195;      36;     159;       3
9831;A028726;GM0377;2015;     435;     233;     197;      23;     174;       5
9832;A028726;GM0377;2016;     465;     284;     171;      24;     147;      10
9833;A028726;GM0377;2017;     451;     253;     178;      20;     158;      20
9834;A028726;GM0377;2018;     509;     242;     189;      24;     165;      78
9835;A028726;GM0377;2019;     491;     253;     209;      58;     151;      29
9836;A028726;GM0377;2020;     492;     250;     214;      58;     156;      28
9837;A028726;GM0055;2012;     455;     256;     177;     121;      56;      22
9838;A028726;GM0055;2013;     430;     255;     161;      94;      67;      14
9839;A028726;GM0055;2014;;;;;;
9840;A028726;GM0055;2015;;;;;;
9841;A028726;GM0055;2016;;;;;;
9842;A028726;GM0055;2017;;;;;;
9843;A028726;GM0055;2018;;;;;;
9844;A028726;GM0055;2019;;;;;;
9845;A028726;GM0055;2020;;;;;;
9846;A028726;GM1901;2012;     947;     502;     328;      94;     234;     117
9847;A028726;GM1901;2013;     968;     464;     422;     146;     276;      82
9848;A028726;GM1901;2014;     884;     489;     320;      90;     230;      75
9849;A028726;GM1901;2015;     835;     454;     298;      73;     225;      83
9850;A028726;GM1901;2016;     849;     480;     279;      54;     225;      90
9851;A028726;GM1901;2017;     761;     426;     248;      51;     197;      87
9852;A028726;GM1901;2018;     820;     432;     268;      76;     192;     120
9853;A028726;GM1901;2019;     682;     410;     258;      70;     188;      14
9854;A028726;GM1901;2020;     647;     382;     260;      59;     201;       5
9855;A028726;GM0755;2012;     173;      99;      59;      13;      46;      15
9856;A028726;GM0755;2013;     183;      96;      58;      15;      43;      29
9857;A028726;GM0755;2014;     176;      91;      47;      12;      35;      38
9858;A028726;GM0755;2015;     179;     101;      37;       7;      30;      41
9859;A028726;GM0755;2016;     178;      93;      54;      17;      37;      31
9860;A028726;GM0755;2017;     152;      79;      46;      11;      35;      27
9861;A028726;GM0755;2018;     154;      87;      44;      11;      33;      23
9862;A028726;GM0755;2019;     173;     109;      62;      12;      50;       2
9863;A028726;GM0755;2020;     172;     106;      64;      22;      42;       2
9864;A028726;GM0009;2012;      97;      47;      48;      32;      16;       2
9865;A028726;GM0009;2013;      93;      57;      34;      25;       9;       2
9866;A028726;GM0009;2014;      93;      57;      34;      20;      14;       2
9867;A028726;GM0009;2015;      94;      44;      48;      29;      19;       2
9868;A028726;GM0009;2016;      98;      45;      51;      29;      22;       2
9869;A028726;GM0009;2017;     107;      48;      57;      36;      21;       2
9870;A028726;GM0009;2018;     113;      46;      66;      41;      25;       1
9871;A028726;GM0009;2019;;;;;;
9872;A028726;GM0009;2020;;;;;;
9873;A028726;GM1681;2012;    1018;     546;     453;      77;     376;      19
9874;A028726;GM1681;2013;    1000;     549;     434;      82;     352;      17
9875;A028726;GM1681;2014;     988;     545;     428;      80;     348;      15
9876;A028726;GM1681;2015;     994;     521;     453;      99;     354;      20
9877;A028726;GM1681;2016;     957;     552;     388;      52;     336;      17
9878;A028726;GM1681;2017;     927;     516;     385;      94;     291;      26
9879;A028726;GM1681;2018;     904;     480;     398;      94;     304;      26
9880;A028726;GM1681;2019;     909;     510;     391;     105;     286;       8
9881;A028726;GM1681;2020;     550;     331;     215;      83;     132;       4
9882;A028726;GM0147;2012;     400;     162;     219;     121;      98;      19
9883;A028726;GM0147;2013;     299;     149;     142;      34;     108;       8
9884;A028726;GM0147;2014;     239;     133;      99;      28;      71;       7
9885;A028726;GM0147;2015;     234;     127;     100;      36;      64;       7
9886;A028726;GM0147;2016;     252;     155;      90;      38;      52;       7
9887;A028726;GM0147;2017;     262;     142;     108;      40;      68;      12
9888;A028726;GM0147;2018;     238;     126;      99;      34;      65;      13
9889;A028726;GM0147;2019;     219;     125;      90;      35;      55;       4
9890;A028726;GM0147;2020;     294;     168;     119;      60;      59;       7
9891;A028726;GM0654;2012;     521;     324;     187;     120;      67;      10
9892;A028726;GM0654;2013;     497;     291;     197;     114;      83;       9
9893;A028726;GM0654;2014;     545;     301;     165;      93;      72;      79
9894;A028726;GM0654;2015;     459;     281;     167;     105;      62;      11
9895;A028726;GM0654;2016;     429;     284;     133;      69;      64;      12
9896;A028726;GM0654;2017;     432;     269;     151;      82;      69;      12
9897;A028726;GM0654;2018;     428;     260;     158;      73;      85;      10
9898;A028726;GM0654;2019;     386;     229;     150;      68;      82;       7
9899;A028726;GM0654;2020;     447;     260;     179;     103;      76;       8
9900;A028726;GM0499;2012;     263;     132;     109;      50;      59;      22
9901;A028726;GM0499;2013;     274;     150;      98;      36;      62;      26
9902;A028726;GM0499;2014;;;;;;
9903;A028726;GM0499;2015;;;;;;
9904;A028726;GM0499;2016;;;;;;
9905;A028726;GM0499;2017;;;;;;
9906;A028726;GM0499;2018;;;;;;
9907;A028726;GM0499;2019;;;;;;
9908;A028726;GM0499;2020;;;;;;
9909;A028726;GM0756;2012;     405;     209;     153;      39;     114;      43
9910;A028726;GM0756;2013;     416;     211;     171;      59;     112;      34
9911;A028726;GM0756;2014;     481;     235;     214;     100;     114;      32
9912;A028726;GM0756;2015;     437;     235;     169;      67;     102;      33
9913;A028726;GM0756;2016;     443;     236;     182;      73;     109;      25
9914;A028726;GM0756;2017;     394;     221;     151;      44;     107;      22
9915;A028726;GM0756;2018;     360;     189;     146;      45;     101;      25
9916;A028726;GM0756;2019;     399;     216;     179;      64;     115;       4
9917;A028726;GM0756;2020;     340;     202;     126;      45;      81;      12
9918;A028726;GM0757;2012;     623;     238;     315;      65;     250;      70
9919;A028726;GM0757;2013;     613;     228;     335;      78;     257;      50
9920;A028726;GM0757;2014;     741;     243;     351;     111;     240;     147
9921;A028726;GM0757;2015;     662;     230;     386;      66;     320;      46
9922;A028726;GM0757;2016;     609;     206;     358;      52;     306;      45
9923;A028726;GM0757;2017;     559;     181;     340;      59;     281;      38
9924;A028726;GM0757;2018;     502;     180;     285;      91;     194;      37
9925;A028726;GM0757;2019;     477;     196;     272;      91;     181;       9
9926;A028726;GM0757;2020;     491;     209;     246;      70;     176;      36
9927;A028726;GM0758;2012;    3272;    1343;    1660;     703;     957;     269
9928;A028726;GM0758;2013;    3469;    1387;    1836;     744;    1092;     246
9929;A028726;GM0758;2014;    3585;    1367;    1967;     909;    1058;     251
9930;A028726;GM0758;2015;    3235;    1316;    1683;     719;     964;     236
9931;A028726;GM0758;2016;    3056;    1246;    1500;     579;     921;     310
9932;A028726;GM0758;2017;    2746;    1054;    1458;     440;    1018;     234
9933;A028726;GM0758;2018;    2527;    1047;    1388;     429;     959;      92
9934;A028726;GM0758;2019;    2612;    1062;    1488;     461;    1027;      62
9935;A028726;GM0758;2020;    2849;    1134;    1674;     540;    1134;      41
9936;A028726;GM0501;2012;     536;     280;     191;      47;     144;      65
9937;A028726;GM0501;2013;     586;     310;     213;      50;     163;      63
9938;A028726;GM0501;2014;     693;     338;     318;      69;     249;      37
9939;A028726;GM0501;2015;     638;     338;     262;      33;     229;      38
9940;A028726;GM0501;2016;     585;     301;     263;      42;     221;      21
9941;A028726;GM0501;2017;     543;     274;     243;      21;     222;      26
9942;A028726;GM0501;2018;     544;     259;     270;      31;     239;      15
9943;A028726;GM0501;2019;     499;     241;     255;      31;     224;       3
9944;A028726;GM0501;2020;     523;     240;     281;      31;     250;       2
9945;A028726;GM1876;2012;     834;     460;     297;     112;     185;      77
9946;A028726;GM1876;2013;     735;     422;     258;      75;     183;      55
9947;A028726;GM1876;2014;     859;     434;     251;      59;     192;     174
9948;A028726;GM1876;2015;     840;     414;     239;      76;     163;     187
9949;A028726;GM1876;2016;     869;     399;     223;      63;     160;     247
9950;A028726;GM1876;2017;     767;     365;     255;      88;     167;     147
9951;A028726;GM1876;2018;     689;     352;     230;      78;     152;     107
9952;A028726;GM1876;2019;     736;     414;     316;     126;     190;       6
9953;A028726;GM1876;2020;     761;     411;     345;     119;     226;       5
9954;A028726;GM0213;2012;     337;     167;     112;      47;      65;      58
9955;A028726;GM0213;2013;     322;     169;     110;      35;      75;      43
9956;A028726;GM0213;2014;     302;     143;     118;      45;      73;      41
9957;A028726;GM0213;2015;     283;     149;     106;      38;      68;      28
9958;A028726;GM0213;2016;     273;     139;     102;      45;      57;      32
9959;A028726;GM0213;2017;     282;     135;     113;      53;      60;      34
9960;A028726;GM0213;2018;     283;     127;     121;      67;      54;      35
9961;A028726;GM0213;2019;     319;     138;     180;     115;      65;       1
9962;A028726;GM0213;2020;     285;     155;     129;      50;      79;       1
9963;A028726;GM0899;2012;     990;     450;     507;     145;     362;      33
9964;A028726;GM0899;2013;    1002;     414;     567;     238;     329;      21
9965;A028726;GM0899;2014;    1183;     391;     611;     248;     363;     181
9966;A028726;GM0899;2015;    1188;     403;     591;     238;     353;     194
9967;A028726;GM0899;2016;    1119;     391;     526;     219;     307;     202
9968;A028726;GM0899;2017;    1039;     360;     492;     161;     331;     187
9969;A028726;GM0899;2018;    1033;     329;     527;     193;     334;     177
9970;A028726;GM0899;2019;    1015;     364;     630;     284;     346;      21
9971;A028726;GM0899;2020;    1078;     339;     720;     378;     342;      19
9972;A028726;GM0312;2012;     206;     126;      72;      16;      56;       8
9973;A028726;GM0312;2013;     217;     124;      84;      16;      68;       9
9974;A028726;GM0312;2014;     200;     126;      67;      11;      56;       7
9975;A028726;GM0312;2015;     207;     121;      79;      22;      57;       7
9976;A028726;GM0312;2016;     210;     143;      58;      11;      47;       9
9977;A028726;GM0312;2017;     177;      99;      67;      18;      49;      11
9978;A028726;GM0312;2018;     165;      95;      58;      19;      39;      12
9979;A028726;GM0312;2019;     182;     111;      69;      17;      52;       2
9980;A028726;GM0312;2020;     200;     122;      75;      18;      57;       3
9981;A028726;GM0313;2012;     378;     249;     123;      22;     101;       6
9982;A028726;GM0313;2013;     384;     248;     136;      23;     113;       0
9983;A028726;GM0313;2014;     283;     172;     102;      16;      86;       9
9984;A028726;GM0313;2015;     306;     208;      90;       9;      81;       8
9985;A028726;GM0313;2016;     335;     210;     118;      12;     106;       7
9986;A028726;GM0313;2017;     307;     191;     106;       6;     100;      10
9987;A028726;GM0313;2018;     299;     172;     113;      11;     102;      14
9988;A028726;GM0313;2019;     303;     178;     118;      15;     103;       7
9989;A028726;GM0313;2020;     322;     171;     130;      27;     103;      21
9990;A028726;GM0214;2012;     516;     237;     201;     105;      96;      78
9991;A028726;GM0214;2013;     520;     247;     221;     120;     101;      52
9992;A028726;GM0214;2014;     471;     228;     197;     104;      93;      46
9993;A028726;GM0214;2015;     479;     256;     176;      55;     121;      47
9994;A028726;GM0214;2016;     446;     239;     148;      48;     100;      59
9995;A028726;GM0214;2017;     412;     223;     134;      30;     104;      55
9996;A028726;GM0214;2018;     381;     197;     132;      28;     104;      52
9997;A028726;GM0214;2019;     377;     244;     123;      42;      81;      10
9998;A028726;GM0214;2020;     439;     276;     148;      47;     101;      15
9999;A028726;GM0381;2012;     867;     415;     337;     111;     226;     115
10000;A028726;GM0381;2013;     877;     388;     389;     111;     278;     100
10001;A028726;GM0381;2014;     907;     379;     433;     103;     330;      95
10002;A028726;GM0381;2015;     771;     359;     336;      68;     268;      76
10003;A028726;GM0381;2016;;;;;;
10004;A028726;GM0381;2017;;;;;;
10005;A028726;GM0381;2018;;;;;;
10006;A028726;GM0381;2019;;;;;;
10007;A028726;GM0381;2020;;;;;;
10008;A028726;GM0502;2012;    1318;     466;     845;     599;     246;       7
10009;A028726;GM0502;2013;    1264;     443;     816;     580;     236;       5
10010;A028726;GM0502;2014;    1249;     448;     783;     511;     272;      18
10011;A028726;GM0502;2015;    1085;     463;     600;     386;     214;      22
10012;A028726;GM0502;2016;     990;     430;     525;     324;     201;      35
10013;A028726;GM0502;2017;     938;     386;     512;     299;     213;      40
10014;A028726;GM0502;2018;     799;     330;     438;     260;     178;      31
10015;A028726;GM0502;2019;     781;     355;     419;     259;     160;       7
10016;A028726;GM0502;2020;     926;     330;     587;     348;     239;       9
10017;A028726;GM0383;2012;     670;     316;     253;      38;     215;     101
10018;A028726;GM0383;2013;     611;     305;     284;      60;     224;      22
10019;A028726;GM0383;2014;     560;     300;     246;      39;     207;      14
10020;A028726;GM0383;2015;     574;     320;     235;      44;     191;      19
10021;A028726;GM0383;2016;     569;     327;     226;      49;     177;      16
10022;A028726;GM0383;2017;     515;     284;     212;      25;     187;      19
10023;A028726;GM0383;2018;     488;     257;     210;      28;     182;      21
10024;A028726;GM0383;2019;     548;     296;     226;      63;     163;      26
10025;A028726;GM0383;2020;     561;     315;     231;      74;     157;      15
10026;A028726;GM0109;2012;    2227;     776;     645;     190;     455;     806
10027;A028726;GM0109;2013;     738;     361;     343;     177;     166;      34
10028;A028726;GM0109;2014;     661;     319;     295;     125;     170;      47
10029;A028726;GM0109;2015;     724;     332;     313;     138;     175;      79
10030;A028726;GM0109;2016;     704;     290;     360;     184;     176;      54
10031;A028726;GM0109;2017;     667;     292;     317;     126;     191;      58
10032;A028726;GM0109;2018;     669;     261;     367;     151;     216;      41
10033;A028726;GM0109;2019;     672;     317;     344;     199;     145;      11
10034;A028726;GM0109;2020;     641;     292;     339;     210;     129;      10
10035;A028726;GM1706;2012;     360;     216;      86;      21;      65;      58
10036;A028726;GM1706;2013;     395;     245;     103;      33;      70;      47
10037;A028726;GM1706;2014;     390;     247;      98;      33;      65;      45
10038;A028726;GM1706;2015;     330;     218;      69;      15;      54;      43
10039;A028726;GM1706;2016;     305;     188;      74;      11;      63;      43
10040;A028726;GM1706;2017;     321;     176;     108;      26;      82;      37
10041;A028726;GM1706;2018;     330;     177;     119;      25;      94;      34
10042;A028726;GM1706;2019;     338;     219;     119;      18;     101;       0
10043;A028726;GM1706;2020;     323;     202;     117;      14;     103;       4
10044;A028726;GM0611;2012;     248;     124;     111;      15;      96;      13
10045;A028726;GM0611;2013;     237;     140;      87;      39;      48;      10
10046;A028726;GM0611;2014;     261;     165;      86;      35;      51;      10
10047;A028726;GM0611;2015;     243;     152;      78;      23;      55;      13
10048;A028726;GM0611;2016;     233;     140;      83;      24;      59;      10
10049;A028726;GM0611;2017;     200;     116;      75;      20;      55;       9
10050;A028726;GM0611;2018;     199;     108;      87;      30;      57;       4
10051;A028726;GM0611;2019;;;;;;
10052;A028726;GM0611;2020;;;;;;
10053;A028726;GM1684;2012;     421;     168;     150;      68;      82;     103
10054;A028726;GM1684;2013;     426;     186;     154;      71;      83;      86
10055;A028726;GM1684;2014;     288;     143;     128;      53;      75;      17
10056;A028726;GM1684;2015;     321;     168;     138;      68;      70;      15
10057;A028726;GM1684;2016;     473;     197;     257;     181;      76;      19
10058;A028726;GM1684;2017;     334;     166;     151;      71;      80;      17
10059;A028726;GM1684;2018;     332;     155;     160;      81;      79;      17
10060;A028726;GM1684;2019;     467;     149;     303;     137;     166;      15
10061;A028726;GM1684;2020;     429;     160;     256;      59;     197;      13
10062;A028726;GM0216;2012;     404;     157;     171;      85;      86;      76
10063;A028726;GM0216;2013;     498;     186;     245;     152;      93;      67
10064;A028726;GM0216;2014;     489;     170;     250;     153;      97;      69
10065;A028726;GM0216;2015;     418;     158;     203;     111;      92;      57
10066;A028726;GM0216;2016;     467;     175;     231;     126;     105;      61
10067;A028726;GM0216;2017;     428;     150;     224;     127;      97;      54
10068;A028726;GM0216;2018;     375;     150;     176;      70;     106;      49
10069;A028726;GM0216;2019;     428;     185;     226;     110;     116;      17
10070;A028726;GM0216;2020;     331;     159;     159;      56;     103;      13
10071;A028726;GM0148;2012;     475;     290;     147;      46;     101;      38
10072;A028726;GM0148;2013;     483;     286;     162;      52;     110;      35
10073;A028726;GM0148;2014;     448;     258;     156;      38;     118;      34
10074;A028726;GM0148;2015;     435;     245;     157;      36;     121;      33
10075;A028726;GM0148;2016;     463;     239;     194;      36;     158;      30
10076;A028726;GM0148;2017;     377;     215;     135;      32;     103;      27
10077;A028726;GM0148;2018;     391;     211;     149;      33;     116;      31
10078;A028726;GM0148;2019;     408;     259;     143;      45;      98;       6
10079;A028726;GM0148;2020;     423;     274;     146;      41;     105;       3
10080;A028726;GM1891;2012;     322;     164;     127;      60;      67;      31
10081;A028726;GM1891;2013;     319;     156;     133;      71;      62;      30
10082;A028726;GM1891;2014;     298;     165;     102;      45;      57;      31
10083;A028726;GM1891;2015;     264;     148;      95;      48;      47;      21
10084;A028726;GM1891;2016;     251;     130;     100;      47;      53;      21
10085;A028726;GM1891;2017;     271;     128;     108;      56;      52;      35
10086;A028726;GM1891;2018;     282;     112;     147;      84;      63;      23
10087;A028726;GM1891;2019;     234;     108;     124;      80;      44;       2
10088;A028726;GM1891;2020;     211;     103;     106;      70;      36;       2
10089;A028726;GM0503;2012;    2512;     775;    1288;     651;     637;     449
10090;A028726;GM0503;2013;    2542;     800;    1482;     649;     833;     260
10091;A028726;GM0503;2014;    2312;     689;    1344;     542;     802;     279
10092;A028726;GM0503;2015;    2462;     775;    1385;     680;     705;     302
10093;A028726;GM0503;2016;    2408;     688;    1366;     596;     770;     354
10094;A028726;GM0503;2017;    2369;     580;    1494;     683;     811;     295
10095;A028726;GM0503;2018;    2245;     613;    1390;     506;     884;     242
10096;A028726;GM0503;2019;    2363;     801;    1439;     663;     776;     123
10097;A028726;GM0503;2020;    2250;     738;    1460;     675;     785;      52
10098;A028726;GM0010;2012;     779;     298;     422;     190;     232;      59
10099;A028726;GM0010;2013;     817;     315;     448;     207;     241;      54
10100;A028726;GM0010;2014;     835;     319;     501;     262;     239;      15
10101;A028726;GM0010;2015;     865;     297;     556;     303;     253;      12
10102;A028726;GM0010;2016;     950;     304;     599;     365;     234;      47
10103;A028726;GM0010;2017;     980;     296;     638;     396;     242;      46
10104;A028726;GM0010;2018;     891;     239;     634;     369;     265;      18
10105;A028726;GM0010;2019;     851;     235;     606;     338;     268;      10
10106;A028726;GM0010;2020;     891;     247;     636;     349;     287;       8
10107;A028726;GM0762;2012;     471;     289;     162;      54;     108;      20
10108;A028726;GM0762;2013;     508;     294;     195;      74;     121;      19
10109;A028726;GM0762;2014;     620;     269;     186;      61;     125;     165
10110;A028726;GM0762;2015;     503;     244;     152;      52;     100;     107
10111;A028726;GM0762;2016;     438;     249;     134;      39;      95;      55
10112;A028726;GM0762;2017;     438;     240;     144;      42;     102;      54
10113;A028726;GM0762;2018;     413;     204;     165;      66;      99;      44
10114;A028726;GM0762;2019;     463;     259;     199;      72;     127;       5
10115;A028726;GM0762;2020;     439;     253;     180;      62;     118;       6
10116;A028726;GM0150;2012;    1590;     587;     787;     383;     404;     216
10117;A028726;GM0150;2013;    1527;     541;     829;     387;     442;     157
10118;A028726;GM0150;2014;    1778;     549;    1085;     624;     461;     144
10119;A028726;GM0150;2015;    1977;     606;     908;     366;     542;     463
10120;A028726;GM0150;2016;    2028;     663;    1262;     611;     651;     103
10121;A028726;GM0150;2017;    1621;     556;     935;     405;     530;     130
10122;A028726;GM0150;2018;    1406;     495;     841;     381;     460;      70
10123;A028726;GM0150;2019;    1574;     551;     974;     383;     591;      49
10124;A028726;GM0150;2020;    1533;     510;     985;     349;     636;      38
10125;A028726;GM0384;2012;     547;     162;     273;      70;     203;     112
10126;A028726;GM0384;2013;     513;     147;     271;      70;     201;      95
10127;A028726;GM0384;2014;     718;     148;     317;     116;     201;     253
10128;A028726;GM0384;2015;     648;     151;     308;     117;     191;     189
10129;A028726;GM0384;2016;     635;     163;     244;      91;     153;     228
10130;A028726;GM0384;2017;     630;     142;     298;      59;     239;     190
10131;A028726;GM0384;2018;     595;     149;     263;      59;     204;     183
10132;A028726;GM0384;2019;     702;     196;     502;     169;     333;       4
10133;A028726;GM0384;2020;    1015;     236;     771;     153;     618;       8
10134;A028726;GM1774;2012;     769;     441;     288;      43;     245;      40
10135;A028726;GM1774;2013;     756;     430;     291;      45;     246;      35
10136;A028726;GM1774;2014;     831;     420;     271;      39;     232;     140
10137;A028726;GM1774;2015;     791;     422;     280;      49;     231;      89
10138;A028726;GM1774;2016;     789;     413;     273;      41;     232;     103
10139;A028726;GM1774;2017;     776;     412;     260;      46;     214;     104
10140;A028726;GM1774;2018;     758;     396;     257;      38;     219;     105
10141;A028726;GM1774;2019;     758;     465;     270;      35;     235;      23
10142;A028726;GM1774;2020;     746;     450;     267;      38;     229;      29
10143;A028726;GM0504;2012;     165;      97;      64;      27;      37;       4
10144;A028726;GM0504;2013;;;;;;
10145;A028726;GM0504;2014;;;;;;
10146;A028726;GM0504;2015;;;;;;
10147;A028726;GM0504;2016;;;;;;
10148;A028726;GM0504;2017;;;;;;
10149;A028726;GM0504;2018;;;;;;
10150;A028726;GM0504;2019;;;;;;
10151;A028726;GM0504;2020;;;;;;
10152;A028726;GM0221;2012;     283;     107;     165;     107;      58;      11
10153;A028726;GM0221;2013;     224;      87;     121;      45;      76;      16
10154;A028726;GM0221;2014;     196;      79;     111;      50;      61;       6
10155;A028726;GM0221;2015;     184;      88;      92;      32;      60;       4
10156;A028726;GM0221;2016;     171;      82;      81;      23;      58;       8
10157;A028726;GM0221;2017;     167;      77;      83;      29;      54;       7
10158;A028726;GM0221;2018;     151;      64;      82;      37;      45;       5
10159;A028726;GM0221;2019;     174;      72;     102;      60;      42;       0
10160;A028726;GM0221;2020;     191;      77;     113;      74;      39;       1
10161;A028726;GM0222;2012;     843;     372;     370;     168;     202;     101
10162;A028726;GM0222;2013;     901;     386;     432;     147;     285;      83
10163;A028726;GM0222;2014;     835;     365;     394;     127;     267;      76
10164;A028726;GM0222;2015;     822;     353;     386;     135;     251;      83
10165;A028726;GM0222;2016;     762;     359;     355;     111;     244;      48
10166;A028726;GM0222;2017;     800;     326;     417;     127;     290;      57
10167;A028726;GM0222;2018;     691;     287;     347;     107;     240;      57
10168;A028726;GM0222;2019;     777;     296;     472;     279;     193;       9
10169;A028726;GM0222;2020;     743;     304;     429;     238;     191;      10
10170;A028726;GM0766;2012;     373;     202;     146;      62;      84;      25
10171;A028726;GM0766;2013;     314;     176;     118;      46;      72;      20
10172;A028726;GM0766;2014;     300;     157;     127;      52;      75;      16
10173;A028726;GM0766;2015;     272;     140;     116;      55;      61;      16
10174;A028726;GM0766;2016;     255;     141;      99;      48;      51;      15
10175;A028726;GM0766;2017;     267;     132;     120;      46;      74;      15
10176;A028726;GM0766;2018;     296;     137;     140;      52;      88;      19
10177;A028726;GM0766;2019;     324;     153;     168;      89;      79;       3
10178;A028726;GM0766;2020;     300;     190;     108;      36;      72;       2
10179;A028726;GM0058;2012;     577;     356;     204;     101;     103;      17
10180;A028726;GM0058;2013;     584;     356;     212;      87;     125;      16
10181;A028726;GM0058;2014;     583;     355;     198;      80;     118;      30
10182;A028726;GM0058;2015;     603;     360;     177;      84;      93;      66
10183;A028726;GM0058;2016;     593;     348;     190;      79;     111;      55
10184;A028726;GM0058;2017;     638;     362;     213;      93;     120;      63
10185;A028726;GM0058;2018;     673;     331;     260;     118;     142;      82
10186;A028726;GM0058;2019;;;;;;
10187;A028726;GM0058;2020;;;;;;
10188;A028726;GM0505;2012;    2855;    1068;    1526;     657;     869;     261
10189;A028726;GM0505;2013;    3109;    1103;    1774;     945;     829;     232
10190;A028726;GM0505;2014;    2807;    1000;    1608;     693;     915;     199
10191;A028726;GM0505;2015;    2643;     958;    1464;     708;     756;     221
10192;A028726;GM0505;2016;    2807;     979;    1640;     815;     825;     188
10193;A028726;GM0505;2017;    2796;     842;    1763;     866;     897;     191
10194;A028726;GM0505;2018;    2935;     866;    1889;     963;     926;     180
10195;A028726;GM0505;2019;    2586;     939;    1624;     786;     838;      23
10196;A028726;GM0505;2020;    2535;     909;    1609;     794;     815;      17
10197;A028726;GM0498;2012;     239;     163;      66;      33;      33;      10
10198;A028726;GM0498;2013;     238;     163;      67;      30;      37;       8
10199;A028726;GM0498;2014;     253;     152;      85;      33;      52;      16
10200;A028726;GM0498;2015;     239;     144;      77;      27;      50;      18
10201;A028726;GM0498;2016;     252;     151;      82;      31;      51;      19
10202;A028726;GM0498;2017;     245;     152;      81;      23;      58;      12
10203;A028726;GM0498;2018;     264;     153;      89;      23;      66;      22
10204;A028726;GM0498;2019;     276;     163;      99;      29;      70;      14
10205;A028726;GM0498;2020;     257;     160;      84;      23;      61;      13
10206;A028726;GM1719;2012;     567;     302;     211;     108;     103;      54
10207;A028726;GM1719;2013;     490;     253;     207;      93;     114;      30
10208;A028726;GM1719;2014;     449;     253;     153;      66;      87;      43
10209;A028726;GM1719;2015;     416;     244;     123;      46;      77;      49
10210;A028726;GM1719;2016;     396;     223;     117;      46;      71;      56
10211;A028726;GM1719;2017;     443;     233;     154;      58;      96;      56
10212;A028726;GM1719;2018;     413;     201;     131;      48;      83;      81
10213;A028726;GM1719;2019;     432;     224;     205;     118;      87;       3
10214;A028726;GM1719;2020;     349;     205;     140;      54;      86;       4
10215;A028726;GM0303;2012;    1523;     493;     600;     107;     493;     430
10216;A028726;GM0303;2013;    1505;     482;     749;     107;     642;     274
10217;A028726;GM0303;2014;    1466;     475;     878;      80;     798;     113
10218;A028726;GM0303;2015;    1486;     519;     872;      99;     773;      95
10219;A028726;GM0303;2016;     619;     244;     354;      78;     276;      21
10220;A028726;GM0303;2017;     550;     187;     333;      53;     280;      30
10221;A028726;GM0303;2018;     719;     189;     497;      77;     420;      33
10222;A028726;GM0303;2019;     798;     292;     497;     143;     354;       9
10223;A028726;GM0303;2020;     754;     242;     498;     153;     345;      14
10224;A028726;GM0225;2012;     302;     123;     147;      55;      92;      32
10225;A028726;GM0225;2013;     286;     116;     143;      53;      90;      27
10226;A028726;GM0225;2014;     281;     123;     142;      47;      95;      16
10227;A028726;GM0225;2015;     257;     124;     112;      25;      87;      21
10228;A028726;GM0225;2016;     235;     117;      97;      30;      67;      21
10229;A028726;GM0225;2017;     237;     114;     102;      25;      77;      21
10230;A028726;GM0225;2018;     286;      91;     126;      26;     100;      69
10231;A028726;GM0225;2019;     301;     125;     170;      40;     130;       6
10232;A028726;GM0225;2020;     281;      83;     195;      58;     137;       3
10233;A028726;GM0226;2012;     274;     142;     123;      54;      69;       9
10234;A028726;GM0226;2013;     270;     139;     113;      43;      70;      18
10235;A028726;GM0226;2014;     241;     121;     106;      40;      66;      14
10236;A028726;GM0226;2015;     234;     123;      97;      37;      60;      14
10237;A028726;GM0226;2016;     223;     119;      94;      33;      61;      10
10238;A028726;GM0226;2017;     213;     111;      89;      42;      47;      13
10239;A028726;GM0226;2018;     173;      86;      75;      28;      47;      12
10240;A028726;GM0226;2019;     172;     108;      59;      30;      29;       5
10241;A028726;GM0226;2020;     187;      97;      79;      39;      40;      11
10242;A028726;GM1711;2012;     609;     357;     207;      73;     134;      45
10243;A028726;GM1711;2013;     618;     373;     223;      78;     145;      22
10244;A028726;GM1711;2014;     806;     345;     242;      95;     147;     219
10245;A028726;GM1711;2015;     780;     319;     233;      85;     148;     228
10246;A028726;GM1711;2016;     616;     324;     192;      49;     143;     100
10247;A028726;GM1711;2017;     622;     314;     204;      57;     147;     104
10248;A028726;GM1711;2018;     610;     294;     222;      58;     164;      94
10249;A028726;GM1711;2019;     603;     321;     276;      56;     220;       6
10250;A028726;GM1711;2020;     625;     331;     287;      71;     216;       7
10251;A028726;GM0385;2012;     953;     294;     486;     369;     117;     173
10252;A028726;GM0385;2013;    1062;     361;     529;     449;      80;     172
10253;A028726;GM0385;2014;     691;     390;     131;      47;      84;     170
10254;A028726;GM0385;2015;     589;     285;     133;      34;      99;     171
10255;A028726;GM0385;2016;     657;     321;     162;      53;     109;     174
10256;A028726;GM0385;2017;     435;     318;     112;      23;      89;       5
10257;A028726;GM0385;2018;     413;     294;     115;      33;      82;       4
10258;A028726;GM0385;2019;     400;     286;     105;      29;      76;       9
10259;A028726;GM0385;2020;     423;     294;     122;      30;      92;       7
10260;A028726;GM0228;2012;    6098;    1473;    1206;     341;     865;    3419
10261;A028726;GM0228;2013;    6049;    1345;    2125;     341;    1784;    2579
10262;A028726;GM0228;2014;    5520;    1330;    2059;     199;    1860;    2131
10263;A028726;GM0228;2015;    5479;    1386;    1968;     142;    1826;    2125
10264;A028726;GM0228;2016;    5471;    1313;    2044;     167;    1877;    2114
10265;A028726;GM0228;2017;    5407;    1343;    2066;     151;    1915;    1998
10266;A028726;GM0228;2018;    3046;    1139;    1477;     143;    1334;     430
10267;A028726;GM0228;2019;    2819;    1101;    1506;     515;     991;     212
10268;A028726;GM0228;2020;    2443;    1067;    1344;     424;     920;      32
10269;A028726;GM0317;2012;     112;      75;      27;       9;      18;      10
10270;A028726;GM0317;2013;     165;      84;      71;      24;      47;      10
10271;A028726;GM0317;2014;     136;      72;      54;      20;      34;      10
10272;A028726;GM0317;2015;     100;      61;      29;       5;      24;      10
10273;A028726;GM0317;2016;      97;      63;      26;      12;      14;       8
10274;A028726;GM0317;2017;      82;      54;      24;       5;      19;       4
10275;A028726;GM0317;2018;      93;      48;      44;      16;      28;       1
10276;A028726;GM0317;2019;     139;      81;      56;      23;      33;       2
10277;A028726;GM0317;2020;     118;      63;      46;      15;      31;       9
10278;A028726;GM1651;2012;     510;     215;     226;     127;      99;      69
10279;A028726;GM1651;2013;     467;     213;     238;     127;     111;      16
10280;A028726;GM1651;2014;     514;     219;     284;     168;     116;      11
10281;A028726;GM1651;2015;     490;     196;     289;     171;     118;       5
10282;A028726;GM1651;2016;     426;     180;     242;     146;      96;       4
10283;A028726;GM1651;2017;     382;     179;     200;      91;     109;       3
10284;A028726;GM1651;2018;     386;     161;     220;      97;     123;       5
10285;A028726;GM1651;2019;;;;;;
10286;A028726;GM1651;2020;;;;;;
10287;A028726;GM0770;2012;     384;     214;      96;      38;      58;      74
10288;A028726;GM0770;2013;     436;     206;     145;      82;      63;      85
10289;A028726;GM0770;2014;     443;     229;     118;      46;      72;      96
10290;A028726;GM0770;2015;     452;     208;     101;      38;      63;     143
10291;A028726;GM0770;2016;     423;     213;      72;      15;      57;     138
10292;A028726;GM0770;2017;     437;     219;      89;      27;      62;     129
10293;A028726;GM0770;2018;     396;     184;      89;      20;      69;     123
10294;A028726;GM0770;2019;     437;     248;     187;      25;     162;       2
10295;A028726;GM0770;2020;     448;     236;     208;      14;     194;       4
10296;A028726;GM1903;2012;     627;     337;     251;      42;     209;      39
10297;A028726;GM1903;2013;     633;     339;     256;      43;     213;      38
10298;A028726;GM1903;2014;     626;     321;     259;      40;     219;      46
10299;A028726;GM1903;2015;     588;     310;     233;      39;     194;      45
10300;A028726;GM1903;2016;     591;     306;     235;      60;     175;      50
10301;A028726;GM1903;2017;     605;     285;     249;      77;     172;      71
10302;A028726;GM1903;2018;     589;     281;     231;      45;     186;      77
10303;A028726;GM1903;2019;     550;     314;     228;      33;     195;       8
10304;A028726;GM1903;2020;     550;     323;     222;      26;     196;       5
10305;A028726;GM0772;2012;    4984;    1615;    2544;    1224;    1320;     825
10306;A028726;GM0772;2013;    4791;    1577;    2687;    1265;    1422;     527
10307;A028726;GM0772;2014;    4583;    1567;    2499;    1298;    1201;     517
10308;A028726;GM0772;2015;    4154;    1449;    2167;    1032;    1135;     538
10309;A028726;GM0772;2016;    5545;    1307;    2362;    1003;    1359;    1876
10310;A028726;GM0772;2017;    5108;    1134;    2794;    1169;    1625;    1180
10311;A028726;GM0772;2018;    4736;    1116;    2876;    1059;    1817;     744
10312;A028726;GM0772;2019;    4758;    1214;    3463;     998;    2465;      81
10313;A028726;GM0772;2020;    4657;    1275;    3343;    1165;    2178;      39
10314;A028726;GM0230;2012;     371;     207;     142;      48;      94;      22
10315;A028726;GM0230;2013;     343;     178;     115;      30;      85;      50
10316;A028726;GM0230;2014;     298;     146;     111;      29;      82;      41
10317;A028726;GM0230;2015;     313;     160;     106;      36;      70;      47
10318;A028726;GM0230;2016;     318;     171;     102;      30;      72;      45
10319;A028726;GM0230;2017;     273;     140;      85;      25;      60;      48
10320;A028726;GM0230;2018;     280;     148;      82;      21;      61;      50
10321;A028726;GM0230;2019;     278;     156;     122;      37;      85;       0
10322;A028726;GM0230;2020;     286;     163;     122;      41;      81;       1
10323;A028726;GM0114;2012;    5581;    1795;    3041;    1507;    1534;     745
10324;A028726;GM0114;2013;    2790;     867;    1541;     564;     977;     382
10325;A028726;GM0114;2014;    3002;     831;    1573;     559;    1014;     598
10326;A028726;GM0114;2015;    2649;     823;    1400;     428;     972;     426
10327;A028726;GM0114;2016;    2407;     783;    1294;     445;     849;     330
10328;A028726;GM0114;2017;    1762;     609;     920;     357;     563;     233
10329;A028726;GM0114;2018;    1675;     586;     874;     329;     545;     215
10330;A028726;GM0114;2019;    1775;     636;    1121;     585;     536;      18
10331;A028726;GM0114;2020;    1648;     586;    1048;     625;     423;      14
10332;A028726;GM0388;2012;     312;     157;     143;      56;      87;      12
10333;A028726;GM0388;2013;     301;     154;     128;      44;      84;      19
10334;A028726;GM0388;2014;     313;     160;     123;      35;      88;      30
10335;A028726;GM0388;2015;     370;     152;     187;      96;      91;      31
10336;A028726;GM0388;2016;     334;     152;     144;      60;      84;      38
10337;A028726;GM0388;2017;     310;     115;     156;      65;      91;      39
10338;A028726;GM0388;2018;     321;     137;     148;      46;     102;      36
10339;A028726;GM0388;2019;     307;     137;     154;      62;      92;      16
10340;A028726;GM0388;2020;     304;     144;     146;      52;      94;      14
10341;A028726;GM0153;2012;    4237;    1151;    2626;    1290;    1336;     460
10342;A028726;GM0153;2013;    4027;    1069;    2576;    1291;    1285;     382
10343;A028726;GM0153;2014;    3754;     991;    2314;    1030;    1284;     449
10344;A028726;GM0153;2015;    3933;    1001;    2496;    1488;    1008;     436
10345;A028726;GM0153;2016;    3751;     982;    2300;    1186;    1114;     469
10346;A028726;GM0153;2017;    3453;     842;    2095;    1100;     995;     516
10347;A028726;GM0153;2018;    3276;     838;    2055;     982;    1073;     383
10348;A028726;GM0153;2019;    3790;     979;    2759;    1222;    1537;      52
10349;A028726;GM0153;2020;    3406;     992;    2359;    1019;    1340;      55
10350;A028726;GM0232;2012;     654;     327;     277;      91;     186;      50
10351;A028726;GM0232;2013;     666;     306;     311;     119;     192;      49
10352;A028726;GM0232;2014;     764;     330;     290;      72;     218;     144
10353;A028726;GM0232;2015;     747;     327;     320;     101;     219;     100
10354;A028726;GM0232;2016;     717;     358;     303;      94;     209;      56
10355;A028726;GM0232;2017;     673;     345;     263;      70;     193;      65
10356;A028726;GM0232;2018;     635;     320;     261;      69;     192;      54
10357;A028726;GM0232;2019;     581;     328;     249;     115;     134;       4
10358;A028726;GM0232;2020;     601;     342;     255;     127;     128;       4
10359;A028726;GM0233;2012;     735;     197;     289;      43;     246;     249
10360;A028726;GM0233;2013;     708;     190;     402;      57;     345;     116
10361;A028726;GM0233;2014;     725;     196;     419;      59;     360;     110
10362;A028726;GM0233;2015;     692;     176;     404;      52;     352;     112
10363;A028726;GM0233;2016;     537;     148;     285;      41;     244;     104
10364;A028726;GM0233;2017;     551;     156;     292;      45;     247;     103
10365;A028726;GM0233;2018;     550;     152;     306;      39;     267;      92
10366;A028726;GM0233;2019;     535;     190;     332;      43;     289;      13
10367;A028726;GM0233;2020;     581;     189;     371;      49;     322;      21
10368;A028726;GM0777;2012;     459;     255;     186;      93;      93;      18
10369;A028726;GM0777;2013;     588;     254;     309;     158;     151;      25
10370;A028726;GM0777;2014;     560;     270;     275;     147;     128;      15
10371;A028726;GM0777;2015;     491;     259;     219;      86;     133;      13
10372;A028726;GM0777;2016;     496;     245;     225;      84;     141;      26
10373;A028726;GM0777;2017;     414;     193;     198;      73;     125;      23
10374;A028726;GM0777;2018;     407;     183;     196;      71;     125;      28
10375;A028726;GM0777;2019;     434;     237;     195;      79;     116;       2
10376;A028726;GM0777;2020;     429;     202;     220;      95;     125;       7
10377;A028726;GM1722;2012;     270;     109;      99;      45;      54;      62
10378;A028726;GM1722;2013;     289;     122;     114;      58;      56;      53
10379;A028726;GM1722;2014;     212;     108;      68;      29;      39;      36
10380;A028726;GM1722;2015;     202;      99;      73;      34;      39;      30
10381;A028726;GM1722;2016;     218;     108;      72;      21;      51;      38
10382;A028726;GM1722;2017;     184;      87;      65;      12;      53;      32
10383;A028726;GM1722;2018;     178;      88;      66;      29;      37;      24
10384;A028726;GM1722;2019;;;;;;
10385;A028726;GM1722;2020;;;;;;
10386;A028726;GM0070;2012;     628;     281;     260;     114;     146;      87
10387;A028726;GM0070;2013;     583;     287;     262;     112;     150;      34
10388;A028726;GM0070;2014;     616;     269;     305;     111;     194;      42
10389;A028726;GM0070;2015;     581;     267;     270;      88;     182;      44
10390;A028726;GM0070;2016;     577;     245;     248;      75;     173;      84
10391;A028726;GM0070;2017;     574;     251;     284;      93;     191;      39
10392;A028726;GM0070;2018;;;;;;
10393;A028726;GM0070;2019;;;;;;
10394;A028726;GM0070;2020;;;;;;
10395;A028726;GM1921;2012;;;;;;
10396;A028726;GM1921;2013;;;;;;
10397;A028726;GM1921;2014;    1582;    1020;     499;     101;     398;      63
10398;A028726;GM1921;2015;    1459;     959;     460;     100;     360;      40
10399;A028726;GM1921;2016;;;;;;
10400;A028726;GM1921;2017;;;;;;
10401;A028726;GM1921;2018;;;;;;
10402;A028726;GM1921;2019;;;;;;
10403;A028726;GM1921;2020;;;;;;
10404;A028726;GM1940;2012;;;;;;
10405;A028726;GM1940;2013;;;;;;
10406;A028726;GM1940;2014;;;;;;
10407;A028726;GM1940;2015;;;;;;
10408;A028726;GM1940;2016;    1437;     959;     431;     111;     320;      47
10409;A028726;GM1940;2017;    1404;     907;     430;      69;     361;      67
10410;A028726;GM1940;2018;    1384;     891;     433;      74;     359;      60
10411;A028726;GM1940;2019;    1398;     909;     441;      95;     346;      48
10412;A028726;GM1940;2020;    1447;     908;     473;     128;     345;      66
10413;A028726;GM0653;2012;     609;     397;     206;      24;     182;       6
10414;A028726;GM0653;2013;     313;     214;      93;      27;      66;       6
10415;A028726;GM0653;2014;;;;;;
10416;A028726;GM0653;2015;;;;;;
10417;A028726;GM0653;2016;;;;;;
10418;A028726;GM0653;2017;;;;;;
10419;A028726;GM0653;2018;;;;;;
10420;A028726;GM0653;2019;;;;;;
10421;A028726;GM0653;2020;;;;;;
10422;A028726;GM0779;2012;     419;     157;     231;     169;      62;      31
10423;A028726;GM0779;2013;     378;     156;     209;     130;      79;      13
10424;A028726;GM0779;2014;     426;     163;     195;     125;      70;      68
10425;A028726;GM0779;2015;     383;     157;     214;      93;     121;      12
10426;A028726;GM0779;2016;     315;     106;     195;      78;     117;      14
10427;A028726;GM0779;2017;     340;     137;     187;      66;     121;      16
10428;A028726;GM0779;2018;     313;     105;     186;      62;     124;      22
10429;A028726;GM0779;2019;     334;     120;     212;     108;     104;       2
10430;A028726;GM0779;2020;     311;     114;     195;     114;      81;       2
10431;A028726;GM0236;2012;     398;     188;     169;      35;     134;      41
10432;A028726;GM0236;2013;     370;     199;     137;      22;     115;      34
10433;A028726;GM0236;2014;     369;     200;     124;      30;      94;      45
10434;A028726;GM0236;2015;     369;     184;     128;      35;      93;      57
10435;A028726;GM0236;2016;     387;     208;     139;      39;     100;      40
10436;A028726;GM0236;2017;     427;     200;     150;      41;     109;      77
10437;A028726;GM0236;2018;     441;     162;     194;      42;     152;      85
10438;A028726;GM0236;2019;;;;;;
10439;A028726;GM0236;2020;;;;;;
10440;A028726;GM1771;2012;     591;     330;     227;      84;     143;      34
10441;A028726;GM1771;2013;     580;     327;     231;      98;     133;      22
10442;A028726;GM1771;2014;     526;     303;     196;      97;      99;      27
10443;A028726;GM1771;2015;     549;     285;     224;     114;     110;      40
10444;A028726;GM1771;2016;     507;     276;     216;     118;      98;      15
10445;A028726;GM1771;2017;     461;     257;     188;      90;      98;      16
10446;A028726;GM1771;2018;     473;     248;     207;      92;     115;      18
10447;A028726;GM1771;2019;     488;     279;     207;      61;     146;       2
10448;A028726;GM1771;2020;     513;     305;     206;      69;     137;       2
10449;A028726;GM1652;2012;     647;     324;     228;      53;     175;      95
10450;A028726;GM1652;2013;     624;     293;     267;      65;     202;      64
10451;A028726;GM1652;2014;     649;     323;     268;      71;     197;      58
10452;A028726;GM1652;2015;     605;     310;     230;      42;     188;      65
10453;A028726;GM1652;2016;     531;     249;     218;      33;     185;      64
10454;A028726;GM1652;2017;     516;     238;     220;      56;     164;      58
10455;A028726;GM1652;2018;     446;     210;     180;      37;     143;      56
10456;A028726;GM1652;2019;     426;     241;     183;      33;     150;       2
10457;A028726;GM1652;2020;     430;     219;     208;      67;     141;       3
10458;A028726;GM0907;2012;     309;     134;     150;      78;      72;      25
10459;A028726;GM0907;2013;     339;     150;     165;      89;      76;      24
10460;A028726;GM0907;2014;     332;     148;     164;      82;      82;      20
10461;A028726;GM0907;2015;     274;     144;     110;      38;      72;      20
10462;A028726;GM0907;2016;     284;     132;      96;      30;      66;      56
10463;A028726;GM0907;2017;     271;     135;     108;      22;      86;      28
10464;A028726;GM0907;2018;     276;     124;     135;      31;     104;      17
10465;A028726;GM0907;2019;     255;     130;     116;      42;      74;       9
10466;A028726;GM0907;2020;     284;     125;     154;      69;      85;       5
10467;A028726;GM0689;2012;     264;     199;      62;      28;      34;       3
10468;A028726;GM0689;2013;     237;     165;      70;      42;      28;       2
10469;A028726;GM0689;2014;     195;     147;      46;      16;      30;       2
10470;A028726;GM0689;2015;     231;     154;      74;      34;      40;       3
10471;A028726;GM0689;2016;     203;     128;      74;      27;      47;       1
10472;A028726;GM0689;2017;     204;     136;      67;      29;      38;       1
10473;A028726;GM0689;2018;     205;     138;      65;      20;      45;       2
10474;A028726;GM0689;2019;;;;;;
10475;A028726;GM0689;2020;;;;;;
10476;A028726;GM0784;2012;     589;     177;     212;      66;     146;     200
10477;A028726;GM0784;2013;     509;     146;     237;     103;     134;     126
10478;A028726;GM0784;2014;     572;     157;     288;      96;     192;     127
10479;A028726;GM0784;2015;     503;     148;     237;      70;     167;     118
10480;A028726;GM0784;2016;     504;     157;     226;      66;     160;     121
10481;A028726;GM0784;2017;     471;     184;     238;      62;     176;      49
10482;A028726;GM0784;2018;     416;     130;     242;      66;     176;      44
10483;A028726;GM0784;2019;     359;     148;     204;      82;     122;       7
10484;A028726;GM0784;2020;     339;     144;     187;      73;     114;       8
10485;A028726;GM0511;2012;     446;     166;     164;      29;     135;     116
10486;A028726;GM0511;2013;;;;;;
10487;A028726;GM0511;2014;;;;;;
10488;A028726;GM0511;2015;;;;;;
10489;A028726;GM0511;2016;;;;;;
10490;A028726;GM0511;2017;;;;;;
10491;A028726;GM0511;2018;;;;;;
10492;A028726;GM0511;2019;;;;;;
10493;A028726;GM0511;2020;;;;;;
10494;A028726;GM1924;2012;;;;;;
10495;A028726;GM1924;2013;    1175;     579;     450;     188;     262;     146
10496;A028726;GM1924;2014;    1197;     648;     468;     178;     290;      81
10497;A028726;GM1924;2015;    1167;     631;     446;     217;     229;      90
10498;A028726;GM1924;2016;    1088;     613;     383;     169;     214;      92
10499;A028726;GM1924;2017;    1060;     538;     424;     170;     254;      98
10500;A028726;GM1924;2018;    1079;     512;     434;     173;     261;     133
10501;A028726;GM1924;2019;    1088;     565;     512;     209;     303;      11
10502;A028726;GM1924;2020;    1143;     629;     493;     183;     310;      21
10503;A028726;GM0664;2012;    1260;     489;     641;     162;     479;     130
10504;A028726;GM0664;2013;    1133;     497;     515;     159;     356;     121
10505;A028726;GM0664;2014;    1112;     458;     532;     127;     405;     122
10506;A028726;GM0664;2015;    1114;     444;     528;     162;     366;     142
10507;A028726;GM0664;2016;    1079;     400;     526;     179;     347;     153
10508;A028726;GM0664;2017;    1135;     385;     563;     195;     368;     187
10509;A028726;GM0664;2018;    1093;     395;     506;     139;     367;     192
10510;A028726;GM0664;2019;    1103;     486;     558;     182;     376;      59
10511;A028726;GM0664;2020;    1178;     476;     580;     187;     393;     122
10512;A028726;GM0785;2012;     357;     147;     173;      98;      75;      37
10513;A028726;GM0785;2013;     339;     176;     154;      88;      66;       9
10514;A028726;GM0785;2014;     230;     120;      96;      53;      43;      14
10515;A028726;GM0785;2015;     264;     142;     112;      63;      49;      10
10516;A028726;GM0785;2016;     296;     138;     137;      88;      49;      21
10517;A028726;GM0785;2017;     265;     129;     125;      74;      51;      11
10518;A028726;GM0785;2018;     300;     161;     127;      70;      57;      12
10519;A028726;GM0785;2019;     320;     190;     128;      83;      45;       2
10520;A028726;GM0785;2020;     299;     170;     127;      69;      58;       2
10521;A028726;GM1942;2012;;;;;;
10522;A028726;GM1942;2013;;;;;;
10523;A028726;GM1942;2014;;;;;;
10524;A028726;GM1942;2015;;;;;;
10525;A028726;GM1942;2016;    1333;     600;     595;     135;     460;     138
10526;A028726;GM1942;2017;    1374;     560;     677;     148;     529;     137
10527;A028726;GM1942;2018;    1305;     527;     618;     148;     470;     160
10528;A028726;GM1942;2019;    1319;     562;     728;     171;     557;      29
10529;A028726;GM1942;2020;    1339;     583;     740;     207;     533;      16
10530;A028726;GM0512;2012;     852;     247;     455;     274;     181;     150
10531;A028726;GM0512;2013;     892;     264;     493;     279;     214;     135
10532;A028726;GM0512;2014;     805;     226;     484;     171;     313;      95
10533;A028726;GM0512;2015;     703;     224;     409;     184;     225;      70
10534;A028726;GM0512;2016;     750;     248;     426;     191;     235;      76
10535;A028726;GM0512;2017;     766;     207;     482;     219;     263;      77
10536;A028726;GM0512;2018;     694;     197;     424;     163;     261;      73
10537;A028726;GM0512;2019;     741;     268;     464;     196;     268;       9
10538;A028726;GM0512;2020;     892;     263;     619;     204;     415;      10
10539;A028726;GM0513;2012;    1095;     459;     606;     263;     343;      30
10540;A028726;GM0513;2013;    1278;     502;     749;     392;     357;      27
10541;A028726;GM0513;2014;    1399;     452;     768;     261;     507;     179
10542;A028726;GM0513;2015;    1297;     426;     714;     261;     453;     157
10543;A028726;GM0513;2016;    1257;     447;     649;     240;     409;     161
10544;A028726;GM0513;2017;    1185;     412;     621;     239;     382;     152
10545;A028726;GM0513;2018;    1128;     388;     571;     201;     370;     169
10546;A028726;GM0513;2019;    1089;     384;     697;     218;     479;       8
10547;A028726;GM0513;2020;    1117;     401;     704;     164;     540;      12
10548;A028726;GM0693;2012;     230;     143;      66;      27;      39;      21
10549;A028726;GM0693;2013;;;;;;
10550;A028726;GM0693;2014;;;;;;
10551;A028726;GM0693;2015;;;;;;
10552;A028726;GM0693;2016;;;;;;
10553;A028726;GM0693;2017;;;;;;
10554;A028726;GM0693;2018;;;;;;
10555;A028726;GM0693;2019;;;;;;
10556;A028726;GM0693;2020;;;;;;
10557;A028726;GM0365;2012;      86;      60;      23;       3;      20;       3
10558;A028726;GM0365;2013;      82;      58;      22;       3;      19;       2
10559;A028726;GM0365;2014;      72;      52;      18;       2;      16;       2
10560;A028726;GM0365;2015;;;;;;
10561;A028726;GM0365;2016;;;;;;
10562;A028726;GM0365;2017;;;;;;
10563;A028726;GM0365;2018;;;;;;
10564;A028726;GM0365;2019;;;;;;
10565;A028726;GM0365;2020;;;;;;
10566;A028726;GM0786;2012;     186;      97;      79;      25;      54;      10
10567;A028726;GM0786;2013;     160;      84;      67;      16;      51;       9
10568;A028726;GM0786;2014;     208;     121;      79;      10;      69;       8
10569;A028726;GM0786;2015;     191;     110;      72;      22;      50;       9
10570;A028726;GM0786;2016;     159;      93;      56;      17;      39;      10
10571;A028726;GM0786;2017;     153;      80;      65;      19;      46;       8
10572;A028726;GM0786;2018;     220;      80;      59;      12;      47;      81
10573;A028726;GM0786;2019;     203;      76;      47;      13;      34;      80
10574;A028726;GM0786;2020;     211;      75;      59;      15;      44;      77
10575;A028726;GM0518;2012;   22196;    6872;   13002;    2700;   10302;    2322
10576;A028726;GM0518;2013;   22684;    6752;   13318;    2985;   10333;    2614
10577;A028726;GM0518;2014;   24792;    6534;   13623;    2989;   10634;    4635
10578;A028726;GM0518;2015;   23910;    6326;   12959;    3125;    9834;    4625
10579;A028726;GM0518;2016;   22812;    6031;   12463;    2546;    9917;    4318
10580;A028726;GM0518;2017;   22023;    6308;   12484;    2799;    9685;    3231
10581;A028726;GM0518;2018;   19744;    6100;   11009;    1938;    9071;    2635
10582;A028726;GM0518;2019;   19928;    7102;   12206;    2817;    9389;     620
10583;A028726;GM0518;2020;   19956;    6813;   12477;    2844;    9633;     666
10584;A028726;GM0241;2012;     404;     236;     156;      44;     112;      12
10585;A028726;GM0241;2013;     591;     238;     347;     226;     121;       6
10586;A028726;GM0241;2014;     405;     177;     221;     143;      78;       7
10587;A028726;GM0241;2015;     671;     288;     322;     198;     124;      61
10588;A028726;GM0241;2016;;;;;;
10589;A028726;GM0241;2017;;;;;;
10590;A028726;GM0241;2018;;;;;;
10591;A028726;GM0241;2019;;;;;;
10592;A028726;GM0241;2020;;;;;;
10593;A028726;GM0014;2012;    4842;    1271;    2559;    1163;    1396;    1012
10594;A028726;GM0014;2013;    5338;    1285;    3167;    1330;    1837;     886
10595;A028726;GM0014;2014;    4984;    1286;    2959;    1157;    1802;     739
10596;A028726;GM0014;2015;    4379;    1169;    2886;    1508;    1378;     324
10597;A028726;GM0014;2016;    4285;    1128;    2847;    1407;    1440;     310
10598;A028726;GM0014;2017;    4247;     996;    2935;    1394;    1541;     316
10599;A028726;GM0014;2018;    3997;    1017;    2677;    1225;    1452;     303
10600;A028726;GM0014;2019;    4865;    1289;    3462;    1462;    2000;     114
10601;A028726;GM0014;2020;    4904;    1323;    3406;    1319;    2087;     175
10602;A028726;GM0015;2012;     166;     110;      45;      18;      27;      11
10603;A028726;GM0015;2013;     158;      94;      58;      24;      34;       6
10604;A028726;GM0015;2014;     165;      79;      54;      25;      29;      32
10605;A028726;GM0015;2015;     196;      98;      88;      40;      48;      10
10606;A028726;GM0015;2016;     141;      76;      55;      25;      30;      10
10607;A028726;GM0015;2017;     151;      77;      66;      33;      33;       8
10608;A028726;GM0015;2018;     152;      91;      54;      35;      19;       7
10609;A028726;GM0015;2019;;;;;;
10610;A028726;GM0015;2020;;;;;;
10611;A028726;GM1729;2012;     565;     240;     160;      24;     136;     165
10612;A028726;GM1729;2013;     607;     292;     229;      40;     189;      86
10613;A028726;GM1729;2014;     646;     289;     226;      37;     189;     131
10614;A028726;GM1729;2015;     641;     272;     231;      26;     205;     138
10615;A028726;GM1729;2016;     588;     248;     190;      25;     165;     150
10616;A028726;GM1729;2017;     562;     240;     181;      29;     152;     141
10617;A028726;GM1729;2018;     581;     214;     215;      31;     184;     152
10618;A028726;GM1729;2019;     569;     278;     287;      36;     251;       4
10619;A028726;GM1729;2020;     569;     272;     293;      32;     261;       4
10620;A028726;GM0158;2012;     450;     200;     161;      84;      77;      89
10621;A028726;GM0158;2013;     480;     187;     224;     104;     120;      69
10622;A028726;GM0158;2014;     462;     184;     195;      62;     133;      83
10623;A028726;GM0158;2015;     437;     207;     151;      43;     108;      79
10624;A028726;GM0158;2016;     402;     195;     128;      41;      87;      79
10625;A028726;GM0158;2017;     420;     191;     132;      42;      90;      97
10626;A028726;GM0158;2018;     475;     219;     168;      41;     127;      88
10627;A028726;GM0158;2019;     478;     254;     218;      97;     121;       6
10628;A028726;GM0158;2020;     505;     264;     236;     122;     114;       5
10629;A028726;GM0788;2012;     269;     114;      77;      13;      64;      78
10630;A028726;GM0788;2013;     289;     119;     110;      31;      79;      60
10631;A028726;GM0788;2014;     304;     106;     122;      19;     103;      76
10632;A028726;GM0788;2015;     297;     119;      94;      23;      71;      84
10633;A028726;GM0788;2016;     350;     102;      99;      18;      81;     149
10634;A028726;GM0788;2017;     288;     116;     133;      16;     117;      39
10635;A028726;GM0788;2018;     244;      89;     106;      15;      91;      49
10636;A028726;GM0788;2019;     266;     107;     157;      45;     112;       2
10637;A028726;GM0788;2020;     205;      88;     106;       8;      98;      11
10638;A028726;GM0392;2012;    3469;    1499;    1606;     568;    1038;     364
10639;A028726;GM0392;2013;    3320;    1523;    1572;     616;     956;     225
10640;A028726;GM0392;2014;    3040;    1415;    1384;     455;     929;     241
10641;A028726;GM0392;2015;    3147;    1411;    1527;     654;     873;     209
10642;A028726;GM0392;2016;    2973;    1286;    1426;     515;     911;     261
10643;A028726;GM0392;2017;    2952;    1151;    1591;     655;     936;     210
10644;A028726;GM0392;2018;    3174;    1274;    1697;     644;    1053;     203
10645;A028726;GM0392;2019;    3310;    1355;    1933;     706;    1227;      22
10646;A028726;GM0392;2020;    3206;    1270;    1914;     631;    1283;      22
10647;A028726;GM0393;2012;     119;      58;      50;      14;      36;      11
10648;A028726;GM0393;2013;     120;      55;      56;      17;      39;       9
10649;A028726;GM0393;2014;     109;      52;      48;      19;      29;       9
10650;A028726;GM0393;2015;      97;      46;      41;      14;      27;      10
10651;A028726;GM0393;2016;      95;      49;      38;       6;      32;       8
10652;A028726;GM0393;2017;     100;      50;      43;      17;      26;       7
10653;A028726;GM0393;2018;      99;      50;      44;      20;      24;       5
10654;A028726;GM0393;2019;;;;;;
10655;A028726;GM0393;2020;;;;;;
10656;A028726;GM0394;2012;    2451;    1132;    1144;     312;     832;     175
10657;A028726;GM0394;2013;    2382;    1088;    1172;     339;     833;     122
10658;A028726;GM0394;2014;    2376;    1033;    1160;     370;     790;     183
10659;A028726;GM0394;2015;    2044;     908;     934;     286;     648;     202
10660;A028726;GM0394;2016;    2170;     936;     903;     298;     605;     331
10661;A028726;GM0394;2017;    1876;     853;     817;     222;     595;     206
10662;A028726;GM0394;2018;    1885;     841;     878;     267;     611;     166
10663;A028726;GM0394;2019;    2134;     955;    1160;     379;     781;      19
10664;A028726;GM0394;2020;    2089;     945;    1122;     402;     720;      22
10665;A028726;GM1655;2012;     622;     296;     237;     129;     108;      89
10666;A028726;GM1655;2013;     832;     385;     393;     174;     219;      54
10667;A028726;GM1655;2014;     660;     295;     308;     180;     128;      57
10668;A028726;GM1655;2015;     559;     279;     244;     131;     113;      36
10669;A028726;GM1655;2016;     488;     248;     208;     115;      93;      32
10670;A028726;GM1655;2017;     532;     228;     277;     158;     119;      27
10671;A028726;GM1655;2018;     481;     197;     259;     121;     138;      25
10672;A028726;GM1655;2019;     487;     252;     232;     127;     105;       3
10673;A028726;GM1655;2020;     463;     225;     233;     121;     112;       5
10674;A028726;GM0160;2012;    1084;     544;     365;     150;     215;     175
10675;A028726;GM0160;2013;    1025;     478;     372;     133;     239;     175
10676;A028726;GM0160;2014;    1053;     472;     403;     166;     237;     178
10677;A028726;GM0160;2015;     944;     467;     395;     189;     206;      82
10678;A028726;GM0160;2016;     898;     452;     356;     156;     200;      90
10679;A028726;GM0160;2017;     861;     394;     370;     146;     224;      97
10680;A028726;GM0160;2018;     820;     378;     363;     113;     250;      79
10681;A028726;GM0160;2019;     812;     412;     345;     133;     212;      55
10682;A028726;GM0160;2020;     846;     442;     355;     153;     202;      49
10683;A028726;GM0243;2012;     726;     247;     349;     121;     228;     130
10684;A028726;GM0243;2013;     682;     254;     320;     112;     208;     108
10685;A028726;GM0243;2014;     663;     226;     342;     118;     224;      95
10686;A028726;GM0243;2015;     624;     219;     305;     115;     190;     100
10687;A028726;GM0243;2016;     628;     209;     347;     121;     226;      72
10688;A028726;GM0243;2017;     674;     206;     314;     108;     206;     154
10689;A028726;GM0243;2018;     671;     188;     346;     112;     234;     137
10690;A028726;GM0243;2019;     597;     203;     358;     134;     224;      36
10691;A028726;GM0243;2020;     642;     238;     377;     141;     236;      27
10692;A028726;GM0523;2012;     345;     178;     129;      43;      86;      38
10693;A028726;GM0523;2013;     310;     160;     116;      38;      78;      34
10694;A028726;GM0523;2014;     270;     143;      95;      35;      60;      32
10695;A028726;GM0523;2015;     277;     147;      98;      41;      57;      32
10696;A028726;GM0523;2016;     282;     150;     102;      47;      55;      30
10697;A028726;GM0523;2017;     318;     160;     126;      62;      64;      32
10698;A028726;GM0523;2018;     282;     110;     134;      65;      69;      38
10699;A028726;GM0523;2019;     298;     156;     128;      61;      67;      14
10700;A028726;GM0523;2020;     368;     204;     156;      76;      80;       8
10701;A028726;GM0017;2012;     445;     198;     218;     111;     107;      29
10702;A028726;GM0017;2013;     442;     220;     202;      70;     132;      20
10703;A028726;GM0017;2014;     446;     198;     232;     106;     126;      16
10704;A028726;GM0017;2015;     393;     192;     194;      83;     111;       7
10705;A028726;GM0017;2016;     370;     174;     186;      62;     124;      10
10706;A028726;GM0017;2017;     350;     159;     180;      49;     131;      11
10707;A028726;GM0017;2018;     392;     162;     218;      77;     141;      12
10708;A028726;GM0017;2019;;;;;;
10709;A028726;GM0017;2020;;;;;;
10710;A028726;GM0395;2012;     207;     111;      65;      24;      41;      31
10711;A028726;GM0395;2013;;;;;;
10712;A028726;GM0395;2014;;;;;;
10713;A028726;GM0395;2015;;;;;;
10714;A028726;GM0395;2016;;;;;;
10715;A028726;GM0395;2017;;;;;;
10716;A028726;GM0395;2018;;;;;;
10717;A028726;GM0395;2019;;;;;;
10718;A028726;GM0395;2020;;;;;;
10719;A028726;GM0072;2012;     363;     154;     193;      59;     134;      16
10720;A028726;GM0072;2013;     372;     144;     209;      87;     122;      19
10721;A028726;GM0072;2014;     344;     146;     183;      77;     106;      15
10722;A028726;GM0072;2015;     337;     163;     163;      50;     113;      11
10723;A028726;GM0072;2016;     364;     174;     175;      61;     114;      15
10724;A028726;GM0072;2017;     363;     166;     177;      79;      98;      20
10725;A028726;GM0072;2018;     459;     195;     251;     151;     100;      13
10726;A028726;GM0072;2019;     401;     187;     210;     107;     103;       4
10727;A028726;GM0072;2020;     493;     181;     308;     185;     123;       4
10728;A028726;GM0244;2012;     263;      84;      71;      21;      50;     108
10729;A028726;GM0244;2013;     316;     103;     193;      54;     139;      20
10730;A028726;GM0244;2014;     226;     106;      96;      30;      66;      24
10731;A028726;GM0244;2015;     255;      96;      91;      43;      48;      68
10732;A028726;GM0244;2016;     308;      94;     119;      71;      48;      95
10733;A028726;GM0244;2017;     266;      93;     111;      52;      59;      62
10734;A028726;GM0244;2018;     235;      59;     117;      67;      50;      59
10735;A028726;GM0244;2019;     213;      77;     134;      43;      91;       2
10736;A028726;GM0244;2020;     205;      84;     120;      33;      87;       1
10737;A028726;GM0396;2012;     559;     224;     303;     129;     174;      32
10738;A028726;GM0396;2013;     527;     234;     261;      99;     162;      32
10739;A028726;GM0396;2014;     590;     195;     355;     154;     201;      40
10740;A028726;GM0396;2015;     527;     204;     293;      86;     207;      30
10741;A028726;GM0396;2016;     446;     181;     246;      85;     161;      19
10742;A028726;GM0396;2017;     478;     142;     319;     117;     202;      17
10743;A028726;GM0396;2018;     424;     173;     237;      77;     160;      14
10744;A028726;GM0396;2019;     497;     191;     296;     232;      64;      10
10745;A028726;GM0396;2020;     504;     206;     286;     200;      86;      12
10746;A028726;GM0397;2012;     505;     319;     155;      37;     118;      31
10747;A028726;GM0397;2013;     524;     333;     163;      38;     125;      28
10748;A028726;GM0397;2014;     612;     299;     220;      66;     154;      93
10749;A028726;GM0397;2015;     557;     277;     207;      36;     171;      73
10750;A028726;GM0397;2016;     588;     257;     251;      32;     219;      80
10751;A028726;GM0397;2017;     550;     237;     237;      47;     190;      76
10752;A028726;GM0397;2018;     547;     253;     221;      48;     173;      73
10753;A028726;GM0397;2019;     521;     227;     281;      57;     224;      13
10754;A028726;GM0397;2020;     592;     269;     302;      61;     241;      21
10755;A028726;GM0246;2012;     296;     172;      81;      25;      56;      43
10756;A028726;GM0246;2013;     363;     231;     106;      24;      82;      26
10757;A028726;GM0246;2014;     342;     205;      82;      23;      59;      55
10758;A028726;GM0246;2015;     298;     178;      70;      27;      43;      50
10759;A028726;GM0246;2016;     299;     168;      76;      33;      43;      55
10760;A028726;GM0246;2017;     275;     155;      79;      35;      44;      41
10761;A028726;GM0246;2018;     270;     157;      86;      36;      50;      27
10762;A028726;GM0246;2019;     322;     206;     107;      65;      42;       9
10763;A028726;GM0246;2020;     277;     173;     101;      52;      49;       3
10764;A028726;GM0074;2012;    1034;     330;     544;     183;     361;     160
10765;A028726;GM0074;2013;     952;     319;     539;     159;     380;      94
10766;A028726;GM0074;2014;    1072;     366;     634;     207;     427;      72
10767;A028726;GM0074;2015;    1116;     349;     636;     189;     447;     131
10768;A028726;GM0074;2016;    1104;     320;     703;     163;     540;      81
10769;A028726;GM0074;2017;    1078;     323;     693;     192;     501;      62
10770;A028726;GM0074;2018;    1085;     300;     706;     143;     563;      79
10771;A028726;GM0074;2019;    1216;     348;     818;     204;     614;      50
10772;A028726;GM0074;2020;     927;     365;     542;     157;     385;      20
10773;A028726;GM0398;2012;     500;     223;     268;     114;     154;       9
10774;A028726;GM0398;2013;     489;     221;     257;      88;     169;      11
10775;A028726;GM0398;2014;     548;     242;     265;      76;     189;      41
10776;A028726;GM0398;2015;     520;     235;     245;      84;     161;      40
10777;A028726;GM0398;2016;     417;     203;     199;      67;     132;      15
10778;A028726;GM0398;2017;     467;     230;     212;      85;     127;      25
10779;A028726;GM0398;2018;     542;     226;     244;      87;     157;      72
10780;A028726;GM0398;2019;     439;     212;     226;     104;     122;       1
10781;A028726;GM0398;2020;     556;     260;     295;     113;     182;       1
10782;A028726;GM0917;2012;    2770;     841;    1816;     787;    1029;     113
10783;A028726;GM0917;2013;    2818;     826;    1909;     951;     958;      83
10784;A028726;GM0917;2014;    2904;     786;    2041;    1071;     970;      77
10785;A028726;GM0917;2015;    2600;     795;    1704;     752;     952;     101
10786;A028726;GM0917;2016;    2483;     780;    1603;     680;     923;     100
10787;A028726;GM0917;2017;    2454;     718;    1602;     631;     971;     134
10788;A028726;GM0917;2018;    2444;     666;    1637;     645;     992;     141
10789;A028726;GM0917;2019;    2374;     761;    1554;     668;     886;      59
10790;A028726;GM0917;2020;    2390;     720;    1632;     752;     880;      38
10791;A028726;GM1658;2012;     323;     215;      83;      18;      65;      25
10792;A028726;GM1658;2013;     332;     211;      98;      38;      60;      23
10793;A028726;GM1658;2014;     337;     211;      96;      35;      61;      30
10794;A028726;GM1658;2015;     319;     222;      74;      18;      56;      23
10795;A028726;GM1658;2016;     284;     179;      63;       9;      54;      42
10796;A028726;GM1658;2017;     268;     171;      68;      17;      51;      29
10797;A028726;GM1658;2018;     311;     197;      85;      27;      58;      29
10798;A028726;GM1658;2019;     291;     207;      80;      19;      61;       4
10799;A028726;GM1658;2020;     258;     170;      84;      16;      68;       4
10800;A028726;GM0399;2012;     402;     228;     104;      22;      82;      70
10801;A028726;GM0399;2013;     419;     241;     126;      22;     104;      52
10802;A028726;GM0399;2014;     394;     202;     148;      30;     118;      44
10803;A028726;GM0399;2015;     469;     181;     243;      25;     218;      45
10804;A028726;GM0399;2016;     385;     192;     105;      15;      90;      88
10805;A028726;GM0399;2017;     370;     165;     147;      60;      87;      58
10806;A028726;GM0399;2018;     438;     170;     134;      32;     102;     134
10807;A028726;GM0399;2019;     349;     191;     154;      25;     129;       4
10808;A028726;GM0399;2020;     358;     192;     161;      27;     134;       5
10809;A028726;GM0400;2012;    1309;     545;     643;     383;     260;     121
10810;A028726;GM0400;2013;    1476;     548;     818;     536;     282;     110
10811;A028726;GM0400;2014;    1834;     518;     895;     511;     384;     421
10812;A028726;GM0400;2015;    1641;     569;     933;     570;     363;     139
10813;A028726;GM0400;2016;    1584;     562;     911;     611;     300;     111
10814;A028726;GM0400;2017;    1576;     537;     868;     573;     295;     171
10815;A028726;GM0400;2018;    1518;     515;     865;     492;     373;     138
10816;A028726;GM0400;2019;    1446;     549;     885;     444;     441;      12
10817;A028726;GM0400;2020;    1407;     524;     858;     431;     427;      25
10818;A028726;GM0163;2012;     609;     341;     247;      87;     160;      21
10819;A028726;GM0163;2013;     514;     292;     210;      68;     142;      12
10820;A028726;GM0163;2014;     468;     264;     189;      74;     115;      15
10821;A028726;GM0163;2015;     436;     245;     172;      78;      94;      19
10822;A028726;GM0163;2016;     399;     238;     139;      40;      99;      22
10823;A028726;GM0163;2017;     391;     207;     166;      61;     105;      18
10824;A028726;GM0163;2018;     365;     175;     166;      60;     106;      24
10825;A028726;GM0163;2019;     381;     223;     147;      68;      79;      11
10826;A028726;GM0163;2020;     405;     230;     165;      46;     119;      10
10827;A028726;GM0530;2012;     606;     300;     239;     125;     114;      67
10828;A028726;GM0530;2013;     678;     353;     289;     145;     144;      36
10829;A028726;GM0530;2014;     626;     323;     289;     127;     162;      14
10830;A028726;GM0530;2015;     620;     322;     279;     147;     132;      19
10831;A028726;GM0530;2016;     596;     280;     301;     184;     117;      15
10832;A028726;GM0530;2017;     565;     320;     229;     118;     111;      16
10833;A028726;GM0530;2018;     520;     260;     243;     120;     123;      17
10834;A028726;GM0530;2019;     483;     229;     245;     102;     143;       9
10835;A028726;GM0530;2020;     513;     249;     258;     121;     137;       6
10836;A028726;GM0794;2012;    1395;     533;     724;     320;     404;     138
10837;A028726;GM0794;2013;    1448;     535;     784;     409;     375;     129
10838;A028726;GM0794;2014;    1456;     492;     843;     480;     363;     121
10839;A028726;GM0794;2015;    1207;     470;     706;     315;     391;      31
10840;A028726;GM0794;2016;    1118;     454;     642;     233;     409;      22
10841;A028726;GM0794;2017;    1049;     420;     602;     224;     378;      27
10842;A028726;GM0794;2018;    1036;     440;     565;     233;     332;      31
10843;A028726;GM0794;2019;    1115;     439;     675;     305;     370;       1
10844;A028726;GM0794;2020;    1055;     402;     644;     332;     312;       9
10845;A028726;GM0531;2012;     767;     278;     141;      51;      90;     348
10846;A028726;GM0531;2013;     448;     189;     144;      51;      93;     115
10847;A028726;GM0531;2014;     404;     206;     141;      58;      83;      57
10848;A028726;GM0531;2015;     368;     202;     109;      54;      55;      57
10849;A028726;GM0531;2016;     352;     180;     112;      57;      55;      60
10850;A028726;GM0531;2017;     355;     162;     133;      68;      65;      60
10851;A028726;GM0531;2018;     299;     133;     110;      42;      68;      56
10852;A028726;GM0531;2019;     260;     146;     110;      48;      62;       4
10853;A028726;GM0531;2020;     276;     159;     116;      64;      52;       1
10854;A028726;GM0164;2012;    1880;     512;    1164;     650;     514;     204
10855;A028726;GM0164;2013;    1772;     494;    1187;     797;     390;      91
10856;A028726;GM0164;2014;    1789;     482;     780;     479;     301;     527
10857;A028726;GM0164;2015;    1654;     486;     705;     429;     276;     463
10858;A028726;GM0164;2016;    1743;     469;     860;     579;     281;     414
10859;A028726;GM0164;2017;    1631;     408;     838;     535;     303;     385
10860;A028726;GM0164;2018;    1682;     398;     914;     485;     429;     370
10861;A028726;GM0164;2019;    1509;     451;    1052;     446;     606;       6
10862;A028726;GM0164;2020;    1453;     475;     946;     408;     538;      32
10863;A028726;GM0796;2012;    2407;    1057;    1182;     569;     613;     168
10864;A028726;GM0796;2013;    2382;    1017;    1136;     492;     644;     229
10865;A028726;GM0796;2014;    2241;     905;    1001;     417;     584;     335
10866;A028726;GM0796;2015;    2743;     963;    1183;     513;     670;     597
10867;A028726;GM0796;2016;    2748;     919;    1049;     457;     592;     780
10868;A028726;GM0796;2017;    2763;     876;    1356;     491;     865;     531
10869;A028726;GM0796;2018;    2667;     885;    1323;     406;     917;     459
10870;A028726;GM0796;2019;    2634;    1020;    1562;     478;    1084;      52
10871;A028726;GM0796;2020;    2631;     990;    1575;     586;     989;      66
10872;A028726;GM0252;2012;     219;     120;      90;      56;      34;       9
10873;A028726;GM0252;2013;     176;     108;      60;      17;      43;       8
10874;A028726;GM0252;2014;     157;      97;      53;       9;      44;       7
10875;A028726;GM0252;2015;     186;     100;      64;      25;      39;      22
10876;A028726;GM0252;2016;     167;      99;      56;      20;      36;      12
10877;A028726;GM0252;2017;     153;      89;      58;      22;      36;       6
10878;A028726;GM0252;2018;     178;      84;      77;      20;      57;      17
10879;A028726;GM0252;2019;     156;      95;      56;      14;      42;       5
10880;A028726;GM0252;2020;     182;     116;      57;      19;      38;       9
10881;A028726;GM0797;2012;     664;     367;     220;      79;     141;      77
10882;A028726;GM0797;2013;     614;     341;     233;      85;     148;      40
10883;A028726;GM0797;2014;     575;     313;     220;      73;     147;      42
10884;A028726;GM0797;2015;     619;     351;     233;      85;     148;      35
10885;A028726;GM0797;2016;     586;     320;     210;      73;     137;      56
10886;A028726;GM0797;2017;     573;     312;     211;      76;     135;      50
10887;A028726;GM0797;2018;     585;     302;     241;      88;     153;      42
10888;A028726;GM0797;2019;     558;     324;     231;      85;     146;       3
10889;A028726;GM0797;2020;     620;     360;     257;      82;     175;       3
10890;A028726;GM0534;2012;     382;     176;     188;      89;      99;      18
10891;A028726;GM0534;2013;     416;     199;     211;      72;     139;       6
10892;A028726;GM0534;2014;     381;     187;     181;      77;     104;      13
10893;A028726;GM0534;2015;     382;     197;     170;      54;     116;      15
10894;A028726;GM0534;2016;     343;     143;     181;      97;      84;      19
10895;A028726;GM0534;2017;     273;     145;     106;      43;      63;      22
10896;A028726;GM0534;2018;     262;     137;     121;      37;      84;       4
10897;A028726;GM0534;2019;     286;     129;     157;      79;      78;       0
10898;A028726;GM0534;2020;     256;     133;     123;      35;      88;       0
10899;A028726;GM0798;2012;     362;     156;     105;      35;      70;     101
10900;A028726;GM0798;2013;     364;     157;     126;      20;     106;      81
10901;A028726;GM0798;2014;     394;     162;     157;      31;     126;      75
10902;A028726;GM0798;2015;     353;     148;     133;      27;     106;      72
10903;A028726;GM0798;2016;     355;     139;     129;      24;     105;      87
10904;A028726;GM0798;2017;     263;     114;      98;      19;      79;      51
10905;A028726;GM0798;2018;     270;     132;     101;      20;      81;      37
10906;A028726;GM0798;2019;     289;     174;     109;      37;      72;       6
10907;A028726;GM0798;2020;     278;     182;      91;      25;      66;       5
10908;A028726;GM0402;2012;    1992;     843;    1118;     572;     546;      31
10909;A028726;GM0402;2013;    2277;     937;    1261;     405;     856;      79
10910;A028726;GM0402;2014;    2238;     861;    1224;     324;     900;     153
10911;A028726;GM0402;2015;    2163;     805;    1128;     377;     751;     230
10912;A028726;GM0402;2016;    2015;     829;     972;     255;     717;     214
10913;A028726;GM0402;2017;    2047;     687;    1055;     322;     733;     305
10914;A028726;GM0402;2018;    1909;     596;     990;     296;     694;     323
10915;A028726;GM0402;2019;    2009;     667;    1328;     564;     764;      14
10916;A028726;GM0402;2020;    1971;     694;    1265;     453;     812;      12
10917;A028726;GM1963;2012;;;;;;
10918;A028726;GM1963;2013;;;;;;
10919;A028726;GM1963;2014;;;;;;
10920;A028726;GM1963;2015;;;;;;
10921;A028726;GM1963;2016;;;;;;
10922;A028726;GM1963;2017;;;;;;
10923;A028726;GM1963;2018;;;;;;
10924;A028726;GM1963;2019;    1305;     786;     508;     261;     247;      11
10925;A028726;GM1963;2020;    1100;     610;     457;     220;     237;      33
10926;A028726;GM1735;2012;     842;     370;     432;     215;     217;      40
10927;A028726;GM1735;2013;     737;     352;     352;     133;     219;      33
10928;A028726;GM1735;2014;     804;     378;     392;     177;     215;      34
10929;A028726;GM1735;2015;     726;     353;     342;     186;     156;      31
10930;A028726;GM1735;2016;     604;     309;     255;      87;     168;      40
10931;A028726;GM1735;2017;     564;     301;     221;      55;     166;      42
10932;A028726;GM1735;2018;     574;     287;     247;      62;     185;      40
10933;A028726;GM1735;2019;     584;     334;     250;      63;     187;       0
10934;A028726;GM1735;2020;     568;     312;     255;      57;     198;       1
10935;A028726;GM1966;2012;;;;;;
10936;A028726;GM1966;2013;;;;;;
10937;A028726;GM1966;2014;;;;;;
10938;A028726;GM1966;2015;;;;;;
10939;A028726;GM1966;2016;;;;;;
10940;A028726;GM1966;2017;;;;;;
10941;A028726;GM1966;2018;;;;;;
10942;A028726;GM1966;2019;    1406;     743;     616;     269;     347;      47
10943;A028726;GM1966;2020;    1372;     722;     630;     200;     430;      20
10944;A028726;GM1911;2012;     822;     478;     287;     104;     183;      57
10945;A028726;GM1911;2013;     900;     519;     321;     141;     180;      60
10946;A028726;GM1911;2014;     910;     518;     326;     128;     198;      66
10947;A028726;GM1911;2015;     889;     500;     326;     145;     181;      63
10948;A028726;GM1911;2016;     863;     481;     314;     125;     189;      68
10949;A028726;GM1911;2017;     873;     491;     298;     102;     196;      84
10950;A028726;GM1911;2018;     875;     436;     340;     145;     195;      99
10951;A028726;GM1911;2019;     892;     518;     323;     166;     157;      51
10952;A028726;GM1911;2020;     911;     474;     368;     177;     191;      69
10953;A028726;GM0118;2012;     792;     425;     351;     177;     174;      16
10954;A028726;GM0118;2013;     821;     416;     384;     205;     179;      21
10955;A028726;GM0118;2014;    1115;     421;     663;     221;     442;      31
10956;A028726;GM0118;2015;    1125;     378;     700;     292;     408;      47
10957;A028726;GM0118;2016;    1025;     364;     605;     194;     411;      56
10958;A028726;GM0118;2017;    1000;     323;     621;     204;     417;      56
10959;A028726;GM0118;2018;     990;     302;     628;     205;     423;      60
10960;A028726;GM0118;2019;    1057;     309;     714;     454;     260;      34
10961;A028726;GM0118;2020;    1070;     329;     687;     315;     372;      54
10962;A028726;GM0018;2012;    1207;     413;     714;     212;     502;      80
10963;A028726;GM0018;2013;     597;     215;     350;     202;     148;      32
10964;A028726;GM0018;2014;     549;     217;     320;     140;     180;      12
10965;A028726;GM0018;2015;     556;     202;     293;     117;     176;      61
10966;A028726;GM0018;2016;     513;     193;     272;     128;     144;      48
10967;A028726;GM0018;2017;     493;     171;     270;     117;     153;      52
10968;A028726;GM0018;2018;;;;;;
10969;A028726;GM0018;2019;;;;;;
10970;A028726;GM0018;2020;;;;;;
10971;A028726;GM0405;2012;     835;     412;     397;     210;     187;      26
10972;A028726;GM0405;2013;     916;     443;     426;     242;     184;      47
10973;A028726;GM0405;2014;     935;     385;     470;     172;     298;      80
10974;A028726;GM0405;2015;     960;     380;     417;     231;     186;     163
10975;A028726;GM0405;2016;     964;     376;     476;     287;     189;     112
10976;A028726;GM0405;2017;     893;     365;     390;     179;     211;     138
10977;A028726;GM0405;2018;     893;     316;     486;     294;     192;      91
10978;A028726;GM0405;2019;     739;     321;     412;     153;     259;       6
10979;A028726;GM0405;2020;     897;     422;     466;     159;     307;       9
10980;A028726;GM1507;2012;     660;     383;     234;      46;     188;      43
10981;A028726;GM1507;2013;     654;     344;     281;      39;     242;      29
10982;A028726;GM1507;2014;     684;     341;     282;      47;     235;      61
10983;A028726;GM1507;2015;     691;     345;     265;      57;     208;      81
10984;A028726;GM1507;2016;     692;     348;     239;      48;     191;     105
10985;A028726;GM1507;2017;     530;     282;     212;      45;     167;      36
10986;A028726;GM1507;2018;     518;     267;     215;      43;     172;      36
10987;A028726;GM1507;2019;     488;     290;     186;      42;     144;      12
10988;A028726;GM1507;2020;     528;     318;     198;      42;     156;      12
10989;A028726;GM0321;2012;     555;     296;     196;      87;     109;      63
10990;A028726;GM0321;2013;     520;     249;     237;      83;     154;      34
10991;A028726;GM0321;2014;     588;     305;     250;      79;     171;      33
10992;A028726;GM0321;2015;     450;     192;     224;      74;     150;      34
10993;A028726;GM0321;2016;     417;     188;     193;      86;     107;      36
10994;A028726;GM0321;2017;     445;     177;     225;      79;     146;      43
10995;A028726;GM0321;2018;     494;     227;     218;     103;     115;      49
10996;A028726;GM0321;2019;     417;     212;     196;      89;     107;       9
10997;A028726;GM0321;2020;     444;     193;     245;      95;     150;       6
10998;A028726;GM0406;2012;     618;     311;     305;     159;     146;       2
10999;A028726;GM0406;2013;     610;     285;     323;     192;     131;       2
11000;A028726;GM0406;2014;     700;     286;     342;     178;     164;      72
11001;A028726;GM0406;2015;     647;     292;     280;     144;     136;      75
11002;A028726;GM0406;2016;     539;     271;     250;     100;     150;      18
11003;A028726;GM0406;2017;     484;     211;     241;     104;     137;      32
11004;A028726;GM0406;2018;     575;     209;     302;     114;     188;      64
11005;A028726;GM0406;2019;     548;     244;     300;     118;     182;       4
11006;A028726;GM0406;2020;     518;     238;     271;     118;     153;       9
11007;A028726;GM0677;2012;    1443;     722;     632;     140;     492;      89
11008;A028726;GM0677;2013;    1006;     585;     328;     117;     211;      93
11009;A028726;GM0677;2014;     994;     546;     348;     116;     232;     100
11010;A028726;GM0677;2015;     953;     546;     356;     106;     250;      51
11011;A028726;GM0677;2016;     992;     558;     382;     110;     272;      52
11012;A028726;GM0677;2017;     997;     538;     401;     119;     282;      58
11013;A028726;GM0677;2018;     959;     492;     408;     125;     283;      59
11014;A028726;GM0677;2019;    1026;     544;     379;     143;     236;     103
11015;A028726;GM0677;2020;    1011;     525;     359;     140;     219;     127
11016;A028726;GM0353;2012;     317;     148;     138;      69;      69;      31
11017;A028726;GM0353;2013;     376;     167;     194;      83;     111;      15
11018;A028726;GM0353;2014;     381;     156;     188;      97;      91;      37
11019;A028726;GM0353;2015;     336;     139;     160;      59;     101;      37
11020;A028726;GM0353;2016;     302;     136;     143;      45;      98;      23
11021;A028726;GM0353;2017;     355;     138;     192;      83;     109;      25
11022;A028726;GM0353;2018;     255;     105;     133;      42;      91;      17
11023;A028726;GM0353;2019;     274;     122;     152;      46;     106;       0
11024;A028726;GM0353;2020;     291;     129;     159;      40;     119;       3
11025;A028726;GM1884;2012;     516;     303;     169;      42;     127;      44
11026;A028726;GM1884;2013;     555;     328;     199;      54;     145;      28
11027;A028726;GM1884;2014;     537;     295;     206;      57;     149;      36
11028;A028726;GM1884;2015;     527;     286;     196;      64;     132;      45
11029;A028726;GM1884;2016;     473;     282;     152;      32;     120;      39
11030;A028726;GM1884;2017;     479;     281;     157;      32;     125;      41
11031;A028726;GM1884;2018;     423;     232;     158;      42;     116;      33
11032;A028726;GM1884;2019;     473;     241;     223;      77;     146;       9
11033;A028726;GM1884;2020;     434;     260;     164;      44;     120;      10
11034;A028726;GM0166;2012;    1505;     515;     902;     370;     532;      88
11035;A028726;GM0166;2013;    1172;     480;     625;     322;     303;      67
11036;A028726;GM0166;2014;    1146;     436;     597;     305;     292;     113
11037;A028726;GM0166;2015;    1035;     452;     472;     177;     295;     111
11038;A028726;GM0166;2016;     908;     415;     420;     151;     269;      73
11039;A028726;GM0166;2017;     859;     412;     386;     138;     248;      61
11040;A028726;GM0166;2018;     893;     425;     393;     129;     264;      75
11041;A028726;GM0166;2019;     875;     452;     412;     145;     267;      11
11042;A028726;GM0166;2020;     882;     445;     431;     155;     276;       6
11043;A028726;GM0678;2012;     192;     142;      49;      15;      34;       1
11044;A028726;GM0678;2013;     198;     128;      70;      13;      57;       0
11045;A028726;GM0678;2014;     231;     145;      82;      18;      64;       4
11046;A028726;GM0678;2015;     216;     111;      96;      20;      76;       9
11047;A028726;GM0678;2016;     195;     110;      73;      15;      58;      12
11048;A028726;GM0678;2017;     244;     121;     107;      21;      86;      16
11049;A028726;GM0678;2018;     219;     120;      89;      16;      73;      10
11050;A028726;GM0678;2019;     208;     130;      65;      17;      48;      13
11051;A028726;GM0678;2020;     241;     155;      67;      14;      53;      19
11052;A028726;GM0537;2012;     947;     511;     417;     166;     251;      19
11053;A028726;GM0537;2013;     925;     446;     426;     206;     220;      53
11054;A028726;GM0537;2014;     874;     427;     431;     138;     293;      16
11055;A028726;GM0537;2015;     869;     487;     362;     107;     255;      20
11056;A028726;GM0537;2016;     894;     415;     448;     138;     310;      31
11057;A028726;GM0537;2017;    1020;     465;     512;     197;     315;      43
11058;A028726;GM0537;2018;     752;     364;     343;     110;     233;      45
11059;A028726;GM0537;2019;     928;     418;     494;     180;     314;      16
11060;A028726;GM0537;2020;     885;     382;     473;     107;     366;      30
11061;A028726;GM0928;2012;    1586;     567;     934;     519;     415;      85
11062;A028726;GM0928;2013;    1462;     570;     827;     467;     360;      65
11063;A028726;GM0928;2014;    1476;     588;     819;     398;     421;      69
11064;A028726;GM0928;2015;    1626;     509;    1043;     528;     515;      74
11065;A028726;GM0928;2016;    1744;     494;    1144;     630;     514;     106
11066;A028726;GM0928;2017;    1643;     499;    1004;     559;     445;     140
11067;A028726;GM0928;2018;    1534;     446;     966;     450;     516;     122
11068;A028726;GM0928;2019;    1239;     495;     697;     171;     526;      47
11069;A028726;GM0928;2020;    1170;     459;     655;     193;     462;      56
11070;A028726;GM1598;2012;     285;     194;      73;      19;      54;      18
11071;A028726;GM1598;2013;     293;     201;      76;      13;      63;      16
11072;A028726;GM1598;2014;     348;     154;     132;      20;     112;      62
11073;A028726;GM1598;2015;     315;     148;     122;      23;      99;      45
11074;A028726;GM1598;2016;     304;     149;     115;      25;      90;      40
11075;A028726;GM1598;2017;     302;     151;     120;      22;      98;      31
11076;A028726;GM1598;2018;     275;     133;     118;      21;      97;      24
11077;A028726;GM1598;2019;     284;     158;     122;      20;     102;       4
11078;A028726;GM1598;2020;     304;     168;     112;      11;     101;      24
11079;A028726;GM0079;2012;     211;     110;      93;      49;      44;       8
11080;A028726;GM0079;2013;     255;     128;     119;      71;      48;       8
11081;A028726;GM0079;2014;     235;     132;      96;      53;      43;       7
11082;A028726;GM0079;2015;     236;     129;     100;      59;      41;       7
11083;A028726;GM0079;2016;     170;     113;      48;      17;      31;       9
11084;A028726;GM0079;2017;     194;     123;      59;      33;      26;      12
11085;A028726;GM0079;2018;     216;     119;      90;      48;      42;       7
11086;A028726;GM0079;2019;;;;;;
11087;A028726;GM0079;2020;;;;;;
11088;A028726;GM0588;2012;     180;      95;      69;      26;      43;      16
11089;A028726;GM0588;2013;     189;     106;      79;      38;      41;       4
11090;A028726;GM0588;2014;     168;     100;      66;      25;      41;       2
11091;A028726;GM0588;2015;     169;     100;      67;      28;      39;       2
11092;A028726;GM0588;2016;     166;      86;      76;      22;      54;       4
11093;A028726;GM0588;2017;     202;      99;     100;      33;      67;       3
11094;A028726;GM0588;2018;     155;      73;      76;      15;      61;       6
11095;A028726;GM0588;2019;;;;;;
11096;A028726;GM0588;2020;;;;;;
11097;A028726;GM0542;2012;     486;     204;     267;     195;      72;      15
11098;A028726;GM0542;2013;     674;     221;     436;     350;      86;      17
11099;A028726;GM0542;2014;     462;     213;     226;     156;      70;      23
11100;A028726;GM0542;2015;     358;     192;     141;      90;      51;      25
11101;A028726;GM0542;2016;     274;     154;      89;      57;      32;      31
11102;A028726;GM0542;2017;     289;     151;      99;      60;      39;      39
11103;A028726;GM0542;2018;     309;     146;     125;      89;      36;      38
11104;A028726;GM0542;2019;     299;     166;     133;      76;      57;       0
11105;A028726;GM0542;2020;     342;     144;     198;     136;      62;       0
11106;A028726;GM1931;2012;;;;;;
11107;A028726;GM1931;2013;;;;;;
11108;A028726;GM1931;2014;;;;;;
11109;A028726;GM1931;2015;    1330;     586;     594;     256;     338;     150
11110;A028726;GM1931;2016;    1100;     573;     475;     195;     280;      52
11111;A028726;GM1931;2017;    1097;     577;     464;     196;     268;      56
11112;A028726;GM1931;2018;     920;     454;     420;     128;     292;      46
11113;A028726;GM1931;2019;     951;     509;     428;     227;     201;      14
11114;A028726;GM1931;2020;     928;     487;     419;     205;     214;      22
11115;A028726;GM1659;2012;     332;     190;     117;      46;      71;      25
11116;A028726;GM1659;2013;     401;     206;     179;      75;     104;      16
11117;A028726;GM1659;2014;     348;     188;     137;      58;      79;      23
11118;A028726;GM1659;2015;     315;     167;     122;      52;      70;      26
11119;A028726;GM1659;2016;     309;     158;     124;      55;      69;      27
11120;A028726;GM1659;2017;     296;     154;     118;      47;      71;      24
11121;A028726;GM1659;2018;     304;     171;     116;      40;      76;      17
11122;A028726;GM1659;2019;     303;     177;     123;      50;      73;       3
11123;A028726;GM1659;2020;     319;     172;     143;      59;      84;       4
11124;A028726;GM1685;2012;     312;     156;     124;      36;      88;      32
11125;A028726;GM1685;2013;     242;     139;      86;      16;      70;      17
11126;A028726;GM1685;2014;     251;     147;      93;      23;      70;      11
11127;A028726;GM1685;2015;     214;     147;      61;      16;      45;       6
11128;A028726;GM1685;2016;     223;     148;      67;      19;      48;       8
11129;A028726;GM1685;2017;     213;     137;      66;      10;      56;      10
11130;A028726;GM1685;2018;     202;     118;      73;      17;      56;      11
11131;A028726;GM1685;2019;     282;     194;      86;      24;      62;       2
11132;A028726;GM1685;2020;     226;     141;      85;      24;      61;       0
11133;A028726;GM0882;2012;     882;     423;     432;     218;     214;      27
11134;A028726;GM0882;2013;     888;     385;     483;     226;     257;      20
11135;A028726;GM0882;2014;     876;     360;     489;     227;     262;      27
11136;A028726;GM0882;2015;     703;     364;     309;     100;     209;      30
11137;A028726;GM0882;2016;     687;     352;     292;      92;     200;      43
11138;A028726;GM0882;2017;     715;     349;     330;     121;     209;      36
11139;A028726;GM0882;2018;     684;     296;     321;     102;     219;      67
11140;A028726;GM0882;2019;     639;     325;     294;     119;     175;      20
11141;A028726;GM0882;2020;     610;     311;     279;     107;     172;      20
11142;A028726;GM0415;2012;     166;      95;      62;      11;      51;       9
11143;A028726;GM0415;2013;     165;     109;      47;      18;      29;       9
11144;A028726;GM0415;2014;     151;      88;      54;      31;      23;       9
11145;A028726;GM0415;2015;     164;      84;      71;      35;      36;       9
11146;A028726;GM0415;2016;     159;     104;      46;      20;      26;       9
11147;A028726;GM0415;2017;     152;      91;      54;      20;      34;       7
11148;A028726;GM0415;2018;     170;     111;      54;      21;      33;       5
11149;A028726;GM0415;2019;     202;     108;      94;      53;      41;       0
11150;A028726;GM0415;2020;     222;     125;      97;      61;      36;       0
11151;A028726;GM0416;2012;     296;     208;      80;      22;      58;       8
11152;A028726;GM0416;2013;     346;     195;     145;      65;      80;       6
11153;A028726;GM0416;2014;     306;     188;     110;      38;      72;       8
11154;A028726;GM0416;2015;     278;     186;      81;      31;      50;      11
11155;A028726;GM0416;2016;     326;     197;     116;      46;      70;      13
11156;A028726;GM0416;2017;     277;     170;      91;      34;      57;      16
11157;A028726;GM0416;2018;     321;     168;     132;      31;     101;      21
11158;A028726;GM0416;2019;     287;     142;     145;      72;      73;       0
11159;A028726;GM0416;2020;     303;     163;     140;      58;      82;       0
11160;A028726;GM1621;2012;     833;     450;     302;     126;     176;      81
11161;A028726;GM1621;2013;     799;     437;     293;      99;     194;      69
11162;A028726;GM1621;2014;     765;     422;     271;      88;     183;      72
11163;A028726;GM1621;2015;     743;     376;     257;      84;     173;     110
11164;A028726;GM1621;2016;     721;     440;     216;      60;     156;      65
11165;A028726;GM1621;2017;     671;     369;     226;      62;     164;      76
11166;A028726;GM1621;2018;     609;     301;     244;      64;     180;      64
11167;A028726;GM1621;2019;     673;     362;     305;      81;     224;       6
11168;A028726;GM1621;2020;     805;     454;     344;     120;     224;       7
11169;A028726;GM0417;2012;     404;     223;     153;      27;     126;      28
11170;A028726;GM0417;2013;     502;     255;     155;      17;     138;      92
11171;A028726;GM0417;2014;     473;     241;     185;      22;     163;      47
11172;A028726;GM0417;2015;     445;     239;     164;      20;     144;      42
11173;A028726;GM0417;2016;     436;     230;     161;      14;     147;      45
11174;A028726;GM0417;2017;     460;     213;     149;      12;     137;      98
11175;A028726;GM0417;2018;     421;     201;     172;      15;     157;      48
11176;A028726;GM0417;2019;     424;     223;     173;      11;     162;      28
11177;A028726;GM0417;2020;     495;     234;     236;      20;     216;      25
11178;A028726;GM0022;2012;     249;     124;     110;      45;      65;      15
11179;A028726;GM0022;2013;     215;     112;      90;      40;      50;      13
11180;A028726;GM0022;2014;     200;      97;      89;      31;      58;      14
11181;A028726;GM0022;2015;     207;      94;      89;      46;      43;      24
11182;A028726;GM0022;2016;     201;      89;     110;      57;      53;       2
11183;A028726;GM0022;2017;     193;     100;      91;      39;      52;       2
11184;A028726;GM0022;2018;     173;      70;     102;      47;      55;       1
11185;A028726;GM0022;2019;;;;;;
11186;A028726;GM0022;2020;;;;;;
11187;A028726;GM0545;2012;     411;     138;     229;     151;      78;      44
11188;A028726;GM0545;2013;     326;     142;     165;     105;      60;      19
11189;A028726;GM0545;2014;     446;     123;     280;     192;      88;      43
11190;A028726;GM0545;2015;     311;     136;     148;      73;      75;      27
11191;A028726;GM0545;2016;     395;     160;     218;     140;      78;      17
11192;A028726;GM0545;2017;     302;     161;     123;      40;      83;      18
11193;A028726;GM0545;2018;     339;     151;     172;      93;      79;      16
11194;A028726;GM0545;2019;;;;;;
11195;A028726;GM0545;2020;;;;;;
11196;A028726;GM0080;2012;    2386;     667;    1561;     576;     985;     158
11197;A028726;GM0080;2013;    2342;     633;    1563;     528;    1035;     146
11198;A028726;GM0080;2014;    2717;     738;    1803;     628;    1175;     176
11199;A028726;GM0080;2015;    2915;     741;    2020;     510;    1510;     154
11200;A028726;GM0080;2016;    2971;     722;    2018;     525;    1493;     231
11201;A028726;GM0080;2017;    2616;     635;    1765;     570;    1195;     216
11202;A028726;GM0080;2018;    2701;     692;    1835;     535;    1300;     174
11203;A028726;GM0080;2019;    2562;     848;    1695;     745;     950;      19
11204;A028726;GM0080;2020;    2736;     857;    1786;     746;    1040;      93
11205;A028726;GM0081;2012;     121;      80;      40;      15;      25;       1
11206;A028726;GM0081;2013;     114;      68;      45;      21;      24;       1
11207;A028726;GM0081;2014;     111;      60;      42;      15;      27;       9
11208;A028726;GM0081;2015;     104;      67;      31;       9;      22;       6
11209;A028726;GM0081;2016;     100;      57;      35;      16;      19;       8
11210;A028726;GM0081;2017;     109;      54;      47;      24;      23;       8
11211;A028726;GM0081;2018;;;;;;
11212;A028726;GM0081;2019;;;;;;
11213;A028726;GM0081;2020;;;;;;
11214;A028726;GM0546;2012;    2828;     954;    1394;     465;     929;     480
11215;A028726;GM0546;2013;    2729;     901;    1504;     542;     962;     324
11216;A028726;GM0546;2014;    2792;     863;    1656;     611;    1045;     273
11217;A028726;GM0546;2015;    2546;     763;    1540;     575;     965;     243
11218;A028726;GM0546;2016;    2845;     855;    1745;     462;    1283;     245
11219;A028726;GM0546;2017;    2426;     728;    1393;     461;     932;     305
11220;A028726;GM0546;2018;    2250;     675;    1328;     421;     907;     247
11221;A028726;GM0546;2019;    2484;     790;    1676;     471;    1205;      18
11222;A028726;GM0546;2020;    2676;     763;    1892;     686;    1206;      21
11223;A028726;GM0547;2012;     456;     217;     220;     108;     112;      19
11224;A028726;GM0547;2013;     407;     205;     187;      70;     117;      15
11225;A028726;GM0547;2014;     346;     197;     130;      37;      93;      19
11226;A028726;GM0547;2015;     347;     201;     134;      43;      91;      12
11227;A028726;GM0547;2016;     372;     171;     137;      51;      86;      64
11228;A028726;GM0547;2017;     320;     160;     150;      47;     103;      10
11229;A028726;GM0547;2018;     276;     134;     131;      48;      83;      11
11230;A028726;GM0547;2019;     286;     149;     136;      40;      96;       1
11231;A028726;GM0547;2020;     297;     152;     141;      37;     104;       4
11232;A028726;GM1916;2012;    2180;    1022;    1149;     317;     832;       9
11233;A028726;GM1916;2013;    1930;     978;     947;     268;     679;       5
11234;A028726;GM1916;2014;    1713;     874;     809;     195;     614;      30
11235;A028726;GM1916;2015;    1693;     898;     742;     193;     549;      53
11236;A028726;GM1916;2016;    1575;     839;     672;     167;     505;      64
11237;A028726;GM1916;2017;    1501;     706;     721;     158;     563;      74
11238;A028726;GM1916;2018;    1453;     721;     654;     157;     497;      78
11239;A028726;GM1916;2019;    1652;     774;     845;     175;     670;      33
11240;A028726;GM1916;2020;    1506;     728;     747;     192;     555;      31
11241;A028726;GM0995;2012;    1532;     503;     485;     223;     262;     544
11242;A028726;GM0995;2013;    1455;     482;     854;     225;     629;     119
11243;A028726;GM0995;2014;    1365;     411;     895;     222;     673;      59
11244;A028726;GM0995;2015;    1229;     363;     810;     217;     593;      56
11245;A028726;GM0995;2016;    1114;     336;     746;     170;     576;      32
11246;A028726;GM0995;2017;    1183;     357;     802;     195;     607;      24
11247;A028726;GM0995;2018;     839;     344;     464;     195;     269;      31
11248;A028726;GM0995;2019;     771;     333;     427;     185;     242;      11
11249;A028726;GM0995;2020;     901;     406;     480;     178;     302;      15
11250;A028726;GM0082;2012;     848;     572;     235;      17;     218;      41
11251;A028726;GM0082;2013;     845;     553;     263;      17;     246;      29
11252;A028726;GM0082;2014;;;;;;
11253;A028726;GM0082;2015;;;;;;
11254;A028726;GM0082;2016;;;;;;
11255;A028726;GM0082;2017;;;;;;
11256;A028726;GM0082;2018;;;;;;
11257;A028726;GM0082;2019;;;;;;
11258;A028726;GM0082;2020;;;;;;
11259;A028726;GM1640;2012;     671;     403;     243;      58;     185;      25
11260;A028726;GM1640;2013;     639;     381;     243;      65;     178;      15
11261;A028726;GM1640;2014;     791;     369;     228;      45;     183;     194
11262;A028726;GM1640;2015;     856;     351;     208;      50;     158;     297
11263;A028726;GM1640;2016;     708;     353;     223;      37;     186;     132
11264;A028726;GM1640;2017;     635;     366;     198;      25;     173;      71
11265;A028726;GM1640;2018;     581;     297;     228;      39;     189;      56
11266;A028726;GM1640;2019;     607;     351;     246;      45;     201;      10
11267;A028726;GM1640;2020;     614;     360;     249;      36;     213;       5
11268;A028726;GM0327;2012;     408;     180;     194;     107;      87;      34
11269;A028726;GM0327;2013;     491;     209;     243;     159;      84;      39
11270;A028726;GM0327;2014;     371;     176;     177;      99;      78;      18
11271;A028726;GM0327;2015;     315;     153;     124;      49;      75;      38
11272;A028726;GM0327;2016;     277;     160;     103;      39;      64;      14
11273;A028726;GM0327;2017;     235;     118;     101;      34;      67;      16
11274;A028726;GM0327;2018;     240;     116;     107;      36;      71;      17
11275;A028726;GM0327;2019;     317;     175;     142;      33;     109;       0
11276;A028726;GM0327;2020;     298;     161;     136;      54;      82;       1
11277;A028726;GM0694;2012;     163;      95;      56;      28;      28;      12
11278;A028726;GM0694;2013;;;;;;
11279;A028726;GM0694;2014;;;;;;
11280;A028726;GM0694;2015;;;;;;
11281;A028726;GM0694;2016;;;;;;
11282;A028726;GM0694;2017;;;;;;
11283;A028726;GM0694;2018;;;;;;
11284;A028726;GM0694;2019;;;;;;
11285;A028726;GM0694;2020;;;;;;
11286;A028726;GM0733;2012;     156;      85;      49;      22;      27;      22
11287;A028726;GM0733;2013;     187;      93;      78;      56;      22;      16
11288;A028726;GM0733;2014;     130;      74;      44;      16;      28;      12
11289;A028726;GM0733;2015;     168;      76;      74;      42;      32;      18
11290;A028726;GM0733;2016;     159;      73;      77;      42;      35;       9
11291;A028726;GM0733;2017;     128;      62;      60;      23;      37;       6
11292;A028726;GM0733;2018;     163;      60;      93;      41;      52;      10
11293;A028726;GM0733;2019;;;;;;
11294;A028726;GM0733;2020;;;;;;
11295;A028726;GM1705;2012;     473;     279;     188;      80;     108;       6
11296;A028726;GM1705;2013;     514;     285;     223;     113;     110;       6
11297;A028726;GM1705;2014;     518;     258;     253;     125;     128;       7
11298;A028726;GM1705;2015;     504;     262;     197;      76;     121;      45
11299;A028726;GM1705;2016;     557;     286;     220;      74;     146;      51
11300;A028726;GM1705;2017;     547;     234;     201;      52;     149;     112
11301;A028726;GM1705;2018;     437;     232;     161;      41;     120;      44
11302;A028726;GM1705;2019;     476;     247;     173;      60;     113;      56
11303;A028726;GM1705;2020;     504;     270;     207;      93;     114;      27
11304;A028726;GM0553;2012;     290;     124;     164;      82;      82;       2
11305;A028726;GM0553;2013;     309;     139;     167;      90;      77;       3
11306;A028726;GM0553;2014;     349;     153;     194;      90;     104;       2
11307;A028726;GM0553;2015;     357;     168;     186;      90;      96;       3
11308;A028726;GM0553;2016;     365;     174;     183;      93;      90;       8
11309;A028726;GM0553;2017;     402;     138;     245;     111;     134;      19
11310;A028726;GM0553;2018;     255;     140;     106;      30;      76;       9
11311;A028726;GM0553;2019;     326;     127;     179;      39;     140;      20
11312;A028726;GM0553;2020;     336;     154;     158;      32;     126;      24
11313;A028726;GM0140;2012;     254;     164;      79;      37;      42;      11
11314;A028726;GM0140;2013;     235;     137;      85;      43;      42;      13
11315;A028726;GM0140;2014;     215;     130;      73;      38;      35;      12
11316;A028726;GM0140;2015;     193;     122;      58;      25;      33;      13
11317;A028726;GM0140;2016;     161;     112;      41;      16;      25;       8
11318;A028726;GM0140;2017;     176;     113;      54;      22;      32;       9
11319;A028726;GM0140;2018;;;;;;
11320;A028726;GM0140;2019;;;;;;
11321;A028726;GM0140;2020;;;;;;
11322;A028726;GM0262;2012;     692;     399;     244;      67;     177;      49
11323;A028726;GM0262;2013;     716;     395;     278;      63;     215;      43
11324;A028726;GM0262;2014;     717;     401;     272;      67;     205;      44
11325;A028726;GM0262;2015;     696;     376;     268;      89;     179;      52
11326;A028726;GM0262;2016;     698;     357;     273;      77;     196;      68
11327;A028726;GM0262;2017;     614;     322;     224;      52;     172;      68
11328;A028726;GM0262;2018;     636;     358;     218;      51;     167;      60
11329;A028726;GM0262;2019;     646;     371;     272;      58;     214;       3
11330;A028726;GM0262;2020;     689;     416;     269;      52;     217;       4
11331;A028726;GM0809;2012;     453;     221;     133;      47;      86;      99
11332;A028726;GM0809;2013;     455;     194;     255;      76;     179;       6
11333;A028726;GM0809;2014;     429;     198;     226;      62;     164;       5
11334;A028726;GM0809;2015;     401;     175;     218;      25;     193;       8
11335;A028726;GM0809;2016;     445;     200;     234;      44;     190;      11
11336;A028726;GM0809;2017;     447;     191;     246;      28;     218;      10
11337;A028726;GM0809;2018;     402;     158;     235;      29;     206;       9
11338;A028726;GM0809;2019;     402;     167;     234;      65;     169;       1
11339;A028726;GM0809;2020;     424;     174;     249;      60;     189;       1
11340;A028726;GM0331;2012;     240;     145;      73;      18;      55;      22
11341;A028726;GM0331;2013;     257;     169;      86;      20;      66;       2
11342;A028726;GM0331;2014;     257;     165;      83;      24;      59;       9
11343;A028726;GM0331;2015;     234;     163;      65;      15;      50;       6
11344;A028726;GM0331;2016;     252;     153;      90;      21;      69;       9
11345;A028726;GM0331;2017;     256;     142;     106;      23;      83;       8
11346;A028726;GM0331;2018;     252;     142;     100;      31;      69;      10
11347;A028726;GM0331;2019;     214;     128;      84;      36;      48;       2
11348;A028726;GM0331;2020;     229;     142;      86;      22;      64;       1
11349;A028726;GM0024;2012;     212;     112;      90;      45;      45;      10
11350;A028726;GM0024;2013;     199;     109;      81;      39;      42;       9
11351;A028726;GM0024;2014;     302;      96;     198;     149;      49;       8
11352;A028726;GM0024;2015;     307;     105;     187;     142;      45;      15
11353;A028726;GM0024;2016;     308;     105;     149;      97;      52;      54
11354;A028726;GM0024;2017;     297;     100;     143;      80;      63;      54
11355;A028726;GM0024;2018;     407;     128;     212;      95;     117;      67
11356;A028726;GM0024;2019;     415;     128;     286;     154;     132;       1
11357;A028726;GM0024;2020;     388;     105;     283;     149;     134;       0
11358;A028726;GM0168;2012;     393;     211;     145;      62;      83;      37
11359;A028726;GM0168;2013;     493;     236;     216;      55;     161;      41
11360;A028726;GM0168;2014;     452;     245;     159;      65;      94;      48
11361;A028726;GM0168;2015;     425;     243;     141;      67;      74;      41
11362;A028726;GM0168;2016;     380;     215;     129;      46;      83;      36
11363;A028726;GM0168;2017;     416;     221;     156;      72;      84;      39
11364;A028726;GM0168;2018;     402;     204;     174;      61;     113;      24
11365;A028726;GM0168;2019;     365;     210;     152;      48;     104;       3
11366;A028726;GM0168;2020;     385;     225;     155;      41;     114;       5
11367;A028726;GM1671;2012;     487;     121;      52;       5;      47;     314
11368;A028726;GM1671;2013;     466;     115;      61;      16;      45;     290
11369;A028726;GM1671;2014;     408;     117;      62;      13;      49;     229
11370;A028726;GM1671;2015;;;;;;
11371;A028726;GM1671;2016;;;;;;
11372;A028726;GM1671;2017;;;;;;
11373;A028726;GM1671;2018;;;;;;
11374;A028726;GM1671;2019;;;;;;
11375;A028726;GM1671;2020;;;;;;
11376;A028726;GM0263;2012;     454;     219;     156;      57;      99;      79
11377;A028726;GM0263;2013;     380;     186;     162;      58;     104;      32
11378;A028726;GM0263;2014;     365;     202;     131;      43;      88;      32
11379;A028726;GM0263;2015;     394;     196;     165;      80;      85;      33
11380;A028726;GM0263;2016;     388;     232;     129;      44;      85;      27
11381;A028726;GM0263;2017;     389;     197;     150;      49;     101;      42
11382;A028726;GM0263;2018;     364;     191;     147;      33;     114;      26
11383;A028726;GM0263;2019;     371;     213;     155;      51;     104;       3
11384;A028726;GM0263;2020;     377;     231;     141;      32;     109;       5
11385;A028726;GM1641;2012;     459;     272;     132;      39;      93;      55
11386;A028726;GM1641;2013;     440;     265;     146;      39;     107;      29
11387;A028726;GM1641;2014;     411;     236;     145;      30;     115;      30
11388;A028726;GM1641;2015;     411;     234;     144;      31;     113;      33
11389;A028726;GM1641;2016;     386;     221;     134;      27;     107;      31
11390;A028726;GM1641;2017;     432;     216;     188;      40;     148;      28
11391;A028726;GM1641;2018;     451;     202;     220;      37;     183;      29
11392;A028726;GM1641;2019;     430;     217;     205;      80;     125;       8
11393;A028726;GM1641;2020;     418;     229;     181;      58;     123;       8
11394;A028726;GM0556;2012;     713;     264;     305;     216;      89;     144
11395;A028726;GM0556;2013;     533;     255;     275;     193;      82;       3
11396;A028726;GM0556;2014;     741;     235;     360;     274;      86;     146
11397;A028726;GM0556;2015;     609;     221;     290;     222;      68;      98
11398;A028726;GM0556;2016;     578;     219;     265;     206;      59;      94
11399;A028726;GM0556;2017;     545;     179;     240;     165;      75;     126
11400;A028726;GM0556;2018;     621;     155;     305;     214;      91;     161
11401;A028726;GM0556;2019;     598;     260;     334;     174;     160;       4
11402;A028726;GM0556;2020;     554;     210;     311;     180;     131;      33
11403;A028726;GM0935;2012;    6292;    1137;    3261;     828;    2433;    1894
11404;A028726;GM0935;2013;    5714;    1099;    3310;     842;    2468;    1305
11405;A028726;GM0935;2014;    5524;    1027;    3191;     847;    2344;    1306
11406;A028726;GM0935;2015;    5032;    1046;    3056;     924;    2132;     930
11407;A028726;GM0935;2016;    4907;    1023;    2860;     765;    2095;    1024
11408;A028726;GM0935;2017;    5290;     965;    3312;     899;    2413;    1013
11409;A028726;GM0935;2018;    5182;     935;    3385;     848;    2537;     862
11410;A028726;GM0935;2019;    5010;    1176;    3653;     995;    2658;     181
11411;A028726;GM0935;2020;    4656;    1057;    3426;     893;    2533;     173
11412;A028726;GM1663;2012;     648;     423;     213;      61;     152;      12
11413;A028726;GM1663;2013;     627;     413;     201;      63;     138;      13
11414;A028726;GM1663;2014;     678;     399;     250;      91;     159;      29
11415;A028726;GM1663;2015;     684;     381;     279;     105;     174;      24
11416;A028726;GM1663;2016;     654;     362;     255;      79;     176;      37
11417;A028726;GM1663;2017;     638;     392;     192;      52;     140;      54
11418;A028726;GM1663;2018;     606;     366;     207;      42;     165;      33
11419;A028726;GM1663;2019;;;;;;
11420;A028726;GM1663;2020;;;;;;
11421;A028726;GM0025;2012;     146;      90;      54;      24;      30;       2
11422;A028726;GM0025;2013;     137;      75;      61;      13;      48;       1
11423;A028726;GM0025;2014;     133;      70;      62;       6;      56;       1
11424;A028726;GM0025;2015;     139;      60;      79;      12;      67;       0
11425;A028726;GM0025;2016;     154;      68;      85;      16;      69;       1
11426;A028726;GM0025;2017;     143;      66;      75;      15;      60;       2
11427;A028726;GM0025;2018;     120;      51;      69;       7;      62;       0
11428;A028726;GM0025;2019;;;;;;
11429;A028726;GM0025;2020;;;;;;
11430;A028726;GM0420;2012;     594;     382;     192;      75;     117;      20
11431;A028726;GM0420;2013;     605;     383;     211;      85;     126;      11
11432;A028726;GM0420;2014;     727;     447;     248;      73;     175;      32
11433;A028726;GM0420;2015;     689;     430;     232;      60;     172;      27
11434;A028726;GM0420;2016;     709;     447;     230;      61;     169;      32
11435;A028726;GM0420;2017;     719;     403;     248;      61;     187;      68
11436;A028726;GM0420;2018;     685;     388;     273;      74;     199;      24
11437;A028726;GM0420;2019;     702;     400;     277;      83;     194;      25
11438;A028726;GM0420;2020;     678;     365;     286;      91;     195;      27
11439;A028726;GM0938;2012;     327;     217;     101;      29;      72;       9
11440;A028726;GM0938;2013;     335;     207;     121;      47;      74;       7
11441;A028726;GM0938;2014;     299;     198;      94;      26;      68;       7
11442;A028726;GM0938;2015;     294;     187;      96;      35;      61;      11
11443;A028726;GM0938;2016;     367;     209;      95;      34;      61;      63
11444;A028726;GM0938;2017;     359;     174;     119;      41;      78;      66
11445;A028726;GM0938;2018;     316;     141;     112;      26;      86;      63
11446;A028726;GM0938;2019;     320;     164;     146;      84;      62;      10
11447;A028726;GM0938;2020;     327;     166;     158;      77;      81;       3
11448;A028726;GM1948;2012;;;;;;
11449;A028726;GM1948;2013;;;;;;
11450;A028726;GM1948;2014;;;;;;
11451;A028726;GM1948;2015;;;;;;
11452;A028726;GM1948;2016;;;;;;
11453;A028726;GM1948;2017;     988;     521;     332;      98;     234;     135
11454;A028726;GM1948;2018;    1084;     489;     428;     118;     310;     167
11455;A028726;GM1948;2019;    1129;     608;     511;     181;     330;      10
11456;A028726;GM1948;2020;    1203;     616;     580;     187;     393;       7
11457;A028726;GM1908;2012;     204;     114;      90;      51;      39;       0
11458;A028726;GM1908;2013;     192;      94;      98;      60;      38;       0
11459;A028726;GM1908;2014;     196;      91;     105;      68;      37;       0
11460;A028726;GM1908;2015;     217;     103;     114;      85;      29;       0
11461;A028726;GM1908;2016;     210;      92;     118;      81;      37;       0
11462;A028726;GM1908;2017;     194;      85;     109;      67;      42;       0
11463;A028726;GM1908;2018;;;;;;
11464;A028726;GM1908;2019;;;;;;
11465;A028726;GM1908;2020;;;;;;
11466;A028726;GM1987;2012;     223;      98;      92;      26;      66;      33
11467;A028726;GM1987;2013;     204;      99;      76;      31;      45;      29
11468;A028726;GM1987;2014;     184;      90;      68;      27;      41;      26
11469;A028726;GM1987;2015;     190;      86;      82;      41;      41;      22
11470;A028726;GM1987;2016;     169;      81;      70;      34;      36;      18
11471;A028726;GM1987;2017;     158;      62;      81;      43;      38;      15
11472;A028726;GM1987;2018;;;;;;
11473;A028726;GM1987;2019;;;;;;
11474;A028726;GM1987;2020;;;;;;
11475;A028726;GM0119;2012;     797;     328;     400;     160;     240;      69
11476;A028726;GM0119;2013;     701;     286;     352;     141;     211;      63
11477;A028726;GM0119;2014;     719;     235;     365;      92;     273;     119
11478;A028726;GM0119;2015;     676;     203;     331;     111;     220;     142
11479;A028726;GM0119;2016;     698;     194;     338;     131;     207;     166
11480;A028726;GM0119;2017;     702;     201;     364;     153;     211;     137
11481;A028726;GM0119;2018;     646;     199;     329;     118;     211;     118
11482;A028726;GM0119;2019;     599;     217;     380;     178;     202;       2
11483;A028726;GM0119;2020;     626;     198;     425;     193;     232;       3
11484;A028726;GM0687;2012;    1263;     466;     753;     339;     414;      44
11485;A028726;GM0687;2013;    1234;     484;     720;     339;     381;      30
11486;A028726;GM0687;2014;    1247;     489;     605;     247;     358;     153
11487;A028726;GM0687;2015;    1169;     496;     565;     218;     347;     108
11488;A028726;GM0687;2016;    1123;     497;     524;     208;     316;     102
11489;A028726;GM0687;2017;    1080;     465;     528;     199;     329;      87
11490;A028726;GM0687;2018;    1129;     493;     574;     199;     375;      62
11491;A028726;GM0687;2019;    1086;     494;     569;     186;     383;      23
11492;A028726;GM0687;2020;    1090;     467;     569;     208;     361;      54
11493;A028726;GM0559;2012;     343;     170;     149;      77;      72;      24
11494;A028726;GM0559;2013;;;;;;
11495;A028726;GM0559;2014;;;;;;
11496;A028726;GM0559;2015;;;;;;
11497;A028726;GM0559;2016;;;;;;
11498;A028726;GM0559;2017;;;;;;
11499;A028726;GM0559;2018;;;;;;
11500;A028726;GM0559;2019;;;;;;
11501;A028726;GM0559;2020;;;;;;
11502;A028726;GM1842;2012;     247;     155;      88;      34;      54;       4
11503;A028726;GM1842;2013;     275;     191;      81;      27;      54;       3
11504;A028726;GM1842;2014;     266;     167;      95;      35;      60;       4
11505;A028726;GM1842;2015;     245;     133;     105;      49;      56;       7
11506;A028726;GM1842;2016;     230;     150;      72;      22;      50;       8
11507;A028726;GM1842;2017;     232;     123;      98;      32;      66;      11
11508;A028726;GM1842;2018;     191;     101;      87;      30;      57;       3
11509;A028726;GM1842;2019;     184;     112;      72;      25;      47;       0
11510;A028726;GM1842;2020;     203;     123;      80;      22;      58;       0
11511;A028726;GM1731;2012;     607;     272;     285;     139;     146;      50
11512;A028726;GM1731;2013;     630;     275;     312;     147;     165;      43
11513;A028726;GM1731;2014;     620;     280;     327;     195;     132;      13
11514;A028726;GM1731;2015;     661;     305;     323;     191;     132;      33
11515;A028726;GM1731;2016;     607;     282;     277;     150;     127;      48
11516;A028726;GM1731;2017;     571;     268;     249;     120;     129;      54
11517;A028726;GM1731;2018;     566;     242;     283;     147;     136;      41
11518;A028726;GM1731;2019;     514;     224;     282;     114;     168;       8
11519;A028726;GM1731;2020;     544;     253;     286;      86;     200;       5
11520;A028726;GM1952;2012;;;;;;
11521;A028726;GM1952;2013;;;;;;
11522;A028726;GM1952;2014;;;;;;
11523;A028726;GM1952;2015;;;;;;
11524;A028726;GM1952;2016;;;;;;
11525;A028726;GM1952;2017;;;;;;
11526;A028726;GM1952;2018;    1126;     320;     670;     281;     389;     136
11527;A028726;GM1952;2019;     956;     385;     532;     216;     316;      39
11528;A028726;GM1952;2020;     955;     379;     533;     235;     298;      43
11529;A028726;GM0815;2012;     192;     104;      47;      16;      31;      41
11530;A028726;GM0815;2013;     202;     120;      51;      12;      39;      31
11531;A028726;GM0815;2014;     203;     109;      49;      10;      39;      45
11532;A028726;GM0815;2015;     184;      97;      45;      17;      28;      42
11533;A028726;GM0815;2016;     142;      91;      34;      12;      22;      17
11534;A028726;GM0815;2017;     140;      90;      38;      12;      26;      12
11535;A028726;GM0815;2018;     139;      82;      44;      15;      29;      13
11536;A028726;GM0815;2019;     148;      90;      58;      24;      34;       0
11537;A028726;GM0815;2020;     155;      85;      67;      27;      40;       3
11538;A028726;GM0265;2012;      83;      46;      35;      22;      13;       2
11539;A028726;GM0265;2013;      80;      41;      37;      25;      12;       2
11540;A028726;GM0265;2014;      93;      47;      44;      35;       9;       2
11541;A028726;GM0265;2015;;;;;;
11542;A028726;GM0265;2016;;;;;;
11543;A028726;GM0265;2017;;;;;;
11544;A028726;GM0265;2018;;;;;;
11545;A028726;GM0265;2019;;;;;;
11546;A028726;GM0265;2020;;;;;;
11547;A028726;GM1709;2012;     792;     339;     342;     213;     129;     111
11548;A028726;GM1709;2013;     716;     325;     379;     178;     201;      12
11549;A028726;GM1709;2014;     652;     288;     352;     126;     226;      12
11550;A028726;GM1709;2015;     586;     290;     280;     103;     177;      16
11551;A028726;GM1709;2016;     594;     269;     311;      84;     227;      14
11552;A028726;GM1709;2017;     642;     243;     385;     101;     284;      14
11553;A028726;GM1709;2018;     511;     212;     287;      83;     204;      12
11554;A028726;GM1709;2019;     512;     255;     253;      86;     167;       4
11555;A028726;GM1709;2020;     505;     280;     217;      72;     145;       8
11556;A028726;GM1978;2012;;;;;;
11557;A028726;GM1978;2013;;;;;;
11558;A028726;GM1978;2014;;;;;;
11559;A028726;GM1978;2015;;;;;;
11560;A028726;GM1978;2016;;;;;;
11561;A028726;GM1978;2017;;;;;;
11562;A028726;GM1978;2018;;;;;;
11563;A028726;GM1978;2019;     668;     385;     267;     120;     147;      16
11564;A028726;GM1978;2020;     667;     401;     245;      89;     156;      21
11565;A028726;GM1927;2012;;;;;;
11566;A028726;GM1927;2013;     465;     267;     165;      69;      96;      33
11567;A028726;GM1927;2014;     475;     252;     186;      88;      98;      37
11568;A028726;GM1927;2015;     499;     279;     181;      67;     114;      39
11569;A028726;GM1927;2016;     492;     256;     190;     107;      83;      46
11570;A028726;GM1927;2017;     479;     269;     163;      76;      87;      47
11571;A028726;GM1927;2018;     483;     255;     181;      81;     100;      47
11572;A028726;GM1927;2019;;;;;;
11573;A028726;GM1927;2020;;;;;;
11574;A028726;GM1955;2012;     768;     369;     341;     215;     126;      58
11575;A028726;GM1955;2013;     744;     369;     336;     208;     128;      39
11576;A028726;GM1955;2014;     697;     379;     268;     157;     111;      50
11577;A028726;GM1955;2015;     610;     341;     261;     126;     135;       8
11578;A028726;GM1955;2016;     543;     302;     234;     108;     126;       7
11579;A028726;GM1955;2017;     513;     271;     239;      91;     148;       3
11580;A028726;GM1955;2018;     465;     246;     216;      73;     143;       3
11581;A028726;GM1955;2019;     433;     249;     178;      75;     103;       6
11582;A028726;GM1955;2020;     499;     261;     224;      88;     136;      14
11583;A028726;GM0335;2012;     225;     115;      93;      25;      68;      17
11584;A028726;GM0335;2013;     228;     114;     100;      35;      65;      14
11585;A028726;GM0335;2014;     216;     112;      82;      15;      67;      22
11586;A028726;GM0335;2015;     192;      93;      82;      21;      61;      17
11587;A028726;GM0335;2016;     198;      96;      85;      22;      63;      17
11588;A028726;GM0335;2017;     241;      95;      98;      30;      68;      48
11589;A028726;GM0335;2018;     240;     109;     101;      21;      80;      30
11590;A028726;GM0335;2019;     182;      87;      94;      35;      59;       1
11591;A028726;GM0335;2020;     202;      99;     101;      33;      68;       2
11592;A028726;GM0944;2012;     229;     110;      80;      26;      54;      39
11593;A028726;GM0944;2013;     222;     114;      73;      15;      58;      35
11594;A028726;GM0944;2014;     225;     126;      68;      11;      57;      31
11595;A028726;GM0944;2015;     210;     115;      59;       7;      52;      36
11596;A028726;GM0944;2016;     193;     107;      52;       8;      44;      34
11597;A028726;GM0944;2017;     193;     110;      53;      10;      43;      30
11598;A028726;GM0944;2018;     204;     100;      70;       8;      62;      34
11599;A028726;GM0944;2019;     143;      91;      51;      10;      41;       1
11600;A028726;GM0944;2020;     145;      91;      54;      10;      44;       0
11601;A028726;GM0424;2012;     110;      57;      49;       8;      41;       4
11602;A028726;GM0424;2013;     117;      60;      53;      10;      43;       4
11603;A028726;GM0424;2014;     157;      61;      94;      18;      76;       2
11604;A028726;GM0424;2015;     126;      55;      68;      12;      56;       3
11605;A028726;GM0424;2016;;;;;;
11606;A028726;GM0424;2017;;;;;;
11607;A028726;GM0424;2018;;;;;;
11608;A028726;GM0424;2019;;;;;;
11609;A028726;GM0424;2020;;;;;;
11610;A028726;GM0425;2012;     414;     232;     156;      33;     123;      26
11611;A028726;GM0425;2013;     407;     246;     145;      29;     116;      16
11612;A028726;GM0425;2014;     430;     231;     181;      33;     148;      18
11613;A028726;GM0425;2015;     442;     218;     181;      41;     140;      43
11614;A028726;GM0425;2016;;;;;;
11615;A028726;GM0425;2017;;;;;;
11616;A028726;GM0425;2018;;;;;;
11617;A028726;GM0425;2019;;;;;;
11618;A028726;GM0425;2020;;;;;;
11619;A028726;GM1740;2012;     515;     238;     257;     113;     144;      20
11620;A028726;GM1740;2013;     380;     173;     197;     120;      77;      10
11621;A028726;GM1740;2014;     303;     180;     115;      38;      77;       8
11622;A028726;GM1740;2015;     325;     176;     139;      72;      67;      10
11623;A028726;GM1740;2016;     295;     181;     102;      40;      62;      12
11624;A028726;GM1740;2017;     281;     169;      99;      32;      67;      13
11625;A028726;GM1740;2018;     263;     167;      91;      31;      60;       5
11626;A028726;GM1740;2019;     291;     207;      77;      30;      47;       7
11627;A028726;GM1740;2020;     306;     203;      95;      43;      52;       8
11628;A028726;GM0643;2012;     301;     118;     175;      74;     101;       8
11629;A028726;GM0643;2013;     265;     134;      95;      32;      63;      36
11630;A028726;GM0643;2014;     289;     141;     138;      48;      90;      10
11631;A028726;GM0643;2015;;;;;;
11632;A028726;GM0643;2016;;;;;;
11633;A028726;GM0643;2017;;;;;;
11634;A028726;GM0643;2018;;;;;;
11635;A028726;GM0643;2019;;;;;;
11636;A028726;GM0643;2020;;;;;;
11637;A028726;GM0946;2012;     263;     165;      89;      29;      60;       9
11638;A028726;GM0946;2013;     245;     152;      84;      24;      60;       9
11639;A028726;GM0946;2014;     244;     144;      78;      24;      54;      22
11640;A028726;GM0946;2015;     235;     147;      67;      17;      50;      21
11641;A028726;GM0946;2016;     235;     145;      76;      23;      53;      14
11642;A028726;GM0946;2017;     231;     150;      67;      17;      50;      14
11643;A028726;GM0946;2018;     221;     121;      82;      14;      68;      18
11644;A028726;GM0946;2019;     242;     140;     100;      25;      75;       2
11645;A028726;GM0946;2020;     272;     157;     111;      24;      87;       4
11646;A028726;GM0304;2012;     241;     134;      59;      27;      32;      48
11647;A028726;GM0304;2013;     210;     129;      54;      19;      35;      27
11648;A028726;GM0304;2014;     218;     132;      60;      14;      46;      26
11649;A028726;GM0304;2015;     200;     121;      61;      19;      42;      18
11650;A028726;GM0304;2016;     244;     113;      67;      23;      44;      64
11651;A028726;GM0304;2017;     232;     104;      67;      12;      55;      61
11652;A028726;GM0304;2018;     226;     100;      70;      17;      53;      56
11653;A028726;GM0304;2019;;;;;;
11654;A028726;GM0304;2020;;;;;;
11655;A028726;GM0356;2012;     690;     326;     310;     157;     153;      54
11656;A028726;GM0356;2013;     784;     336;     378;     164;     214;      70
11657;A028726;GM0356;2014;     819;     344;     390;     210;     180;      85
11658;A028726;GM0356;2015;     904;     353;     432;     233;     199;     119
11659;A028726;GM0356;2016;     860;     336;     338;     178;     160;     186
11660;A028726;GM0356;2017;     783;     265;     329;     145;     184;     189
11661;A028726;GM0356;2018;     887;     327;     364;     149;     215;     196
11662;A028726;GM0356;2019;     706;     283;     413;     169;     244;      10
11663;A028726;GM0356;2020;     701;     302;     386;     138;     248;      13
11664;A028726;GM0569;2012;     414;     255;     135;      43;      92;      24
11665;A028726;GM0569;2013;     367;     231;     117;      51;      66;      19
11666;A028726;GM0569;2014;     412;     244;     155;      57;      98;      13
11667;A028726;GM0569;2015;     462;     240;     200;      73;     127;      22
11668;A028726;GM0569;2016;     376;     255;     100;      28;      72;      21
11669;A028726;GM0569;2017;     413;     244;     155;      69;      86;      14
11670;A028726;GM0569;2018;     399;     221;     158;      33;     125;      20
11671;A028726;GM0569;2019;     300;     186;     112;      23;      89;       2
11672;A028726;GM0569;2020;     356;     221;     132;      38;      94;       3
11673;A028726;GM0571;2012;     116;      52;      34;      17;      17;      30
11674;A028726;GM0571;2013;;;;;;
11675;A028726;GM0571;2014;;;;;;
11676;A028726;GM0571;2015;;;;;;
11677;A028726;GM0571;2016;;;;;;
11678;A028726;GM0571;2017;;;;;;
11679;A028726;GM0571;2018;;;;;;
11680;A028726;GM0571;2019;;;;;;
11681;A028726;GM0571;2020;;;;;;
11682;A028726;GM0267;2012;     562;     324;     220;      52;     168;      18
11683;A028726;GM0267;2013;     592;     278;     305;     124;     181;       9
11684;A028726;GM0267;2014;     474;     239;     221;      75;     146;      14
11685;A028726;GM0267;2015;     411;     213;     182;      55;     127;      16
11686;A028726;GM0267;2016;     471;     252;     206;      61;     145;      13
11687;A028726;GM0267;2017;     396;     166;     195;      63;     132;      35
11688;A028726;GM0267;2018;     496;     209;     253;      80;     173;      34
11689;A028726;GM0267;2019;     477;     217;     254;     106;     148;       6
11690;A028726;GM0267;2020;     491;     226;     257;     103;     154;       8
11691;A028726;GM0268;2012;    3127;     890;    1836;     916;     920;     401
11692;A028726;GM0268;2013;    3363;     937;    1929;     949;     980;     497
11693;A028726;GM0268;2014;    3302;     898;    1832;     939;     893;     572
11694;A028726;GM0268;2015;    3335;     959;    2000;    1066;     934;     376
11695;A028726;GM0268;2016;    3445;     891;    2083;    1134;     949;     471
11696;A028726;GM0268;2017;    3162;     826;    1727;     780;     947;     609
11697;A028726;GM0268;2018;    3039;     785;    1874;     777;    1097;     380
11698;A028726;GM0268;2019;    2853;     851;    1928;     854;    1074;      74
11699;A028726;GM0268;2020;    2680;     838;    1794;     673;    1121;      48
11700;A028726;GM1930;2012;;;;;;
11701;A028726;GM1930;2013;;;;;;
11702;A028726;GM1930;2014;;;;;;
11703;A028726;GM1930;2015;    1373;     572;     791;     424;     367;      10
11704;A028726;GM1930;2016;    1284;     550;     725;     463;     262;       9
11705;A028726;GM1930;2017;    1198;     472;     706;     475;     231;      20
11706;A028726;GM1930;2018;    1051;     399;     632;     387;     245;      20
11707;A028726;GM1930;2019;    1160;     447;     706;     423;     283;       7
11708;A028726;GM1930;2020;    1308;     424;     878;     597;     281;       6
11709;A028726;GM1970;2012;;;;;;
11710;A028726;GM1970;2013;;;;;;
11711;A028726;GM1970;2014;;;;;;
11712;A028726;GM1970;2015;;;;;;
11713;A028726;GM1970;2016;;;;;;
11714;A028726;GM1970;2017;;;;;;
11715;A028726;GM1970;2018;;;;;;
11716;A028726;GM1970;2019;    1040;     545;     459;     218;     241;      36
11717;A028726;GM1970;2020;    1110;     561;     511;     252;     259;      38
11718;A028726;GM1695;2012;     831;     271;     556;      24;     532;       4
11719;A028726;GM1695;2013;     822;     302;     518;      25;     493;       2
11720;A028726;GM1695;2014;     842;     307;     517;      46;     471;      18
11721;A028726;GM1695;2015;     890;     321;     546;      29;     517;      23
11722;A028726;GM1695;2016;     885;     317;     546;      28;     518;      22
11723;A028726;GM1695;2017;     911;     323;     585;      39;     546;       3
11724;A028726;GM1695;2018;     923;     312;     609;      43;     566;       2
11725;A028726;GM1695;2019;     920;     458;     206;      21;     185;     256
11726;A028726;GM1695;2020;     926;     432;     201;      20;     181;     293
11727;A028726;GM1699;2012;    1127;     619;     461;      81;     380;      47
11728;A028726;GM1699;2013;    1128;     692;     410;      78;     332;      26
11729;A028726;GM1699;2014;    1154;     695;     410;      94;     316;      49
11730;A028726;GM1699;2015;    1134;     678;     393;     116;     277;      63
11731;A028726;GM1699;2016;    1043;     632;     344;     106;     238;      67
11732;A028726;GM1699;2017;    1002;     586;     340;      99;     241;      76
11733;A028726;GM1699;2018;     978;     555;     354;      91;     263;      69
11734;A028726;GM1699;2019;    1000;     533;     451;     116;     335;      16
11735;A028726;GM1699;2020;    1013;     495;     472;     151;     321;      46
11736;A028726;GM0171;2012;     654;     363;     259;     115;     144;      32
11737;A028726;GM0171;2013;     701;     355;     282;     130;     152;      64
11738;A028726;GM0171;2014;     843;     375;     456;     169;     287;      12
11739;A028726;GM0171;2015;     942;     343;     507;     189;     318;      92
11740;A028726;GM0171;2016;     978;     324;     546;     223;     323;     108
11741;A028726;GM0171;2017;     882;     294;     490;     144;     346;      98
11742;A028726;GM0171;2018;     927;     304;     514;     137;     377;     109
11743;A028726;GM0171;2019;    1018;     285;     732;     137;     595;       1
11744;A028726;GM0171;2020;    1033;     305;     723;     133;     590;       5
11745;A028726;GM0575;2012;    2319;    1114;     888;      34;     854;     317
11746;A028726;GM0575;2013;    2132;    1016;     943;      22;     921;     173
11747;A028726;GM0575;2014;    1321;     631;     525;      27;     498;     165
11748;A028726;GM0575;2015;    1240;     643;     452;      26;     426;     145
11749;A028726;GM0575;2016;    1236;     640;     419;      15;     404;     177
11750;A028726;GM0575;2017;    1215;     604;     416;      19;     397;     195
11751;A028726;GM0575;2018;    1195;     590;     420;      17;     403;     185
11752;A028726;GM0575;2019;    1555;     762;     719;     173;     546;      74
11753;A028726;GM0575;2020;    1554;     789;     688;     127;     561;      77
11754;A028726;GM0576;2012;     318;     139;     169;      73;      96;      10
11755;A028726;GM0576;2013;     345;     172;     170;      42;     128;       3
11756;A028726;GM0576;2014;     401;     160;     210;      68;     142;      31
11757;A028726;GM0576;2015;     383;     153;     203;      79;     124;      27
11758;A028726;GM0576;2016;     362;     138;     149;      23;     126;      75
11759;A028726;GM0576;2017;     437;     162;     204;      58;     146;      71
11760;A028726;GM0576;2018;     335;     116;     144;      32;     112;      75
11761;A028726;GM0576;2019;;;;;;
11762;A028726;GM0576;2020;;;;;;
11763;A028726;GM0820;2012;     363;     215;     142;      55;      87;       6
11764;A028726;GM0820;2013;     409;     226;     177;      80;      97;       6
11765;A028726;GM0820;2014;     356;     217;     132;      54;      78;       7
11766;A028726;GM0820;2015;     335;     184;     139;      53;      86;      12
11767;A028726;GM0820;2016;     330;     183;     135;      48;      87;      12
11768;A028726;GM0820;2017;     343;     169;     162;      21;     141;      12
11769;A028726;GM0820;2018;     382;     171;     190;      19;     171;      21
11770;A028726;GM0820;2019;     266;     167;      96;      12;      84;       3
11771;A028726;GM0820;2020;     288;     173;     110;      19;      91;       5
11772;A028726;GM0302;2012;     722;     344;     274;      80;     194;     104
11773;A028726;GM0302;2013;     720;     326;     260;      81;     179;     134
11774;A028726;GM0302;2014;     522;     254;     215;      70;     145;      53
11775;A028726;GM0302;2015;     539;     270;     214;      78;     136;      55
11776;A028726;GM0302;2016;     503;     247;     201;      92;     109;      55
11777;A028726;GM0302;2017;     467;     227;     180;      68;     112;      60
11778;A028726;GM0302;2018;     432;     225;     171;      27;     144;      36
11779;A028726;GM0302;2019;     468;     280;     177;      42;     135;      11
11780;A028726;GM0302;2020;     399;     234;     159;      35;     124;       6
11781;A028726;GM0951;2012;     329;     190;     113;      24;      89;      26
11782;A028726;GM0951;2013;     330;     204;     118;      37;      81;       8
11783;A028726;GM0951;2014;     305;     186;     110;      28;      82;       9
11784;A028726;GM0951;2015;     322;     191;     121;      35;      86;      10
11785;A028726;GM0951;2016;     307;     187;     114;      31;      83;       6
11786;A028726;GM0951;2017;     297;     167;     120;      39;      81;      10
11787;A028726;GM0951;2018;     298;     159;     131;      35;      96;       8
11788;A028726;GM0951;2019;;;;;;
11789;A028726;GM0951;2020;;;;;;
11790;A028726;GM0579;2012;     489;     250;     218;      95;     123;      21
11791;A028726;GM0579;2013;     444;     249;     182;      70;     112;      13
11792;A028726;GM0579;2014;     503;     223;     220;      77;     143;      60
11793;A028726;GM0579;2015;     531;     229;     186;      86;     100;     116
11794;A028726;GM0579;2016;     464;     264;     179;      80;      99;      21
11795;A028726;GM0579;2017;     356;     217;     121;      29;      92;      18
11796;A028726;GM0579;2018;     331;     198;     110;      16;      94;      23
11797;A028726;GM0579;2019;     356;     209;     127;      16;     111;      20
11798;A028726;GM0579;2020;     398;     206;     182;      55;     127;      10
11799;A028726;GM0823;2012;     298;     171;     120;      33;      87;       7
11800;A028726;GM0823;2013;     284;     158;     123;      38;      85;       3
11801;A028726;GM0823;2014;     240;     145;      92;      21;      71;       3
11802;A028726;GM0823;2015;     233;     147;      81;      17;      64;       5
11803;A028726;GM0823;2016;     299;     196;      93;      23;      70;      10
11804;A028726;GM0823;2017;     290;     163;      85;      13;      72;      42
11805;A028726;GM0823;2018;     300;     170;      87;      17;      70;      43
11806;A028726;GM0823;2019;     344;     215;     123;      22;     101;       6
11807;A028726;GM0823;2020;     381;     234;     140;      27;     113;       7
11808;A028726;GM0824;2012;     516;     246;     226;      54;     172;      44
11809;A028726;GM0824;2013;     587;     292;     250;      44;     206;      45
11810;A028726;GM0824;2014;     533;     264;     228;      43;     185;      41
11811;A028726;GM0824;2015;     494;     237;     217;      34;     183;      40
11812;A028726;GM0824;2016;     515;     256;     219;      40;     179;      40
11813;A028726;GM0824;2017;     486;     241;     209;      40;     169;      36
11814;A028726;GM0824;2018;     550;     220;     216;      37;     179;     114
11815;A028726;GM0824;2019;     586;     285;     284;      40;     244;      17
11816;A028726;GM0824;2020;     532;     284;     222;      52;     170;      26
11817;A028726;GM1895;2012;     889;     392;     424;     234;     190;      73
11818;A028726;GM1895;2013;     834;     381;     409;     240;     169;      44
11819;A028726;GM1895;2014;     836;     383;     426;     240;     186;      27
11820;A028726;GM1895;2015;     840;     375;     440;     255;     185;      25
11821;A028726;GM1895;2016;     837;     396;     420;     250;     170;      21
11822;A028726;GM1895;2017;     781;     337;     416;     216;     200;      28
11823;A028726;GM1895;2018;     704;     275;     407;     185;     222;      22
11824;A028726;GM1895;2019;     750;     346;     389;     227;     162;      15
11825;A028726;GM1895;2020;     716;     353;     347;     189;     158;      16
11826;A028726;GM0269;2012;     391;     235;     142;      57;      85;      14
11827;A028726;GM0269;2013;     316;     209;      97;      25;      72;      10
11828;A028726;GM0269;2014;     309;     203;      94;      28;      66;      12
11829;A028726;GM0269;2015;     319;     191;     110;      49;      61;      18
11830;A028726;GM0269;2016;     367;     165;      87;      39;      48;     115
11831;A028726;GM0269;2017;     355;     142;     127;      51;      76;      86
11832;A028726;GM0269;2018;     289;     154;     101;      42;      59;      34
11833;A028726;GM0269;2019;     287;     159;     125;      72;      53;       3
11834;A028726;GM0269;2020;     303;     157;     140;      73;      67;       6
11835;A028726;GM0173;2012;     402;     189;     193;      98;      95;      20
11836;A028726;GM0173;2013;     390;     176;     194;     101;      93;      20
11837;A028726;GM0173;2014;     471;     179;     198;      96;     102;      94
11838;A028726;GM0173;2015;     456;     194;     204;     109;      95;      58
11839;A028726;GM0173;2016;     429;     178;     194;      94;     100;      57
11840;A028726;GM0173;2017;     428;     183;     179;      81;      98;      66
11841;A028726;GM0173;2018;     464;     179;     242;     122;     120;      43
11842;A028726;GM0173;2019;     457;     207;     247;     107;     140;       3
11843;A028726;GM0173;2020;     499;     205;     293;     141;     152;       1
11844;A028726;GM1773;2012;     280;     145;     121;      76;      45;      14
11845;A028726;GM1773;2013;     277;     107;     160;     105;      55;      10
11846;A028726;GM1773;2014;     232;     117;     105;      53;      52;      10
11847;A028726;GM1773;2015;     230;     140;      80;      35;      45;      10
11848;A028726;GM1773;2016;     312;     136;      80;      27;      53;      96
11849;A028726;GM1773;2017;     310;     130;     112;      38;      74;      68
11850;A028726;GM1773;2018;     248;     123;     114;      47;      67;      11
11851;A028726;GM1773;2019;     236;     120;     110;      38;      72;       6
11852;A028726;GM1773;2020;     254;     115;     137;      36;     101;       2
11853;A028726;GM0175;2012;    1413;     815;     413;      36;     377;     185
11854;A028726;GM0175;2013;    1403;     795;     438;      27;     411;     170
11855;A028726;GM0175;2014;     480;     187;     199;      38;     161;      94
11856;A028726;GM0175;2015;     433;     201;     199;      37;     162;      33
11857;A028726;GM0175;2016;     445;     185;     233;      33;     200;      27
11858;A028726;GM0175;2017;     410;     177;     198;      25;     173;      35
11859;A028726;GM0175;2018;     404;     168;     212;      23;     189;      24
11860;A028726;GM0175;2019;     398;     200;     190;      30;     160;       8
11861;A028726;GM0175;2020;     397;     188;     203;      35;     168;       6
11862;A028726;GM0881;2012;     327;     160;     106;      14;      92;      61
11863;A028726;GM0881;2013;     313;     163;      94;       9;      85;      56
11864;A028726;GM0881;2014;     293;     155;     105;      13;      92;      33
11865;A028726;GM0881;2015;     286;     161;      91;      11;      80;      34
11866;A028726;GM0881;2016;     290;     158;     100;      13;      87;      32
11867;A028726;GM0881;2017;     272;     146;      97;      11;      86;      29
11868;A028726;GM0881;2018;     253;     127;     106;       8;      98;      20
11869;A028726;GM0881;2019;;;;;;
11870;A028726;GM0881;2020;;;;;;
11871;A028726;GM1586;2012;     462;     256;     160;      39;     121;      46
11872;A028726;GM1586;2013;     469;     283;     150;      41;     109;      36
11873;A028726;GM1586;2014;     443;     252;     164;      44;     120;      27
11874;A028726;GM1586;2015;     450;     264;     166;      54;     112;      20
11875;A028726;GM1586;2016;     419;     232;     172;      60;     112;      15
11876;A028726;GM1586;2017;     412;     228;     167;      58;     109;      17
11877;A028726;GM1586;2018;     384;     203;     169;      61;     108;      12
11878;A028726;GM1586;2019;     358;     201;     155;      51;     104;       2
11879;A028726;GM1586;2020;     353;     191;     155;      37;     118;       7
11880;A028726;GM0826;2012;     723;     362;     265;     121;     144;      96
11881;A028726;GM0826;2013;     710;     326;     307;     142;     165;      77
11882;A028726;GM0826;2014;     778;     338;     337;     140;     197;     103
11883;A028726;GM0826;2015;     873;     342;     354;     147;     207;     177
11884;A028726;GM0826;2016;     927;     324;     408;     213;     195;     195
11885;A028726;GM0826;2017;     840;     268;     379;     179;     200;     193
11886;A028726;GM0826;2018;     777;     244;     344;     137;     207;     189
11887;A028726;GM0826;2019;     814;     340;     451;     228;     223;      23
11888;A028726;GM0826;2020;     768;     287;     462;     247;     215;      19
11889;A028726;GM0580;2012;     201;     113;      62;      31;      31;      26
11890;A028726;GM0580;2013;;;;;;
11891;A028726;GM0580;2014;;;;;;
11892;A028726;GM0580;2015;;;;;;
11893;A028726;GM0580;2016;;;;;;
11894;A028726;GM0580;2017;;;;;;
11895;A028726;GM0580;2018;;;;;;
11896;A028726;GM0580;2019;;;;;;
11897;A028726;GM0580;2020;;;;;;
11898;A028726;GM0085;2012;     451;     215;     207;      70;     137;      29
11899;A028726;GM0085;2013;     417;     200;     191;      80;     111;      26
11900;A028726;GM0085;2014;     413;     195;     194;      89;     105;      24
11901;A028726;GM0085;2015;     388;     212;     157;      78;      79;      19
11902;A028726;GM0085;2016;     387;     215;     159;      70;      89;      13
11903;A028726;GM0085;2017;     380;     190;     178;      90;      88;      12
11904;A028726;GM0085;2018;     385;     197;     170;      70;     100;      18
11905;A028726;GM0085;2019;     407;     186;     217;     115;     102;       4
11906;A028726;GM0085;2020;     345;     178;     161;      77;      84;       6
11907;A028726;GM0431;2012;     194;      93;      28;      12;      16;      73
11908;A028726;GM0431;2013;     240;      91;      28;      15;      13;     121
11909;A028726;GM0431;2014;     126;      87;      27;      13;      14;      12
11910;A028726;GM0431;2015;     129;      78;      37;      22;      15;      14
11911;A028726;GM0431;2016;     117;      73;      29;      15;      14;      15
11912;A028726;GM0431;2017;     104;      60;      30;      20;      10;      14
11913;A028726;GM0431;2018;     107;      58;      35;      22;      13;      14
11914;A028726;GM0431;2019;     121;      66;      55;      12;      43;       0
11915;A028726;GM0431;2020;     138;      76;      62;      33;      29;       0
11916;A028726;GM0432;2012;     132;      76;      48;       6;      42;       8
11917;A028726;GM0432;2013;     110;      78;      30;       2;      28;       2
11918;A028726;GM0432;2014;     154;      80;      35;       2;      33;      39
11919;A028726;GM0432;2015;     155;      86;      25;       2;      23;      44
11920;A028726;GM0432;2016;     178;      92;      40;       4;      36;      46
11921;A028726;GM0432;2017;     160;      80;      29;       2;      27;      51
11922;A028726;GM0432;2018;     145;      75;      24;       4;      20;      46
11923;A028726;GM0432;2019;     144;      79;      64;       7;      57;       1
11924;A028726;GM0432;2020;     151;      84;      67;       1;      66;       0
11925;A028726;GM0086;2012;     608;     281;     317;     189;     128;      10
11926;A028726;GM0086;2013;     485;     272;     207;     152;      55;       6
11927;A028726;GM0086;2014;     476;     265;     190;     116;      74;      21
11928;A028726;GM0086;2015;     443;     246;     156;      92;      64;      41
11929;A028726;GM0086;2016;     476;     235;     114;      57;      57;     127
11930;A028726;GM0086;2017;     506;     212;     160;      83;      77;     134
11931;A028726;GM0086;2018;     524;     209;     168;      79;      89;     147
11932;A028726;GM0086;2019;     424;     215;     208;      98;     110;       1
11933;A028726;GM0086;2020;     409;     220;     186;      58;     128;       3
11934;A028726;GM0828;2012;    1251;     652;     532;     214;     318;      67
11935;A028726;GM0828;2013;    1232;     640;     551;     257;     294;      41
11936;A028726;GM0828;2014;    1266;     634;     473;     200;     273;     159
11937;A028726;GM0828;2015;    1241;     644;     431;     152;     279;     166
11938;A028726;GM0828;2016;    1263;     641;     445;     182;     263;     177
11939;A028726;GM0828;2017;    1220;     589;     455;     145;     310;     176
11940;A028726;GM0828;2018;    1223;     554;     473;     158;     315;     196
11941;A028726;GM0828;2019;    1297;     610;     675;     228;     447;      12
11942;A028726;GM0828;2020;    1265;     625;     595;     247;     348;      45
11943;A028726;GM0584;2012;     287;     143;     138;      67;      71;       6
11944;A028726;GM0584;2013;     261;     136;     121;      71;      50;       4
11945;A028726;GM0584;2014;     244;     133;     104;      57;      47;       7
11946;A028726;GM0584;2015;     285;     153;     119;      65;      54;      13
11947;A028726;GM0584;2016;     325;     163;     129;      63;      66;      33
11948;A028726;GM0584;2017;     348;     171;     160;      99;      61;      17
11949;A028726;GM0584;2018;     277;     123;     129;      54;      75;      25
11950;A028726;GM0584;2019;;;;;;
11951;A028726;GM0584;2020;;;;;;
11952;A028726;GM1509;2012;     830;     331;     398;     218;     180;     101
11953;A028726;GM1509;2013;     861;     323;     451;     259;     192;      87
11954;A028726;GM1509;2014;     866;     309;     470;     239;     231;      87
11955;A028726;GM1509;2015;     726;     318;     338;     184;     154;      70
11956;A028726;GM1509;2016;     528;     284;     195;      56;     139;      49
11957;A028726;GM1509;2017;     487;     266;     180;      48;     132;      41
11958;A028726;GM1509;2018;     511;     256;     223;      75;     148;      32
11959;A028726;GM1509;2019;     541;     297;     242;      79;     163;       2
11960;A028726;GM1509;2020;     527;     308;     214;      77;     137;       5
11961;A028726;GM0437;2012;     203;     104;      91;      41;      50;       8
11962;A028726;GM0437;2013;     243;     104;     127;      80;      47;      12
11963;A028726;GM0437;2014;     185;      77;     102;      44;      58;       6
11964;A028726;GM0437;2015;     187;      98;      76;      36;      40;      13
11965;A028726;GM0437;2016;     197;     103;      81;      26;      55;      13
11966;A028726;GM0437;2017;     178;      86;      79;      25;      54;      13
11967;A028726;GM0437;2018;     213;     112;      86;      22;      64;      15
11968;A028726;GM0437;2019;     235;     106;     126;      48;      78;       3
11969;A028726;GM0437;2020;     327;      96;     227;      41;     186;       4
11970;A028726;GM0644;2012;     163;      94;      58;      17;      41;      11
11971;A028726;GM0644;2013;     162;      92;      68;      20;      48;       2
11972;A028726;GM0644;2014;     139;      90;      47;      21;      26;       2
11973;A028726;GM0644;2015;;;;;;
11974;A028726;GM0644;2016;;;;;;
11975;A028726;GM0644;2017;;;;;;
11976;A028726;GM0644;2018;;;;;;
11977;A028726;GM0644;2019;;;;;;
11978;A028726;GM0644;2020;;;;;;
11979;A028726;GM0589;2012;     171;      95;      73;      41;      32;       3
11980;A028726;GM0589;2013;     185;     110;      71;      43;      28;       4
11981;A028726;GM0589;2014;     186;      99;      74;      43;      31;      13
11982;A028726;GM0589;2015;     206;     114;      81;      54;      27;      11
11983;A028726;GM0589;2016;     207;     109;      79;      43;      36;      19
11984;A028726;GM0589;2017;     193;      98;      65;      37;      28;      30
11985;A028726;GM0589;2018;     209;      90;      56;      17;      39;      63
11986;A028726;GM0589;2019;     229;      92;     134;      87;      47;       3
11987;A028726;GM0589;2020;     216;      79;     134;      86;      48;       3
11988;A028726;GM1734;2012;     601;     327;     252;      94;     158;      22
11989;A028726;GM1734;2013;     533;     278;     237;      84;     153;      18
11990;A028726;GM1734;2014;     536;     248;     270;     102;     168;      18
11991;A028726;GM1734;2015;     516;     249;     223;      64;     159;      44
11992;A028726;GM1734;2016;     555;     262;     244;      52;     192;      49
11993;A028726;GM1734;2017;     538;     230;     246;      52;     194;      62
11994;A028726;GM1734;2018;     500;     238;     214;      51;     163;      48
11995;A028726;GM1734;2019;     513;     275;     230;      68;     162;       8
11996;A028726;GM1734;2020;     562;     298;     253;      72;     181;      11
11997;A028726;GM0590;2012;     475;     265;     199;      72;     127;      11
11998;A028726;GM0590;2013;     442;     232;     206;      83;     123;       4
11999;A028726;GM0590;2014;     399;     206;     188;      93;      95;       5
12000;A028726;GM0590;2015;     401;     178;     154;      70;      84;      69
12001;A028726;GM0590;2016;     411;     204;     148;      72;      76;      59
12002;A028726;GM0590;2017;     409;     204;     162;      68;      94;      43
12003;A028726;GM0590;2018;     408;     162;     210;      84;     126;      36
12004;A028726;GM0590;2019;     386;     156;     224;      81;     143;       6
12005;A028726;GM0590;2020;     455;     199;     251;      97;     154;       5
12006;A028726;GM1894;2012;     623;     338;     161;      43;     118;     124
12007;A028726;GM1894;2013;     653;     332;     201;      54;     147;     120
12008;A028726;GM1894;2014;     696;     307;     214;      47;     167;     175
12009;A028726;GM1894;2015;     743;     303;     205;      59;     146;     235
12010;A028726;GM1894;2016;     543;     283;     181;      56;     125;      79
12011;A028726;GM1894;2017;     603;     279;     251;     105;     146;      73
12012;A028726;GM1894;2018;     616;     271;     287;     115;     172;      58
12013;A028726;GM1894;2019;     640;     350;     288;     140;     148;       2
12014;A028726;GM1894;2020;     583;     351;     231;      80;     151;       1
12015;A028726;GM0765;2012;     275;     118;     129;      61;      68;      28
12016;A028726;GM0765;2013;     275;     108;     140;      74;      66;      27
12017;A028726;GM0765;2014;     275;     119;     130;      56;      74;      26
12018;A028726;GM0765;2015;     302;     118;     148;      95;      53;      36
12019;A028726;GM0765;2016;     295;     108;     151;      43;     108;      36
12020;A028726;GM0765;2017;     310;     105;     177;      55;     122;      28
12021;A028726;GM0765;2018;     275;      94;     164;      43;     121;      17
12022;A028726;GM0765;2019;     256;     105;     147;     113;      34;       4
12023;A028726;GM0765;2020;     262;      97;     163;     124;      39;       2
12024;A028726;GM1926;2012;     733;     379;     293;     122;     171;      61
12025;A028726;GM1926;2013;     783;     387;     321;     127;     194;      75
12026;A028726;GM1926;2014;     646;     342;     260;      99;     161;      44
12027;A028726;GM1926;2015;     609;     337;     201;      69;     132;      71
12028;A028726;GM1926;2016;     611;     365;     206;      63;     143;      40
12029;A028726;GM1926;2017;     550;     327;     191;      54;     137;      32
12030;A028726;GM1926;2018;     512;     265;     221;      60;     161;      26
12031;A028726;GM1926;2019;     517;     283;     232;      54;     178;       2
12032;A028726;GM1926;2020;     535;     310;     224;      66;     158;       1
12033;A028726;GM0439;2012;    1223;     512;     633;     277;     356;      78
12034;A028726;GM0439;2013;     956;     475;     460;     233;     227;      21
12035;A028726;GM0439;2014;     941;     447;     461;     271;     190;      33
12036;A028726;GM0439;2015;     937;     464;     442;     268;     174;      31
12037;A028726;GM0439;2016;     843;     394;     406;     179;     227;      43
12038;A028726;GM0439;2017;     776;     329;     397;     194;     203;      50
12039;A028726;GM0439;2018;     767;     315;     414;     195;     219;      38
12040;A028726;GM0439;2019;    1111;     412;     697;     489;     208;       2
12041;A028726;GM0439;2020;    1058;     436;     618;     328;     290;       4
12042;A028726;GM0273;2012;    1166;     734;     311;      29;     282;     121
12043;A028726;GM0273;2013;     520;     269;     178;      35;     143;      73
12044;A028726;GM0273;2014;     541;     273;     205;      29;     176;      63
12045;A028726;GM0273;2015;     440;     247;     141;      30;     111;      52
12046;A028726;GM0273;2016;     475;     279;     145;      28;     117;      51
12047;A028726;GM0273;2017;     446;     259;     139;      17;     122;      48
12048;A028726;GM0273;2018;     419;     237;     136;      17;     119;      46
12049;A028726;GM0273;2019;     418;     251;     159;      42;     117;       8
12050;A028726;GM0273;2020;     453;     251;     197;      36;     161;       5
12051;A028726;GM0177;2012;     987;     547;     397;     128;     269;      43
12052;A028726;GM0177;2013;    1033;     556;     439;     150;     289;      38
12053;A028726;GM0177;2014;     995;     530;     411;      90;     321;      54
12054;A028726;GM0177;2015;     554;     275;     224;      70;     154;      55
12055;A028726;GM0177;2016;     548;     267;     231;      70;     161;      50
12056;A028726;GM0177;2017;     493;     243;     205;      52;     153;      45
12057;A028726;GM0177;2018;     529;     228;     270;      88;     182;      31
12058;A028726;GM0177;2019;     512;     267;     239;      96;     143;       6
12059;A028726;GM0177;2020;     538;     286;     244;     119;     125;       8
12060;A028726;GM0703;2012;     533;     282;     230;      94;     136;      21
12061;A028726;GM0703;2013;     517;     278;     220;      97;     123;      19
12062;A028726;GM0703;2014;     544;     259;     231;     110;     121;      54
12063;A028726;GM0703;2015;     480;     237;     191;     105;      86;      52
12064;A028726;GM0703;2016;     483;     223;     209;     121;      88;      51
12065;A028726;GM0703;2017;     442;     208;     178;      82;      96;      56
12066;A028726;GM0703;2018;     458;     227;     173;      59;     114;      58
12067;A028726;GM0703;2019;     497;     241;     226;     110;     116;      30
12068;A028726;GM0703;2020;     551;     223;     301;     160;     141;      27
12069;A028726;GM0274;2012;     989;     386;     402;      68;     334;     201
12070;A028726;GM0274;2013;    1058;     365;     545;     130;     415;     148
12071;A028726;GM0274;2014;     979;     368;     461;      74;     387;     150
12072;A028726;GM0274;2015;     920;     368;     407;      77;     330;     145
12073;A028726;GM0274;2016;     849;     340;     432;     114;     318;      77
12074;A028726;GM0274;2017;     778;     295;     408;      93;     315;      75
12075;A028726;GM0274;2018;     773;     276;     420;     128;     292;      77
12076;A028726;GM0274;2019;     824;     335;     467;      88;     379;      22
12077;A028726;GM0274;2020;     785;     322;     417;      79;     338;      46
12078;A028726;GM0339;2012;      96;      42;      43;       0;      43;      11
12079;A028726;GM0339;2013;      79;      36;      38;       0;      38;       5
12080;A028726;GM0339;2014;      85;      39;      43;       0;      43;       3
12081;A028726;GM0339;2015;      70;      34;      35;       0;      35;       1
12082;A028726;GM0339;2016;      74;      48;      26;       0;      26;       0
12083;A028726;GM0339;2017;      83;      43;      40;       0;      40;       0
12084;A028726;GM0339;2018;      95;      48;      47;       0;      47;       0
12085;A028726;GM0339;2019;      75;      46;      29;       0;      29;       0
12086;A028726;GM0339;2020;      95;      43;      52;       0;      52;       0
12087;A028726;GM1667;2012;     227;     144;      75;      24;      51;       8
12088;A028726;GM1667;2013;     235;     145;      86;      32;      54;       4
12089;A028726;GM1667;2014;     254;     136;     111;      36;      75;       7
12090;A028726;GM1667;2015;     246;     133;     103;      19;      84;      10
12091;A028726;GM1667;2016;     229;     129;      66;      22;      44;      34
12092;A028726;GM1667;2017;     259;     144;      66;      14;      52;      49
12093;A028726;GM1667;2018;     236;     122;      63;      15;      48;      51
12094;A028726;GM1667;2019;     241;     138;     102;      19;      83;       1
12095;A028726;GM1667;2020;     234;     135;      97;      13;      84;       2
12096;A028726;GM0275;2012;     991;     429;     502;     157;     345;      60
12097;A028726;GM0275;2013;     993;     450;     486;     193;     293;      57
12098;A028726;GM0275;2014;    1063;     422;     491;     171;     320;     150
12099;A028726;GM0275;2015;    1025;     382;     449;     136;     313;     194
12100;A028726;GM0275;2016;     918;     352;     390;      94;     296;     176
12101;A028726;GM0275;2017;     974;     346;     434;     133;     301;     194
12102;A028726;GM0275;2018;     912;     321;     403;     115;     288;     188
12103;A028726;GM0275;2019;     902;     332;     535;     155;     380;      35
12104;A028726;GM0275;2020;     888;     329;     522;     158;     364;      37
12105;A028726;GM0340;2012;     311;     160;     137;      40;      97;      14
12106;A028726;GM0340;2013;     291;     150;     133;      27;     106;       8
12107;A028726;GM0340;2014;     296;     143;     128;      35;      93;      25
12108;A028726;GM0340;2015;     309;     155;     144;      51;      93;      10
12109;A028726;GM0340;2016;     320;     141;     164;      79;      85;      15
12110;A028726;GM0340;2017;     305;     165;     134;      24;     110;       6
12111;A028726;GM0340;2018;     275;     132;     135;      35;     100;       8
12112;A028726;GM0340;2019;     284;     164;     116;      46;      70;       4
12113;A028726;GM0340;2020;     261;     151;     108;      30;      78;       2
12114;A028726;GM0597;2012;     598;     347;     242;      84;     158;       9
12115;A028726;GM0597;2013;     616;     338;     275;     122;     153;       3
12116;A028726;GM0597;2014;     634;     307;     293;     158;     135;      34
12117;A028726;GM0597;2015;     625;     305;     283;     153;     130;      37
12118;A028726;GM0597;2016;     659;     326;     281;     156;     125;      52
12119;A028726;GM0597;2017;     663;     292;     285;     171;     114;      86
12120;A028726;GM0597;2018;     629;     246;     301;     183;     118;      82
12121;A028726;GM0597;2019;     747;     281;     464;     368;      96;       2
12122;A028726;GM0597;2020;     499;     263;     233;     136;      97;       3
12123;A028726;GM0196;2012;     246;     102;     113;      72;      41;      31
12124;A028726;GM0196;2013;     218;      87;     102;      59;      43;      29
12125;A028726;GM0196;2014;     197;      88;      90;      50;      40;      19
12126;A028726;GM0196;2015;     199;      86;      92;      41;      51;      21
12127;A028726;GM0196;2016;     179;      84;      88;      36;      52;       7
12128;A028726;GM0196;2017;     168;      83;      79;      33;      46;       6
12129;A028726;GM0196;2018;;;;;;
12130;A028726;GM0196;2019;;;;;;
12131;A028726;GM0196;2020;;;;;;
12132;A028726;GM1672;2012;     233;     128;      81;      22;      59;      24
12133;A028726;GM1672;2013;     228;     136;      66;      25;      41;      26
12134;A028726;GM1672;2014;;;;;;
12135;A028726;GM1672;2015;;;;;;
12136;A028726;GM1672;2016;;;;;;
12137;A028726;GM1672;2017;;;;;;
12138;A028726;GM1672;2018;;;;;;
12139;A028726;GM1672;2019;;;;;;
12140;A028726;GM1672;2020;;;;;;
12141;A028726;GM1742;2012;     403;     231;     158;      52;     106;      14
12142;A028726;GM1742;2013;     407;     227;     153;      58;      95;      27
12143;A028726;GM1742;2014;     448;     216;     167;      48;     119;      65
12144;A028726;GM1742;2015;     453;     221;     168;      62;     106;      64
12145;A028726;GM1742;2016;     499;     241;     188;      68;     120;      70
12146;A028726;GM1742;2017;     471;     238;     162;      61;     101;      71
12147;A028726;GM1742;2018;     460;     233;     188;      68;     120;      39
12148;A028726;GM1742;2019;     464;     247;     212;      65;     147;       5
12149;A028726;GM1742;2020;     463;     249;     211;      61;     150;       3
12150;A028726;GM0603;2012;    1332;     656;     638;     208;     430;      38
12151;A028726;GM0603;2013;    1238;     625;     586;     206;     380;      27
12152;A028726;GM0603;2014;    1265;     634;     567;     189;     378;      64
12153;A028726;GM0603;2015;    1175;     589;     531;     181;     350;      55
12154;A028726;GM0603;2016;    1233;     646;     514;     166;     348;      73
12155;A028726;GM0603;2017;    1177;     470;     523;     154;     369;     184
12156;A028726;GM0603;2018;    1156;     463;     577;     148;     429;     116
12157;A028726;GM0603;2019;    1232;     522;     680;     216;     464;      30
12158;A028726;GM0603;2020;    1192;     506;     628;     206;     422;      58
12159;A028726;GM1669;2012;     377;     241;     123;      40;      83;      13
12160;A028726;GM1669;2013;     415;     254;     145;      44;     101;      16
12161;A028726;GM1669;2014;     436;     247;     148;      42;     106;      41
12162;A028726;GM1669;2015;     449;     262;     138;      30;     108;      49
12163;A028726;GM1669;2016;     431;     259;     123;      35;      88;      49
12164;A028726;GM1669;2017;     393;     227;     122;      30;      92;      44
12165;A028726;GM1669;2018;     386;     204;     135;      30;     105;      47
12166;A028726;GM1669;2019;     359;     213;     142;      36;     106;       4
12167;A028726;GM1669;2020;     349;     214;     129;      33;      96;       6
12168;A028726;GM0957;2012;    1731;     552;    1002;     557;     445;     177
12169;A028726;GM0957;2013;    1604;     496;     990;     491;     499;     118
12170;A028726;GM0957;2014;    1454;     471;     838;     350;     488;     145
12171;A028726;GM0957;2015;    1409;     499;     781;     323;     458;     129
12172;A028726;GM0957;2016;    1299;     485;     729;     256;     473;      85
12173;A028726;GM0957;2017;    1095;     381;     645;     215;     430;      69
12174;A028726;GM0957;2018;    1134;     404;     669;     237;     432;      61
12175;A028726;GM0957;2019;    1186;     458;     697;     310;     387;      31
12176;A028726;GM0957;2020;    1217;     438;     735;     337;     398;      44
12177;A028726;GM0736;2012;    1426;     703;     652;     219;     433;      71
12178;A028726;GM0736;2013;    1340;     721;     563;      98;     465;      56
12179;A028726;GM0736;2014;     866;     398;     300;      67;     233;     168
12180;A028726;GM0736;2015;     830;     396;     308;      93;     215;     126
12181;A028726;GM0736;2016;     766;     392;     254;      62;     192;     120
12182;A028726;GM0736;2017;     838;     376;     273;      54;     219;     189
12183;A028726;GM0736;2018;     773;     375;     267;      69;     198;     131
12184;A028726;GM0736;2019;     736;     365;     366;      96;     270;       5
12185;A028726;GM0736;2020;     734;     381;     346;      85;     261;       7
12186;A028726;GM1674;2012;    1431;     622;     730;     350;     380;      79
12187;A028726;GM1674;2013;    1305;     625;     631;     248;     383;      49
12188;A028726;GM1674;2014;    1368;     618;     700;     275;     425;      50
12189;A028726;GM1674;2015;    1503;     680;     765;     350;     415;      58
12190;A028726;GM1674;2016;    1387;     638;     636;     210;     426;     113
12191;A028726;GM1674;2017;    1455;     601;     761;     255;     506;      93
12192;A028726;GM1674;2018;    1358;     516;     748;     232;     516;      94
12193;A028726;GM1674;2019;    1371;     563;     748;     273;     475;      60
12194;A028726;GM1674;2020;    1413;     574;     753;     256;     497;      86
12195;A028726;GM0599;2012;   23079;    5701;   14757;    7569;    7188;    2621
12196;A028726;GM0599;2013;   22166;    5621;   14470;    7120;    7350;    2075
12197;A028726;GM0599;2014;   22053;    5612;   14447;    6475;    7972;    1994
12198;A028726;GM0599;2015;   21844;    5495;   13228;    6014;    7214;    3121
12199;A028726;GM0599;2016;   19314;    4934;   12084;    4959;    7125;    2296
12200;A028726;GM0599;2017;   17816;    4296;   11315;    4402;    6913;    2205
12201;A028726;GM0599;2018;   17758;    3892;   11609;    4731;    6878;    2257
12202;A028726;GM0599;2019;   16919;    4118;   12491;    5409;    7082;     310
12203;A028726;GM0599;2020;   17848;    4164;   13398;    5694;    7704;     286
12204;A028726;GM0277;2012;      22;      16;       5;       0;       5;       1
12205;A028726;GM0277;2013;      27;      21;       6;       0;       6;       0
12206;A028726;GM0277;2014;      19;      16;       3;       0;       3;       0
12207;A028726;GM0277;2015;      19;      11;       7;       0;       7;       1
12208;A028726;GM0277;2016;      26;      19;       6;       2;       4;       1
12209;A028726;GM0277;2017;      20;      16;       4;       0;       4;       0
12210;A028726;GM0277;2018;      28;      18;       5;       2;       3;       5
12211;A028726;GM0277;2019;      25;      22;       3;       0;       3;       0
12212;A028726;GM0277;2020;      17;      13;       4;       0;       4;       0
12213;A028726;GM0840;2012;     334;     215;     109;      62;      47;      10
12214;A028726;GM0840;2013;     336;     227;      94;      46;      48;      15
12215;A028726;GM0840;2014;     375;     237;     117;      68;      49;      21
12216;A028726;GM0840;2015;     334;     240;      84;      42;      42;      10
12217;A028726;GM0840;2016;     324;     223;      86;      53;      33;      15
12218;A028726;GM0840;2017;     327;     201;     105;      57;      48;      21
12219;A028726;GM0840;2018;     300;     190;      94;      52;      42;      16
12220;A028726;GM0840;2019;     294;     198;      96;      63;      33;       0
12221;A028726;GM0840;2020;     300;     205;      93;      41;      52;       2
12222;A028726;GM0441;2012;     212;     122;      83;      25;      58;       7
12223;A028726;GM0441;2013;     814;     382;     323;     100;     223;     109
12224;A028726;GM0441;2014;     793;     399;     353;     126;     227;      41
12225;A028726;GM0441;2015;     767;     426;     297;      89;     208;      44
12226;A028726;GM0441;2016;     736;     425;     255;      70;     185;      56
12227;A028726;GM0441;2017;     682;     395;     239;      60;     179;      48
12228;A028726;GM0441;2018;     664;     357;     251;      64;     187;      56
12229;A028726;GM0441;2019;     708;     420;     270;      95;     175;      18
12230;A028726;GM0441;2020;     684;     381;     268;      85;     183;      35
12231;A028726;GM0458;2012;     112;      60;      44;      17;      27;       8
12232;A028726;GM0458;2013;      94;      47;      41;      15;      26;       6
12233;A028726;GM0458;2014;      87;      43;      38;      12;      26;       6
12234;A028726;GM0458;2015;;;;;;
12235;A028726;GM0458;2016;;;;;;
12236;A028726;GM0458;2017;;;;;;
12237;A028726;GM0458;2018;;;;;;
12238;A028726;GM0458;2019;;;;;;
12239;A028726;GM0458;2020;;;;;;
12240;A028726;GM0279;2012;     181;      80;      85;      20;      65;      16
12241;A028726;GM0279;2013;     166;      82;      74;      19;      55;      10
12242;A028726;GM0279;2014;     139;      68;      62;      13;      49;       9
12243;A028726;GM0279;2015;     127;      65;      53;       9;      44;       9
12244;A028726;GM0279;2016;     120;      57;      58;       9;      49;       5
12245;A028726;GM0279;2017;     140;      72;      64;      16;      48;       4
12246;A028726;GM0279;2018;     191;      66;      78;      20;      58;      47
12247;A028726;GM0279;2019;     147;      78;      64;       5;      59;       5
12248;A028726;GM0279;2020;     144;      83;      59;       9;      50;       2
12249;A028726;GM0606;2012;    2185;     847;    1319;     492;     827;      19
12250;A028726;GM0606;2013;    2191;     808;    1371;     580;     791;      12
12251;A028726;GM0606;2014;    2056;     777;    1213;     440;     773;      66
12252;A028726;GM0606;2015;    2315;     777;    1084;     340;     744;     454
12253;A028726;GM0606;2016;    2279;     782;     992;     323;     669;     505
12254;A028726;GM0606;2017;    2129;     663;     958;     277;     681;     508
12255;A028726;GM0606;2018;    2144;     604;    1049;     362;     687;     491
12256;A028726;GM0606;2019;    2245;     598;    1636;     446;    1190;      11
12257;A028726;GM0606;2020;    2358;     592;    1750;     539;    1211;      16
12258;A028726;GM0088;2012;     175;     101;      49;       7;      42;      25
12259;A028726;GM0088;2013;     167;     101;      56;       1;      55;      10
12260;A028726;GM0088;2014;     148;      81;      51;       3;      48;      16
12261;A028726;GM0088;2015;     143;      79;      51;       7;      44;      13
12262;A028726;GM0088;2016;     145;      75;      57;       3;      54;      13
12263;A028726;GM0088;2017;     143;      70;      59;       7;      52;      14
12264;A028726;GM0088;2018;     142;      72;      61;       4;      57;       9
12265;A028726;GM0088;2019;     139;      71;      63;       4;      59;       5
12266;A028726;GM0088;2020;     139;      75;      59;       3;      56;       5
12267;A028726;GM0844;2012;     256;     148;      89;      40;      49;      19
12268;A028726;GM0844;2013;     351;     173;     166;      74;      92;      12
12269;A028726;GM0844;2014;     290;     181;      95;      37;      58;      14
12270;A028726;GM0844;2015;     250;     144;      79;      23;      56;      27
12271;A028726;GM0844;2016;     257;     146;      81;      29;      52;      30
12272;A028726;GM0844;2017;;;;;;
12273;A028726;GM0844;2018;;;;;;
12274;A028726;GM0844;2019;;;;;;
12275;A028726;GM0844;2020;;;;;;
12276;A028726;GM0962;2012;     440;     173;     166;      17;     149;     101
12277;A028726;GM0962;2013;     405;     167;     149;      20;     129;      89
12278;A028726;GM0962;2014;     418;     172;     153;      28;     125;      93
12279;A028726;GM0962;2015;     395;     151;     150;      30;     120;      94
12280;A028726;GM0962;2016;     377;     156;     127;      14;     113;      94
12281;A028726;GM0962;2017;     347;     133;     122;      23;      99;      92
12282;A028726;GM0962;2018;     360;     120;     149;      51;      98;      91
12283;A028726;GM0962;2019;;;;;;
12284;A028726;GM0962;2020;;;;;;
12285;A028726;GM0608;2012;     203;      84;      95;      42;      53;      24
12286;A028726;GM0608;2013;     204;      87;      99;      47;      52;      18
12287;A028726;GM0608;2014;     263;     112;     134;      46;      88;      17
12288;A028726;GM0608;2015;;;;;;
12289;A028726;GM0608;2016;;;;;;
12290;A028726;GM0608;2017;;;;;;
12291;A028726;GM0608;2018;;;;;;
12292;A028726;GM0608;2019;;;;;;
12293;A028726;GM0608;2020;;;;;;
12294;A028726;GM1676;2012;    2253;    1181;     665;      93;     572;     407
12295;A028726;GM1676;2013;    2306;    1147;     993;     143;     850;     166
12296;A028726;GM1676;2014;    2310;    1143;     970;     164;     806;     197
12297;A028726;GM1676;2015;    2043;    1069;     927;     182;     745;      47
12298;A028726;GM1676;2016;    2077;    1129;     872;     124;     748;      76
12299;A028726;GM1676;2017;    2009;    1109;     848;     120;     728;      52
12300;A028726;GM1676;2018;    1872;    1117;     709;     103;     606;      46
12301;A028726;GM1676;2019;    1884;    1118;     553;     126;     427;     213
12302;A028726;GM1676;2020;    1803;    1001;     542;     109;     433;     260
12303;A028726;GM0965;2012;     495;     271;     197;      88;     109;      27
12304;A028726;GM0965;2013;     428;     237;     174;      64;     110;      17
12305;A028726;GM0965;2014;     426;     236;     173;      66;     107;      17
12306;A028726;GM0965;2015;     413;     236;     159;      54;     105;      18
12307;A028726;GM0965;2016;     446;     227;     200;      52;     148;      19
12308;A028726;GM0965;2017;     476;     217;     240;      81;     159;      19
12309;A028726;GM0965;2018;     451;     189;     243;      61;     182;      19
12310;A028726;GM0965;2019;     511;     216;     290;      69;     221;       5
12311;A028726;GM0965;2020;     349;     121;     224;      51;     173;       4
12312;A028726;GM1702;2012;     208;     119;      54;      10;      44;      35
12313;A028726;GM1702;2013;     180;     103;      63;      18;      45;      14
12314;A028726;GM1702;2014;     269;     104;      85;      19;      66;      80
12315;A028726;GM1702;2015;     242;     105;      69;      13;      56;      68
12316;A028726;GM1702;2016;     250;     111;      66;      13;      53;      73
12317;A028726;GM1702;2017;     183;      99;      53;      13;      40;      31
12318;A028726;GM1702;2018;     216;     100;      73;      13;      60;      43
12319;A028726;GM1702;2019;     203;     112;      91;      12;      79;       0
12320;A028726;GM1702;2020;     208;     118;      88;      10;      78;       2
12321;A028726;GM0845;2012;     563;     277;     151;      39;     112;     135
12322;A028726;GM0845;2013;     575;     261;     213;      70;     143;     101
12323;A028726;GM0845;2014;     510;     264;     168;      29;     139;      78
12324;A028726;GM0845;2015;     545;     207;     179;      45;     134;     159
12325;A028726;GM0845;2016;     538;     229;     151;      35;     116;     158
12326;A028726;GM0845;2017;     562;     236;     169;      37;     132;     157
12327;A028726;GM0845;2018;     617;     288;     186;      50;     136;     143
12328;A028726;GM0845;2019;     559;     281;     198;      40;     158;      80
12329;A028726;GM0845;2020;     536;     258;     196;      37;     159;      82
12330;A028726;GM0846;2012;     341;     169;      80;      21;      59;      92
12331;A028726;GM0846;2013;     293;     164;      94;      30;      64;      35
12332;A028726;GM0846;2014;     285;     161;      87;      21;      66;      37
12333;A028726;GM0846;2015;     267;     146;      86;      29;      57;      35
12334;A028726;GM0846;2016;     240;     140;      59;       7;      52;      41
12335;A028726;GM0846;2017;;;;;;
12336;A028726;GM0846;2018;;;;;;
12337;A028726;GM0846;2019;;;;;;
12338;A028726;GM0846;2020;;;;;;
12339;A028726;GM1883;2012;    2479;     966;    1390;     638;     752;     123
12340;A028726;GM1883;2013;    2493;    1002;    1406;     739;     667;      85
12341;A028726;GM1883;2014;    2791;     974;    1530;     837;     693;     287
12342;A028726;GM1883;2015;    2505;     934;    1362;     664;     698;     209
12343;A028726;GM1883;2016;    2248;     872;    1188;     503;     685;     188
12344;A028726;GM1883;2017;    2252;     855;    1249;     522;     727;     148
12345;A028726;GM1883;2018;    2208;     725;    1343;     584;     759;     140
12346;A028726;GM1883;2019;    2120;     835;    1232;     520;     712;      53
12347;A028726;GM1883;2020;    2277;     807;    1425;     655;     770;      45
12348;A028726;GM0051;2012;     981;     571;     286;      51;     235;     124
12349;A028726;GM0051;2013;     968;     645;     294;      57;     237;      29
12350;A028726;GM0051;2014;;;;;;
12351;A028726;GM0051;2015;;;;;;
12352;A028726;GM0051;2016;;;;;;
12353;A028726;GM0051;2017;;;;;;
12354;A028726;GM0051;2018;;;;;;
12355;A028726;GM0051;2019;;;;;;
12356;A028726;GM0051;2020;;;;;;
12357;A028726;GM0610;2012;     525;     227;     291;     178;     113;       7
12358;A028726;GM0610;2013;     559;     190;     364;     264;     100;       5
12359;A028726;GM0610;2014;     488;     179;     304;     184;     120;       5
12360;A028726;GM0610;2015;     469;     177;     248;     113;     135;      44
12361;A028726;GM0610;2016;     500;     165;     303;     156;     147;      32
12362;A028726;GM0610;2017;     580;     177;     291;     132;     159;     112
12363;A028726;GM0610;2018;     551;     154;     295;     140;     155;     102
12364;A028726;GM0610;2019;     701;     174;     526;     308;     218;       1
12365;A028726;GM0610;2020;     485;     156;     328;     115;     213;       1
12366;A028726;GM0040;2012;     404;     143;     134;      36;      98;     127
12367;A028726;GM0040;2013;     411;     142;     140;      40;     100;     129
12368;A028726;GM0040;2014;     378;     135;     233;      31;     202;      10
12369;A028726;GM0040;2015;     367;     125;     226;      33;     193;      16
12370;A028726;GM0040;2016;     365;     129;     197;      26;     171;      39
12371;A028726;GM0040;2017;     341;     109;     200;      36;     164;      32
12372;A028726;GM0040;2018;;;;;;
12373;A028726;GM0040;2019;;;;;;
12374;A028726;GM0040;2020;;;;;;
12375;A028726;GM1714;2012;    4762;    3011;    1710;     157;    1553;      41
12376;A028726;GM1714;2013;    2650;    1557;    1066;     157;     909;      27
12377;A028726;GM1714;2014;    2940;    1593;    1150;     146;    1004;     197
12378;A028726;GM1714;2015;    2905;    1479;    1293;     156;    1137;     133
12379;A028726;GM1714;2016;    2932;    1445;    1337;     142;    1195;     150
12380;A028726;GM1714;2017;    2857;    1399;    1377;     134;    1243;      81
12381;A028726;GM1714;2018;    2890;    1335;    1480;     175;    1305;      75
12382;A028726;GM1714;2019;    3084;    1691;     851;     195;     656;     542
12383;A028726;GM1714;2020;    3212;    1615;     889;     247;     642;     708
12384;A028726;GM0090;2012;     878;     364;     479;     338;     141;      35
12385;A028726;GM0090;2013;     827;     332;     457;     313;     144;      38
12386;A028726;GM0090;2014;    1001;     342;     482;     342;     140;     177
12387;A028726;GM0090;2015;    1093;     328;     610;     409;     201;     155
12388;A028726;GM0090;2016;    1105;     336;     548;     372;     176;     221
12389;A028726;GM0090;2017;     896;     331;     394;     215;     179;     171
12390;A028726;GM0090;2018;     773;     296;     306;     138;     168;     171
12391;A028726;GM0090;2019;     812;     327;     479;     167;     312;       6
12392;A028726;GM0090;2020;     840;     331;     500;     160;     340;       9
12393;A028726;GM0342;2012;     644;     306;     299;     133;     166;      39
12394;A028726;GM0342;2013;     670;     334;     328;     158;     170;       8
12395;A028726;GM0342;2014;     699;     329;     348;     151;     197;      22
12396;A028726;GM0342;2015;     733;     352;     341;     139;     202;      40
12397;A028726;GM0342;2016;     728;     342;     316;     120;     196;      70
12398;A028726;GM0342;2017;     684;     311;     285;      94;     191;      88
12399;A028726;GM0342;2018;     685;     273;     308;      99;     209;     104
12400;A028726;GM0342;2019;     702;     324;     371;      77;     294;       7
12401;A028726;GM0342;2020;     667;     303;     350;     127;     223;      14
12402;A028726;GM0847;2012;     262;     163;      88;      25;      63;      11
12403;A028726;GM0847;2013;     262;     158;     101;      27;      74;       3
12404;A028726;GM0847;2014;     277;     148;     117;      42;      75;      12
12405;A028726;GM0847;2015;     272;     153;     117;      52;      65;       2
12406;A028726;GM0847;2016;     202;     128;      66;      25;      41;       8
12407;A028726;GM0847;2017;     222;     141;      76;      32;      44;       5
12408;A028726;GM0847;2018;     216;     127;      80;      22;      58;       9
12409;A028726;GM0847;2019;     208;     143;      63;      32;      31;       2
12410;A028726;GM0847;2020;     187;     116;      71;      34;      37;       0
12411;A028726;GM0848;2012;     279;     165;      84;      22;      62;      30
12412;A028726;GM0848;2013;     248;     127;     112;      28;      84;       9
12413;A028726;GM0848;2014;     219;     132;      82;      16;      66;       5
12414;A028726;GM0848;2015;     205;     119;      80;      15;      65;       6
12415;A028726;GM0848;2016;     194;     112;      75;      11;      64;       7
12416;A028726;GM0848;2017;     210;     104;      79;       7;      72;      27
12417;A028726;GM0848;2018;     208;     115;      82;      16;      66;      11
12418;A028726;GM0848;2019;     221;     138;      55;      11;      44;      28
12419;A028726;GM0848;2020;     228;     138;      61;      17;      44;      29
12420;A028726;GM0612;2012;    2351;     756;    1019;     466;     553;     576
12421;A028726;GM0612;2013;     984;     483;     498;     322;     176;       3
12422;A028726;GM0612;2014;    1019;     439;     578;     397;     181;       2
12423;A028726;GM0612;2015;;;;;;
12424;A028726;GM0612;2016;;;;;;
12425;A028726;GM0612;2017;;;;;;
12426;A028726;GM0612;2018;;;;;;
12427;A028726;GM0612;2019;;;;;;
12428;A028726;GM0612;2020;;;;;;
12429;A028726;GM0037;2012;     935;     304;     527;     247;     280;     104
12430;A028726;GM0037;2013;     771;     301;     389;     190;     199;      81
12431;A028726;GM0037;2014;     925;     312;     386;     169;     217;     227
12432;A028726;GM0037;2015;     923;     316;     434;     185;     249;     173
12433;A028726;GM0037;2016;     914;     286;     448;     195;     253;     180
12434;A028726;GM0037;2017;     864;     249;     425;     175;     250;     190
12435;A028726;GM0037;2018;     821;     218;     432;     164;     268;     171
12436;A028726;GM0037;2019;     764;     259;     381;     191;     190;     124
12437;A028726;GM0037;2020;     809;     251;     424;     236;     188;     134
12438;A028726;GM0180;2012;     370;     221;      72;       9;      63;      77
12439;A028726;GM0180;2013;     344;     212;      72;      11;      61;      60
12440;A028726;GM0180;2014;     323;     222;      53;       7;      46;      48
12441;A028726;GM0180;2015;     311;     201;      60;      10;      50;      50
12442;A028726;GM0180;2016;     284;     185;      50;       5;      45;      49
12443;A028726;GM0180;2017;     284;     186;      47;       3;      44;      51
12444;A028726;GM0180;2018;     331;     218;      75;      15;      60;      38
12445;A028726;GM0180;2019;     318;     246;      69;      12;      57;       3
12446;A028726;GM0180;2020;     285;     214;      69;       3;      66;       2
12447;A028726;GM0532;2012;     213;     130;      75;      22;      53;       8
12448;A028726;GM0532;2013;     224;     121;      81;      24;      57;      22
12449;A028726;GM0532;2014;     184;     104;      68;      24;      44;      12
12450;A028726;GM0532;2015;     197;     116;      70;      36;      34;      11
12451;A028726;GM0532;2016;     172;     106;      54;      19;      35;      12
12452;A028726;GM0532;2017;     171;     101;      57;      25;      32;      13
12453;A028726;GM0532;2018;     190;      95;      82;      37;      45;      13
12454;A028726;GM0532;2019;     203;     107;      94;      38;      56;       2
12455;A028726;GM0532;2020;     165;      99;      64;      22;      42;       2
12456;A028726;GM0851;2012;     575;     270;     278;      70;     208;      27
12457;A028726;GM0851;2013;     532;     251;     252;      52;     200;      29
12458;A028726;GM0851;2014;     553;     262;     266;      63;     203;      25
12459;A028726;GM0851;2015;     439;     239;     183;      49;     134;      17
12460;A028726;GM0851;2016;     428;     224;     173;      48;     125;      31
12461;A028726;GM0851;2017;     458;     231;     182;      50;     132;      45
12462;A028726;GM0851;2018;     490;     244;     223;      72;     151;      23
12463;A028726;GM0851;2019;     470;     281;     183;      64;     119;       6
12464;A028726;GM0851;2020;     453;     267;     181;      49;     132;       5
12465;A028726;GM1708;2012;    1406;     722;     598;     243;     355;      86
12466;A028726;GM1708;2013;    1353;     674;     613;     258;     355;      66
12467;A028726;GM1708;2014;    1277;     641;     565;     231;     334;      71
12468;A028726;GM1708;2015;    1294;     680;     540;     202;     338;      74
12469;A028726;GM1708;2016;    1292;     680;     554;     205;     349;      58
12470;A028726;GM1708;2017;    1283;     663;     556;     181;     375;      64
12471;A028726;GM1708;2018;    1228;     591;     584;     221;     363;      53
12472;A028726;GM1708;2019;    1208;     622;     569;     228;     341;      17
12473;A028726;GM1708;2020;    1196;     579;     598;     268;     330;      19
12474;A028726;GM0971;2012;     426;     275;      92;      48;      44;      59
12475;A028726;GM0971;2013;     423;     245;     121;      70;      51;      57
12476;A028726;GM0971;2014;     526;     244;     217;     153;      64;      65
12477;A028726;GM0971;2015;     463;     243;     164;      91;      73;      56
12478;A028726;GM0971;2016;     449;     236;     159;      93;      66;      54
12479;A028726;GM0971;2017;     418;     238;     153;      70;      83;      27
12480;A028726;GM0971;2018;     407;     224;     161;      85;      76;      22
12481;A028726;GM0971;2019;     442;     236;     198;     105;      93;       8
12482;A028726;GM0971;2020;     413;     230;     179;      91;      88;       4
12483;A028726;GM1904;2012;    1562;     634;     680;     135;     545;     248
12484;A028726;GM1904;2013;    1463;     643;     603;      60;     543;     217
12485;A028726;GM1904;2014;    1534;     688;     603;      77;     526;     243
12486;A028726;GM1904;2015;    1470;     702;     561;      71;     490;     207
12487;A028726;GM1904;2016;    1450;     706;     581;     103;     478;     163
12488;A028726;GM1904;2017;    1402;     605;     633;     123;     510;     164
12489;A028726;GM1904;2018;    1454;     615;     680;     157;     523;     159
12490;A028726;GM1904;2019;    1530;     681;     806;     155;     651;      43
12491;A028726;GM1904;2020;    1453;     637;     787;     145;     642;      29
12492;A028726;GM0617;2012;     174;      82;      79;      49;      30;      13
12493;A028726;GM0617;2013;     161;      73;      84;      61;      23;       4
12494;A028726;GM0617;2014;     170;      84;      81;      58;      23;       5
12495;A028726;GM0617;2015;     154;      91;      59;      41;      18;       4
12496;A028726;GM0617;2016;     140;      81;      55;      40;      15;       4
12497;A028726;GM0617;2017;     133;      77;      53;      36;      17;       3
12498;A028726;GM0617;2018;     143;      73;      68;      40;      28;       2
12499;A028726;GM0617;2019;;;;;;
12500;A028726;GM0617;2020;;;;;;
12501;A028726;GM1900;2012;    2784;    1638;    1002;     302;     700;     144
12502;A028726;GM1900;2013;    2876;    1572;    1160;     415;     745;     144
12503;A028726;GM1900;2014;    2653;    1378;    1107;     358;     749;     168
12504;A028726;GM1900;2015;    2521;    1344;     936;     286;     650;     241
12505;A028726;GM1900;2016;    2435;    1249;     981;     336;     645;     205
12506;A028726;GM1900;2017;    2335;    1207;     936;     279;     657;     192
12507;A028726;GM1900;2018;    2376;    1190;     990;     280;     710;     196
12508;A028726;GM1900;2019;    2310;    1306;     919;     321;     598;      85
12509;A028726;GM1900;2020;    2323;    1234;     997;     382;     615;      92
12510;A028726;GM0715;2012;    1797;    1043;     710;     285;     425;      44
12511;A028726;GM0715;2013;    1783;    1000;     770;     272;     498;      13
12512;A028726;GM0715;2014;    1826;    1015;     788;     289;     499;      23
12513;A028726;GM0715;2015;    1760;     964;     767;     249;     518;      29
12514;A028726;GM0715;2016;    1813;     938;     754;     261;     493;     121
12515;A028726;GM0715;2017;    1761;     913;     743;     236;     507;     105
12516;A028726;GM0715;2018;    1793;     788;     875;     277;     598;     130
12517;A028726;GM0715;2019;    1812;     907;     799;     243;     556;     106
12518;A028726;GM0715;2020;    1837;     862;     816;     255;     561;     159
12519;A028726;GM0093;2012;     266;     140;      52;       4;      48;      74
12520;A028726;GM0093;2013;     296;     155;      76;       9;      67;      65
12521;A028726;GM0093;2014;     292;     153;      81;      10;      71;      58
12522;A028726;GM0093;2015;     278;     147;      90;      16;      74;      41
12523;A028726;GM0093;2016;     270;     145;      95;       8;      87;      30
12524;A028726;GM0093;2017;     283;     151;     101;       8;      93;      31
12525;A028726;GM0093;2018;     248;     121;      96;      13;      83;      31
12526;A028726;GM0093;2019;     233;     160;      70;       4;      66;       3
12527;A028726;GM0093;2020;     231;     155;      76;       6;      70;       0
12528;A028726;GM0448;2012;     460;     258;     170;      54;     116;      32
12529;A028726;GM0448;2013;     454;     248;     177;      54;     123;      29
12530;A028726;GM0448;2014;     489;     271;     180;      55;     125;      38
12531;A028726;GM0448;2015;     477;     270;     169;      57;     112;      38
12532;A028726;GM0448;2016;     472;     265;     175;      70;     105;      32
12533;A028726;GM0448;2017;     500;     263;     190;      69;     121;      47
12534;A028726;GM0448;2018;     467;     236;     181;      57;     124;      50
12535;A028726;GM0448;2019;     467;     263;     189;      52;     137;      15
12536;A028726;GM0448;2020;     460;     268;     170;      50;     120;      22
12537;A028726;GM1525;2012;     584;     253;     293;     141;     152;      38
12538;A028726;GM1525;2013;     546;     256;     251;      90;     161;      39
12539;A028726;GM1525;2014;     650;     260;     307;      96;     211;      83
12540;A028726;GM1525;2015;     613;     257;     260;      79;     181;      96
12541;A028726;GM1525;2016;     549;     251;     210;      72;     138;      88
12542;A028726;GM1525;2017;     556;     203;     252;     102;     150;     101
12543;A028726;GM1525;2018;     533;     188;     241;      93;     148;     104
12544;A028726;GM1525;2019;     503;     191;     255;      98;     157;      57
12545;A028726;GM1525;2020;     579;     234;     298;     104;     194;      47
12546;A028726;GM0716;2012;     565;     314;     212;      97;     115;      39
12547;A028726;GM0716;2013;     583;     330;     237;     132;     105;      16
12548;A028726;GM0716;2014;     579;     328;     217;     126;      91;      34
12549;A028726;GM0716;2015;     547;     308;     203;     103;     100;      36
12550;A028726;GM0716;2016;     563;     355;     165;      65;     100;      43
12551;A028726;GM0716;2017;     566;     343;     188;      74;     114;      35
12552;A028726;GM0716;2018;     546;     323;     192;      77;     115;      31
12553;A028726;GM0716;2019;     538;     321;     200;      90;     110;      17
12554;A028726;GM0716;2020;     584;     339;     216;     104;     112;      29
12555;A028726;GM0281;2012;     827;     309;     347;     198;     149;     171
12556;A028726;GM0281;2013;     689;     249;     327;     180;     147;     113
12557;A028726;GM0281;2014;     643;     232;     326;     178;     148;      85
12558;A028726;GM0281;2015;     767;     241;     353;     212;     141;     173
12559;A028726;GM0281;2016;     681;     212;     329;     157;     172;     140
12560;A028726;GM0281;2017;     681;     198;     357;     164;     193;     126
12561;A028726;GM0281;2018;     595;     177;     305;     113;     192;     113
12562;A028726;GM0281;2019;     583;     204;     368;     162;     206;      11
12563;A028726;GM0281;2020;     544;     219;     303;     117;     186;      22
12564;A028726;GM0855;2012;    3316;    1291;    1977;     900;    1077;      48
12565;A028726;GM0855;2013;    3022;    1152;    1837;     868;     969;      33
12566;A028726;GM0855;2014;    4217;    1095;    2520;    1085;    1435;     602
12567;A028726;GM0855;2015;    4245;    1102;    2654;    1211;    1443;     489
12568;A028726;GM0855;2016;    3719;    1059;    2199;     685;    1514;     461
12569;A028726;GM0855;2017;    3306;     949;    2031;     570;    1461;     326
12570;A028726;GM0855;2018;    3312;     875;    2124;     637;    1487;     313
12571;A028726;GM0855;2019;    3126;     953;    2102;     735;    1367;      71
12572;A028726;GM0855;2020;    3110;     967;    2071;     722;    1349;      72
12573;A028726;GM0183;2012;     382;     231;     108;      11;      97;      43
12574;A028726;GM0183;2013;     429;     266;     119;      16;     103;      44
12575;A028726;GM0183;2014;     414;     242;     112;      14;      98;      60
12576;A028726;GM0183;2015;     442;     245;     131;      18;     113;      66
12577;A028726;GM0183;2016;     450;     239;     143;      20;     123;      68
12578;A028726;GM0183;2017;     470;     250;     125;      15;     110;      95
12579;A028726;GM0183;2018;     522;     252;     126;      15;     111;     144
12580;A028726;GM0183;2019;     557;     290;     261;      22;     239;       6
12581;A028726;GM0183;2020;     546;     287;     248;      22;     226;      11
12582;A028726;GM1700;2012;     814;     405;     285;      93;     192;     124
12583;A028726;GM1700;2013;     723;     328;     284;     102;     182;     111
12584;A028726;GM1700;2014;     705;     324;     237;      72;     165;     144
12585;A028726;GM1700;2015;     681;     327;     224;      61;     163;     130
12586;A028726;GM1700;2016;     648;     300;     210;      54;     156;     138
12587;A028726;GM1700;2017;     673;     317;     217;      56;     161;     139
12588;A028726;GM1700;2018;     626;     297;     199;      56;     143;     130
12589;A028726;GM1700;2019;     625;     341;     272;      97;     175;      12
12590;A028726;GM1700;2020;     666;     362;     278;      97;     181;      26
12591;A028726;GM1730;2012;    1005;     427;     157;      39;     118;     421
12592;A028726;GM1730;2013;     775;     335;     198;      71;     127;     242
12593;A028726;GM1730;2014;     705;     330;     293;      55;     238;      82
12594;A028726;GM1730;2015;     540;     326;     138;      31;     107;      76
12595;A028726;GM1730;2016;     549;     323;     154;      42;     112;      72
12596;A028726;GM1730;2017;     522;     295;     148;      51;      97;      79
12597;A028726;GM1730;2018;     495;     264;     152;      40;     112;      79
12598;A028726;GM1730;2019;     532;     345;     176;      44;     132;      11
12599;A028726;GM1730;2020;     489;     296;     179;      36;     143;      14
12600;A028726;GM0737;2012;     953;     512;     212;      51;     161;     229
12601;A028726;GM0737;2013;     405;     250;     150;      76;      74;       5
12602;A028726;GM0737;2014;     464;     252;     181;      88;      93;      31
12603;A028726;GM0737;2015;     462;     227;     140;      49;      91;      95
12604;A028726;GM0737;2016;     462;     218;     141;      54;      87;     103
12605;A028726;GM0737;2017;     478;     210;     150;      69;      81;     118
12606;A028726;GM0737;2018;     502;     217;     163;      75;      88;     122
12607;A028726;GM0737;2019;     611;     235;     375;     131;     244;       1
12608;A028726;GM0737;2020;     509;     185;     321;      89;     232;       3
12609;A028726;GM0282;2012;     153;      91;      60;      14;      46;       2
12610;A028726;GM0282;2013;     189;     115;      73;      17;      56;       1
12611;A028726;GM0282;2014;     214;     100;      72;      13;      59;      42
12612;A028726;GM0282;2015;;;;;;
12613;A028726;GM0282;2016;;;;;;
12614;A028726;GM0282;2017;;;;;;
12615;A028726;GM0282;2018;;;;;;
12616;A028726;GM0282;2019;;;;;;
12617;A028726;GM0282;2020;;;;;;
12618;A028726;GM0856;2012;     631;     319;     256;      89;     167;      56
12619;A028726;GM0856;2013;     604;     310;     243;      68;     175;      51
12620;A028726;GM0856;2014;     604;     321;     236;      65;     171;      47
12621;A028726;GM0856;2015;     583;     298;     228;      59;     169;      57
12622;A028726;GM0856;2016;     535;     288;     183;      61;     122;      64
12623;A028726;GM0856;2017;     526;     253;     213;      67;     146;      60
12624;A028726;GM0856;2018;     487;     225;     198;      72;     126;      64
12625;A028726;GM0856;2019;     505;     265;     238;      93;     145;       2
12626;A028726;GM0856;2020;     548;     268;     279;     120;     159;       1
12627;A028726;GM0450;2012;     176;     113;      48;      16;      32;      15
12628;A028726;GM0450;2013;     194;     110;      70;      34;      36;      14
12629;A028726;GM0450;2014;     155;      99;      42;      18;      24;      14
12630;A028726;GM0450;2015;     150;      89;      45;      18;      27;      16
12631;A028726;GM0450;2016;     136;      83;      39;      14;      25;      14
12632;A028726;GM0450;2017;     171;      81;      43;      14;      29;      47
12633;A028726;GM0450;2018;     132;      66;      33;      11;      22;      33
12634;A028726;GM0450;2019;     155;      92;      62;      14;      48;       1
12635;A028726;GM0450;2020;     147;      88;      59;      13;      46;       0
12636;A028726;GM0451;2012;     485;     263;     208;      94;     114;      14
12637;A028726;GM0451;2013;     533;     298;     221;      96;     125;      14
12638;A028726;GM0451;2014;     628;     267;     351;     130;     221;      10
12639;A028726;GM0451;2015;     499;     217;     271;      96;     175;      11
12640;A028726;GM0451;2016;     460;     228;     220;     105;     115;      12
12641;A028726;GM0451;2017;     433;     197;     224;      88;     136;      12
12642;A028726;GM0451;2018;     522;     152;     358;     216;     142;      12
12643;A028726;GM0451;2019;     480;     175;     303;     182;     121;       2
12644;A028726;GM0451;2020;     466;     235;     231;     110;     121;       0
12645;A028726;GM0184;2012;     233;     172;      50;       7;      43;      11
12646;A028726;GM0184;2013;     253;     166;      59;       6;      53;      28
12647;A028726;GM0184;2014;     336;     233;      76;      13;      63;      27
12648;A028726;GM0184;2015;     269;     180;      65;      25;      40;      24
12649;A028726;GM0184;2016;     264;     197;      46;      10;      36;      21
12650;A028726;GM0184;2017;     280;     191;      63;      23;      40;      26
12651;A028726;GM0184;2018;     255;     189;      45;      10;      35;      21
12652;A028726;GM0184;2019;     253;     193;      51;      11;      40;       9
12653;A028726;GM0184;2020;     329;     255;      65;      15;      50;       9
12654;A028726;GM0344;2012;    8927;    2655;    4511;    1656;    2855;    1761
12655;A028726;GM0344;2013;    8662;    2490;    4833;    1731;    3102;    1339
12656;A028726;GM0344;2014;    7606;    2150;    4593;    1691;    2902;     863
12657;A028726;GM0344;2015;    7107;    1993;    4045;    1475;    2570;    1069
12658;A028726;GM0344;2016;    7211;    1924;    4212;    1475;    2737;    1075
12659;A028726;GM0344;2017;    7939;    1745;    5161;    2088;    3073;    1033
12660;A028726;GM0344;2018;    7005;    1824;    4207;    1552;    2655;     974
12661;A028726;GM0344;2019;    7204;    2353;    4689;    1433;    3256;     162
12662;A028726;GM0344;2020;    6983;    2180;    4652;    1633;    3019;     151
12663;A028726;GM1581;2012;    1992;     559;     645;     209;     436;     788
12664;A028726;GM1581;2013;    1965;     564;     794;     197;     597;     607
12665;A028726;GM1581;2014;    1983;     567;     740;     181;     559;     676
12666;A028726;GM1581;2015;    1535;     554;     634;     191;     443;     347
12667;A028726;GM1581;2016;    1496;     495;     669;     207;     462;     332
12668;A028726;GM1581;2017;    1522;     439;     708;     216;     492;     375
12669;A028726;GM1581;2018;    1483;     401;     697;     213;     484;     385
12670;A028726;GM1581;2019;    1391;     462;     841;     281;     560;      88
12671;A028726;GM1581;2020;    1381;     489;     861;     257;     604;      31
12672;A028726;GM0981;2012;     628;     227;     373;      49;     324;      28
12673;A028726;GM0981;2013;     588;     206;     340;      50;     290;      42
12674;A028726;GM0981;2014;     591;     211;     351;      84;     267;      29
12675;A028726;GM0981;2015;     574;     218;     335;      54;     281;      21
12676;A028726;GM0981;2016;     579;     215;     345;      60;     285;      19
12677;A028726;GM0981;2017;     754;     208;     527;     118;     409;      19
12678;A028726;GM0981;2018;     555;     192;     346;      43;     303;      17
12679;A028726;GM0981;2019;     510;     215;     261;      36;     225;      34
12680;A028726;GM0981;2020;     507;     195;     268;      33;     235;      44
12681;A028726;GM0994;2012;     561;     231;     246;      43;     203;      84
12682;A028726;GM0994;2013;     569;     241;     263;      59;     204;      65
12683;A028726;GM0994;2014;     611;     263;     291;      49;     242;      57
12684;A028726;GM0994;2015;     631;     270;     291;      43;     248;      70
12685;A028726;GM0994;2016;     619;     264;     281;      53;     228;      74
12686;A028726;GM0994;2017;     600;     261;     291;      50;     241;      48
12687;A028726;GM0994;2018;     600;     232;     309;      52;     257;      59
12688;A028726;GM0994;2019;     583;     274;     299;      40;     259;      10
12689;A028726;GM0994;2020;     568;     252;     304;      45;     259;      12
12690;A028726;GM0858;2012;     937;     353;     541;     358;     183;      43
12691;A028726;GM0858;2013;     495;     259;     201;      69;     132;      35
12692;A028726;GM0858;2014;     593;     256;     309;     148;     161;      28
12693;A028726;GM0858;2015;     533;     280;     215;      84;     131;      38
12694;A028726;GM0858;2016;     607;     234;     316;     203;     113;      57
12695;A028726;GM0858;2017;     614;     255;     285;     165;     120;      74
12696;A028726;GM0858;2018;     590;     214;     313;     102;     211;      63
12697;A028726;GM0858;2019;     531;     227;     300;     125;     175;       4
12698;A028726;GM0858;2020;     552;     249;     297;     113;     184;       6
12699;A028726;GM0047;2012;     475;     236;     210;      91;     119;      29
12700;A028726;GM0047;2013;     479;     219;     244;     108;     136;      16
12701;A028726;GM0047;2014;     542;     231;     286;     134;     152;      25
12702;A028726;GM0047;2015;     492;     223;     245;     102;     143;      24
12703;A028726;GM0047;2016;     479;     223;     236;      94;     142;      20
12704;A028726;GM0047;2017;     468;     201;     235;      91;     144;      32
12705;A028726;GM0047;2018;     439;     179;     232;     110;     122;      28
12706;A028726;GM0047;2019;     411;     182;     225;     114;     111;       4
12707;A028726;GM0047;2020;     363;     151;     207;     102;     105;       5
12708;A028726;GM0345;2012;     689;     389;     288;     134;     154;      12
12709;A028726;GM0345;2013;     697;     345;     347;     197;     150;       5
12710;A028726;GM0345;2014;     684;     338;     336;     177;     159;      10
12711;A028726;GM0345;2015;     692;     307;     381;     205;     176;       4
12712;A028726;GM0345;2016;     705;     345;     356;     162;     194;       4
12713;A028726;GM0345;2017;     706;     269;     397;     149;     248;      40
12714;A028726;GM0345;2018;     687;     265;     402;     129;     273;      20
12715;A028726;GM0345;2019;     660;     275;     384;     140;     244;       1
12716;A028726;GM0345;2020;     668;     283;     384;     134;     250;       1
12717;A028726;GM0717;2012;    1644;     989;     473;      23;     450;     182
12718;A028726;GM0717;2013;    1713;    1002;     541;      43;     498;     170
12719;A028726;GM0717;2014;    1716;     966;     569;      28;     541;     181
12720;A028726;GM0717;2015;    1669;     994;     510;      16;     494;     165
12721;A028726;GM0717;2016;    1697;    1077;     447;      24;     423;     173
12722;A028726;GM0717;2017;    1774;    1091;     507;      58;     449;     176
12723;A028726;GM0717;2018;    1763;    1079;     514;      58;     456;     170
12724;A028726;GM0717;2019;    1775;    1205;     477;      66;     411;      93
12725;A028726;GM0717;2020;    1734;    1126;     476;      73;     403;     132
12726;A028726;GM0860;2012;     739;     342;     322;     153;     169;      75
12727;A028726;GM0860;2013;     694;     339;     303;      94;     209;      52
12728;A028726;GM0860;2014;     682;     313;     320;     130;     190;      49
12729;A028726;GM0860;2015;     600;     321;     221;      69;     152;      58
12730;A028726;GM0860;2016;     561;     309;     188;      49;     139;      64
12731;A028726;GM0860;2017;;;;;;
12732;A028726;GM0860;2018;;;;;;
12733;A028726;GM0860;2019;;;;;;
12734;A028726;GM0860;2020;;;;;;
12735;A028726;GM0861;2012;     725;     368;     287;     122;     165;      70
12736;A028726;GM0861;2013;     654;     329;     257;     101;     156;      68
12737;A028726;GM0861;2014;     645;     290;     287;     136;     151;      68
12738;A028726;GM0861;2015;     596;     308;     222;      76;     146;      66
12739;A028726;GM0861;2016;     579;     313;     208;      63;     145;      58
12740;A028726;GM0861;2017;     556;     294;     209;      70;     139;      53
12741;A028726;GM0861;2018;     547;     254;     242;     106;     136;      51
12742;A028726;GM0861;2019;     551;     308;     232;      92;     140;      11
12743;A028726;GM0861;2020;     554;     304;     242;      92;     150;       8
12744;A028726;GM0453;2012;    1132;     506;     504;     248;     256;     122
12745;A028726;GM0453;2013;    1126;     516;     493;     294;     199;     117
12746;A028726;GM0453;2014;    1663;     508;    1058;     251;     807;      97
12747;A028726;GM0453;2015;    1550;     477;     987;     304;     683;      86
12748;A028726;GM0453;2016;    1470;     415;     962;     194;     768;      93
12749;A028726;GM0453;2017;    1243;     388;     712;     325;     387;     143
12750;A028726;GM0453;2018;    1034;     380;     588;     239;     349;      66
12751;A028726;GM0453;2019;     937;     391;     520;     258;     262;      26
12752;A028726;GM0453;2020;    1014;     434;     557;     270;     287;      23
12753;A028726;GM0983;2012;    2970;     925;    1873;     865;    1008;     172
12754;A028726;GM0983;2013;    2711;     983;    1569;     606;     963;     159
12755;A028726;GM0983;2014;    2481;     889;    1446;     544;     902;     146
12756;A028726;GM0983;2015;    2291;     872;    1276;     448;     828;     143
12757;A028726;GM0983;2016;    2159;     811;    1193;     372;     821;     155
12758;A028726;GM0983;2017;    2036;     712;    1184;     365;     819;     140
12759;A028726;GM0983;2018;    1754;     601;    1044;     238;     806;     109
12760;A028726;GM0983;2019;    1894;     759;    1113;     346;     767;      22
12761;A028726;GM0983;2020;    1808;     723;    1049;     259;     790;      36
12762;A028726;GM0984;2012;     912;     372;     424;      79;     345;     116
12763;A028726;GM0984;2013;    1000;     376;     571;     126;     445;      53
12764;A028726;GM0984;2014;     900;     346;     512;     126;     386;      42
12765;A028726;GM0984;2015;     847;     319;     475;     107;     368;      53
12766;A028726;GM0984;2016;     791;     322;     426;      81;     345;      43
12767;A028726;GM0984;2017;     829;     317;     476;     146;     330;      36
12768;A028726;GM0984;2018;     795;     306;     451;      67;     384;      38
12769;A028726;GM0984;2019;     799;     313;     453;      75;     378;      33
12770;A028726;GM0984;2020;     751;     278;     430;      57;     373;      43
12771;A028726;GM0620;2012;     189;     115;      73;      29;      44;       1
12772;A028726;GM0620;2013;     207;     113;      92;      46;      46;       2
12773;A028726;GM0620;2014;     237;     104;     133;      89;      44;       0
12774;A028726;GM0620;2015;     212;      92;     118;      68;      50;       2
12775;A028726;GM0620;2016;     285;     122;     162;     108;      54;       1
12776;A028726;GM0620;2017;     228;      93;     134;      88;      46;       1
12777;A028726;GM0620;2018;     227;     119;      95;      53;      42;      13
12778;A028726;GM0620;2019;;;;;;
12779;A028726;GM0620;2020;;;;;;
12780;A028726;GM1961;2012;;;;;;
12781;A028726;GM1961;2013;;;;;;
12782;A028726;GM1961;2014;;;;;;
12783;A028726;GM1961;2015;;;;;;
12784;A028726;GM1961;2016;;;;;;
12785;A028726;GM1961;2017;;;;;;
12786;A028726;GM1961;2018;;;;;;
12787;A028726;GM1961;2019;     895;     532;     351;     183;     168;      12
12788;A028726;GM1961;2020;     836;     474;     350;     151;     199;      12
12789;A028726;GM0622;2012;    1918;     584;    1169;     878;     291;     165
12790;A028726;GM0622;2013;    1769;     545;    1166;     884;     282;      58
12791;A028726;GM0622;2014;    2339;     605;    1397;     922;     475;     337
12792;A028726;GM0622;2015;    2042;     564;    1137;     699;     438;     341
12793;A028726;GM0622;2016;    1746;     535;     874;     470;     404;     337
12794;A028726;GM0622;2017;    1736;     522;     904;     498;     406;     310
12795;A028726;GM0622;2018;    1971;     542;    1129;     619;     510;     300
12796;A028726;GM0622;2019;    1872;     519;    1349;     467;     882;       4
12797;A028726;GM0622;2020;    1752;     466;    1274;     416;     858;      12
12798;A028726;GM0048;2012;     666;     305;     320;     124;     196;      41
12799;A028726;GM0048;2013;     622;     307;     284;     106;     178;      31
12800;A028726;GM0048;2014;     516;     213;     240;     126;     114;      63
12801;A028726;GM0048;2015;     643;     219;     205;     102;     103;     219
12802;A028726;GM0048;2016;     711;     223;     202;     103;      99;     286
12803;A028726;GM0048;2017;     804;     194;     195;      99;      96;     415
12804;A028726;GM0048;2018;;;;;;
12805;A028726;GM0048;2019;;;;;;
12806;A028726;GM0048;2020;;;;;;
12807;A028726;GM0096;2012;     111;      60;      34;       6;      28;      17
12808;A028726;GM0096;2013;     106;      54;      36;       5;      31;      16
12809;A028726;GM0096;2014;     110;      60;      39;       4;      35;      11
12810;A028726;GM0096;2015;      70;      27;      33;       1;      32;      10
12811;A028726;GM0096;2016;      81;      29;      42;       4;      38;      10
12812;A028726;GM0096;2017;      84;      28;      43;       7;      36;      13
12813;A028726;GM0096;2018;      71;      19;      36;       2;      34;      16
12814;A028726;GM0096;2019;      78;      25;      50;       5;      45;       3
12815;A028726;GM0096;2020;      85;      23;      58;       3;      55;       4
12816;A028726;GM0718;2012;    1434;     613;     811;     367;     444;      10
12817;A028726;GM0718;2013;    1568;     594;     933;     414;     519;      41
12818;A028726;GM0718;2014;    1417;     643;     739;     281;     458;      35
12819;A028726;GM0718;2015;    1396;     671;     686;     235;     451;      39
12820;A028726;GM0718;2016;    1404;     669;     645;     203;     442;      90
12821;A028726;GM0718;2017;    1346;     659;     620;     152;     468;      67
12822;A028726;GM0718;2018;    1417;     626;     664;     137;     527;     127
12823;A028726;GM0718;2019;    1404;     612;     762;     217;     545;      30
12824;A028726;GM0718;2020;    1526;     616;     845;     282;     563;      65
12825;A028726;GM0623;2012;     243;      94;      84;      18;      66;      65
12826;A028726;GM0623;2013;     210;     111;      73;      20;      53;      26
12827;A028726;GM0623;2014;     214;     116;      72;      29;      43;      26
12828;A028726;GM0623;2015;;;;;;
12829;A028726;GM0623;2016;;;;;;
12830;A028726;GM0623;2017;;;;;;
12831;A028726;GM0623;2018;;;;;;
12832;A028726;GM0623;2019;;;;;;
12833;A028726;GM0623;2020;;;;;;
12834;A028726;GM0986;2012;     259;     146;      82;      30;      52;      31
12835;A028726;GM0986;2013;     252;     120;      99;      31;      68;      33
12836;A028726;GM0986;2014;     253;     122;      97;      45;      52;      34
12837;A028726;GM0986;2015;     347;     122;     125;      74;      51;     100
12838;A028726;GM0986;2016;     301;     104;     129;      79;      50;      68
12839;A028726;GM0986;2017;     316;     119;     131;      71;      60;      66
12840;A028726;GM0986;2018;     262;     102;      89;      20;      69;      71
12841;A028726;GM0986;2019;     263;     121;     138;      19;     119;       4
12842;A028726;GM0986;2020;     265;     129;     131;      24;     107;       5
12843;A028726;GM0626;2012;     739;     256;     458;     321;     137;      25
12844;A028726;GM0626;2013;     577;     256;     295;     162;     133;      26
12845;A028726;GM0626;2014;     600;     247;     217;      88;     129;     136
12846;A028726;GM0626;2015;     497;     211;     144;      41;     103;     142
12847;A028726;GM0626;2016;     547;     228;     180;      52;     128;     139
12848;A028726;GM0626;2017;     594;     217;     153;      41;     112;     224
12849;A028726;GM0626;2018;     543;     191;     166;      36;     130;     186
12850;A028726;GM0626;2019;     533;     197;     332;     152;     180;       4
12851;A028726;GM0626;2020;     437;     191;     244;      68;     176;       2
12852;A028726;GM0285;2012;     397;     156;     207;     128;      79;      34
12853;A028726;GM0285;2013;     390;     169;     204;     126;      78;      17
12854;A028726;GM0285;2014;     409;     179;     217;     128;      89;      13
12855;A028726;GM0285;2015;     472;     184;     271;     113;     158;      17
12856;A028726;GM0285;2016;     755;     172;     271;     137;     134;     312
12857;A028726;GM0285;2017;     705;     161;     177;      61;     116;     367
12858;A028726;GM0285;2018;     698;     148;     176;      63;     113;     374
12859;A028726;GM0285;2019;     680;     222;     456;      77;     379;       2
12860;A028726;GM0285;2020;     682;     232;     450;      62;     388;       0
12861;A028726;GM0865;2012;     416;     222;     177;      73;     104;      17
12862;A028726;GM0865;2013;     466;     251;     201;     105;      96;      14
12863;A028726;GM0865;2014;     474;     239;     215;      80;     135;      20
12864;A028726;GM0865;2015;     481;     229;     220;      77;     143;      32
12865;A028726;GM0865;2016;     486;     220;     230;      61;     169;      36
12866;A028726;GM0865;2017;     519;     189;     298;      73;     225;      32
12867;A028726;GM0865;2018;     498;     180;     289;      77;     212;      29
12868;A028726;GM0865;2019;     549;     217;     331;     141;     190;       1
12869;A028726;GM0865;2020;     463;     205;     257;      56;     201;       1
12870;A028726;GM1949;2012;;;;;;
12871;A028726;GM1949;2013;;;;;;
12872;A028726;GM1949;2014;;;;;;
12873;A028726;GM1949;2015;;;;;;
12874;A028726;GM1949;2016;;;;;;
12875;A028726;GM1949;2017;;;;;;
12876;A028726;GM1949;2018;    1061;     476;     543;     218;     325;      42
12877;A028726;GM1949;2019;    1071;     516;     542;     231;     311;      13
12878;A028726;GM1949;2020;    1089;     512;     565;     243;     322;      12
12879;A028726;GM0866;2012;     300;     170;     103;      35;      68;      27
12880;A028726;GM0866;2013;     302;     165;     107;      44;      63;      30
12881;A028726;GM0866;2014;     373;     148;     204;      77;     127;      21
12882;A028726;GM0866;2015;     349;     156;     163;      45;     118;      30
12883;A028726;GM0866;2016;     328;     132;     178;      56;     122;      18
12884;A028726;GM0866;2017;     355;     161;     174;      24;     150;      20
12885;A028726;GM0866;2018;     318;     126;     176;      27;     149;      16
12886;A028726;GM0866;2019;     354;     173;     168;      25;     143;      13
12887;A028726;GM0866;2020;     347;     155;     190;      16;     174;       2
12888;A028726;GM0867;2012;     809;     388;     389;     231;     158;      32
12889;A028726;GM0867;2013;     765;     383;     355;     189;     166;      27
12890;A028726;GM0867;2014;     741;     368;     338;     189;     149;      35
12891;A028726;GM0867;2015;     694;     340;     311;     155;     156;      43
12892;A028726;GM0867;2016;     709;     360;     301;     127;     174;      48
12893;A028726;GM0867;2017;     755;     316;     395;     173;     222;      44
12894;A028726;GM0867;2018;     842;     328;     442;     155;     287;      72
12895;A028726;GM0867;2019;     826;     333;     486;     222;     264;       7
12896;A028726;GM0867;2020;     783;     301;     477;     259;     218;       5
12897;A028726;GM0627;2012;     319;     149;     157;      60;      97;      13
12898;A028726;GM0627;2013;     402;     186;     206;      73;     133;      10
12899;A028726;GM0627;2014;     377;     174;     174;      45;     129;      29
12900;A028726;GM0627;2015;     479;     178;     265;      65;     200;      36
12901;A028726;GM0627;2016;     500;     203;     256;      62;     194;      41
12902;A028726;GM0627;2017;     427;     169;     202;      52;     150;      56
12903;A028726;GM0627;2018;     410;     172;     182;      76;     106;      56
12904;A028726;GM0627;2019;     348;     171;     175;      50;     125;       2
12905;A028726;GM0627;2020;     371;     183;     187;      62;     125;       1
12906;A028726;GM0289;2012;     644;     232;     296;     126;     170;     116
12907;A028726;GM0289;2013;    1003;     242;     621;     194;     427;     140
12908;A028726;GM0289;2014;    1203;     234;     779;     121;     658;     190
12909;A028726;GM0289;2015;    1365;     232;     901;     372;     529;     232
12910;A028726;GM0289;2016;    1375;     229;     907;     322;     585;     239
12911;A028726;GM0289;2017;     751;     215;     517;     134;     383;      19
12912;A028726;GM0289;2018;     761;     197;     544;     227;     317;      20
12913;A028726;GM0289;2019;     776;     232;     536;     287;     249;       8
12914;A028726;GM0289;2020;     751;     243;     503;     186;     317;       5
12915;A028726;GM0629;2012;    1090;     548;     506;      69;     437;      36
12916;A028726;GM0629;2013;    1117;     510;     560;      95;     465;      47
12917;A028726;GM0629;2014;    1144;     506;     549;      92;     457;      89
12918;A028726;GM0629;2015;    1085;     514;     517;      97;     420;      54
12919;A028726;GM0629;2016;    1028;     499;     500;      76;     424;      29
12920;A028726;GM0629;2017;    1009;     428;     557;      83;     474;      24
12921;A028726;GM0629;2018;    1012;     439;     537;      59;     478;      36
12922;A028726;GM0629;2019;     996;     459;     475;      54;     421;      62
12923;A028726;GM0629;2020;    1041;     490;     489;      92;     397;      62
12924;A028726;GM0852;2012;     333;     151;     119;      59;      60;      63
12925;A028726;GM0852;2013;     326;     156;     108;      56;      52;      62
12926;A028726;GM0852;2014;     331;     169;      94;      33;      61;      68
12927;A028726;GM0852;2015;     319;     168;      71;      29;      42;      80
12928;A028726;GM0852;2016;     278;     135;      69;      31;      38;      74
12929;A028726;GM0852;2017;     237;     141;      72;      29;      43;      24
12930;A028726;GM0852;2018;     259;     152;      83;      33;      50;      24
12931;A028726;GM0852;2019;     276;     167;     107;      46;      61;       2
12932;A028726;GM0852;2020;     264;     168;      95;      30;      65;       1
12933;A028726;GM0988;2012;     968;     432;     442;     158;     284;      94
12934;A028726;GM0988;2013;    1075;     425;     576;     286;     290;      74
12935;A028726;GM0988;2014;    1446;     418;     571;     273;     298;     457
12936;A028726;GM0988;2015;    1257;     397;     411;     154;     257;     449
12937;A028726;GM0988;2016;    1290;     361;     483;     213;     270;     446
12938;A028726;GM0988;2017;     963;     343;     365;     106;     259;     255
12939;A028726;GM0988;2018;    1047;     325;     451;     109;     342;     271
12940;A028726;GM0988;2019;    1023;     382;     555;     163;     392;      86
12941;A028726;GM0988;2020;     975;     368;     519;     160;     359;      88
12942;A028726;GM0457;2012;     355;     139;     210;     141;      69;       6
12943;A028726;GM0457;2013;     345;     143;     198;     125;      73;       4
12944;A028726;GM0457;2014;     481;     140;     321;     254;      67;      20
12945;A028726;GM0457;2015;     439;     162;     263;     187;      76;      14
12946;A028726;GM0457;2016;     294;     151;     123;      75;      48;      20
12947;A028726;GM0457;2017;     328;     128;     108;      39;      69;      92
12948;A028726;GM0457;2018;     356;     168;     129;      42;      87;      59
12949;A028726;GM0457;2019;     340;     153;     152;      56;      96;      35
12950;A028726;GM0457;2020;     396;     192;     173;      71;     102;      31
12951;A028726;GM0870;2012;     383;     199;     166;      62;     104;      18
12952;A028726;GM0870;2013;     347;     166;     168;      56;     112;      13
12953;A028726;GM0870;2014;     354;     182;     157;      48;     109;      15
12954;A028726;GM0870;2015;     431;     232;     176;      52;     124;      23
12955;A028726;GM0870;2016;     411;     206;     167;      65;     102;      38
12956;A028726;GM0870;2017;     375;     190;     168;      42;     126;      17
12957;A028726;GM0870;2018;     425;     199;     205;      56;     149;      21
12958;A028726;GM0870;2019;;;;;;
12959;A028726;GM0870;2020;;;;;;
12960;A028726;GM1960;2012;;;;;;
12961;A028726;GM1960;2013;;;;;;
12962;A028726;GM1960;2014;;;;;;
12963;A028726;GM1960;2015;;;;;;
12964;A028726;GM1960;2016;;;;;;
12965;A028726;GM1960;2017;;;;;;
12966;A028726;GM1960;2018;;;;;;
12967;A028726;GM1960;2019;     820;     436;     251;      85;     166;     133
12968;A028726;GM1960;2020;     767;     431;     250;      45;     205;      86
12969;A028726;GM0668;2012;     324;     153;     110;      46;      64;      61
12970;A028726;GM0668;2013;     367;     183;     128;      54;      74;      56
12971;A028726;GM0668;2014;     377;     195;     123;      46;      77;      59
12972;A028726;GM0668;2015;     305;     173;      97;      32;      65;      35
12973;A028726;GM0668;2016;     343;     181;     106;      38;      68;      56
12974;A028726;GM0668;2017;     326;     162;     100;      35;      65;      64
12975;A028726;GM0668;2018;     323;     132;     139;      43;      96;      52
12976;A028726;GM0668;2019;     322;     174;     146;      39;     107;       2
12977;A028726;GM0668;2020;     334;     157;     173;      54;     119;       4
12978;A028726;GM1969;2012;;;;;;
12979;A028726;GM1969;2013;;;;;;
12980;A028726;GM1969;2014;;;;;;
12981;A028726;GM1969;2015;;;;;;
12982;A028726;GM1969;2016;;;;;;
12983;A028726;GM1969;2017;;;;;;
12984;A028726;GM1969;2018;;;;;;
12985;A028726;GM1969;2019;     884;     414;     454;     233;     221;      16
12986;A028726;GM1969;2020;     862;     415;     433;     265;     168;      14
12987;A028726;GM1701;2012;     401;     236;     119;      44;      75;      46
12988;A028726;GM1701;2013;     444;     260;     134;      34;     100;      50
12989;A028726;GM1701;2014;     456;     251;     154;      53;     101;      51
12990;A028726;GM1701;2015;     413;     239;     152;      58;      94;      22
12991;A028726;GM1701;2016;     455;     267;     153;      52;     101;      35
12992;A028726;GM1701;2017;     464;     238;     147;      36;     111;      79
12993;A028726;GM1701;2018;     428;     219;     174;      64;     110;      35
12994;A028726;GM1701;2019;     418;     220;     192;      51;     141;       6
12995;A028726;GM1701;2020;     404;     207;     194;      57;     137;       3
12996;A028726;GM0293;2012;     144;      71;      73;      33;      40;       0
12997;A028726;GM0293;2013;     148;      69;      79;      49;      30;       0
12998;A028726;GM0293;2014;      97;      50;      47;      26;      21;       0
12999;A028726;GM0293;2015;     134;      64;      70;      33;      37;       0
13000;A028726;GM0293;2016;     115;      59;      56;      30;      26;       0
13001;A028726;GM0293;2017;     108;      47;      61;      24;      37;       0
13002;A028726;GM0293;2018;     108;      60;      48;      26;      22;       0
13003;A028726;GM0293;2019;     109;      63;      45;      27;      18;       1
13004;A028726;GM0293;2020;     106;      50;      56;      32;      24;       0
13005;A028726;GM1950;2012;;;;;;
13006;A028726;GM1950;2013;;;;;;
13007;A028726;GM1950;2014;;;;;;
13008;A028726;GM1950;2015;;;;;;
13009;A028726;GM1950;2016;;;;;;
13010;A028726;GM1950;2017;;;;;;
13011;A028726;GM1950;2018;     984;     285;     278;     122;     156;     421
13012;A028726;GM1950;2019;     957;     323;     328;     142;     186;     306
13013;A028726;GM1950;2020;     948;     302;     336;     143;     193;     310
13014;A028726;GM1783;2012;    1964;     838;     818;     337;     481;     308
13015;A028726;GM1783;2013;    1802;     819;     711;     264;     447;     272
13016;A028726;GM1783;2014;    1857;     779;     839;     301;     538;     239
13017;A028726;GM1783;2015;    1686;     758;     698;     246;     452;     230
13018;A028726;GM1783;2016;    1594;     743;     609;     156;     453;     242
13019;A028726;GM1783;2017;    1630;     666;     670;     201;     469;     294
13020;A028726;GM1783;2018;    1497;     630;     633;     147;     486;     234
13021;A028726;GM1783;2019;    1465;     773;     582;     178;     404;     110
13022;A028726;GM1783;2020;    1459;     842;     549;     146;     403;      68
13023;A028726;GM0098;2012;     558;     307;     233;     112;     121;      18
13024;A028726;GM0098;2013;     588;     323;     254;     141;     113;      11
13025;A028726;GM0098;2014;     631;     305;     317;     189;     128;       9
13026;A028726;GM0098;2015;     600;     303;     291;     167;     124;       6
13027;A028726;GM0098;2016;     629;     335;     280;     161;     119;      14
13028;A028726;GM0098;2017;     595;     303;     276;     174;     102;      16
13029;A028726;GM0098;2018;     574;     261;     300;     181;     119;      13
13030;A028726;GM0098;2019;     579;     273;     300;      73;     227;       6
13031;A028726;GM0098;2020;     564;     272;     284;      91;     193;       8
13032;A028726;GM0614;2012;     484;     276;     201;      36;     165;       7
13033;A028726;GM0614;2013;     516;     279;     230;      40;     190;       7
13034;A028726;GM0614;2014;     562;     322;     229;      35;     194;      11
13035;A028726;GM0614;2015;     481;     273;     194;      32;     162;      14
13036;A028726;GM0614;2016;     411;     244;     156;      22;     134;      11
13037;A028726;GM0614;2017;     419;     238;     165;      26;     139;      16
13038;A028726;GM0614;2018;     390;     220;     156;      24;     132;      14
13039;A028726;GM0614;2019;     357;     205;     146;      34;     112;       6
13040;A028726;GM0614;2020;     375;     204;     166;      35;     131;       5
13041;A028726;GM0189;2012;     614;     331;     241;      62;     179;      42
13042;A028726;GM0189;2013;     650;     338;     273;      56;     217;      39
13043;A028726;GM0189;2014;     700;     335;     328;      57;     271;      37
13044;A028726;GM0189;2015;     621;     336;     256;      28;     228;      29
13045;A028726;GM0189;2016;     418;     244;     145;      22;     123;      29
13046;A028726;GM0189;2017;     492;     241;     223;      87;     136;      28
13047;A028726;GM0189;2018;     401;     217;     165;      34;     131;      19
13048;A028726;GM0189;2019;     401;     234;     132;      41;      91;      35
13049;A028726;GM0189;2020;     417;     245;     163;      49;     114;       9
13050;A028726;GM0296;2012;     462;     300;     147;      49;      98;      15
13051;A028726;GM0296;2013;     488;     303;     170;      80;      90;      15
13052;A028726;GM0296;2014;     445;     266;     144;      60;      84;      35
13053;A028726;GM0296;2015;     469;     280;     156;      72;      84;      33
13054;A028726;GM0296;2016;     415;     234;     156;      75;      81;      25
13055;A028726;GM0296;2017;     360;     185;     154;      82;      72;      21
13056;A028726;GM0296;2018;     499;     230;     211;     104;     107;      58
13057;A028726;GM0296;2019;     403;     204;     192;      82;     110;       7
13058;A028726;GM0296;2020;     412;     203;     202;      87;     115;       7
13059;A028726;GM1696;2012;     850;     472;     312;      53;     259;      66
13060;A028726;GM1696;2013;     872;     464;     352;      61;     291;      56
13061;A028726;GM1696;2014;     826;     450;     322;      45;     277;      54
13062;A028726;GM1696;2015;     809;     438;     311;      39;     272;      60
13063;A028726;GM1696;2016;     761;     410;     275;      32;     243;      76
13064;A028726;GM1696;2017;     832;     397;     342;      64;     278;      93
13065;A028726;GM1696;2018;     829;     429;     347;      80;     267;      53
13066;A028726;GM1696;2019;     814;     457;     340;      57;     283;      17
13067;A028726;GM1696;2020;     737;     435;     288;      48;     240;      14
13068;A028726;GM0352;2012;     329;     158;     166;      46;     120;       5
13069;A028726;GM0352;2013;     301;     170;     124;      52;      72;       7
13070;A028726;GM0352;2014;     335;     176;     150;      64;      86;       9
13071;A028726;GM0352;2015;     288;     160;     118;      44;      74;      10
13072;A028726;GM0352;2016;     268;     142;     113;      45;      68;      13
13073;A028726;GM0352;2017;     299;     152;     125;      49;      76;      22
13074;A028726;GM0352;2018;     261;     115;     128;      35;      93;      18
13075;A028726;GM0352;2019;     242;     116;     118;      61;      57;       8
13076;A028726;GM0352;2020;     204;     105;      94;      33;      61;       5
13077;A028726;GM0053;2012;     164;      80;      80;      49;      31;       4
13078;A028726;GM0053;2013;     172;      84;      86;      56;      30;       2
13079;A028726;GM0053;2014;     190;      98;      92;      56;      36;       0
13080;A028726;GM0053;2015;     219;     112;     107;      66;      41;       0
13081;A028726;GM0053;2016;     211;     124;      87;      42;      45;       0
13082;A028726;GM0053;2017;     187;     110;      76;      25;      51;       1
13083;A028726;GM0053;2018;     174;      99;      74;      25;      49;       1
13084;A028726;GM0053;2019;;;;;;
13085;A028726;GM0053;2020;;;;;;
13086;A028726;GM0294;2012;     790;     433;     324;     129;     195;      33
13087;A028726;GM0294;2013;     650;     355;     267;     107;     160;      28
13088;A028726;GM0294;2014;     646;     316;     301;     121;     180;      29
13089;A028726;GM0294;2015;     602;     291;     282;     124;     158;      29
13090;A028726;GM0294;2016;     597;     287;     282;     125;     157;      28
13091;A028726;GM0294;2017;     556;     268;     261;     114;     147;      27
13092;A028726;GM0294;2018;     565;     273;     265;     114;     151;      27
13093;A028726;GM0294;2019;     559;     286;     270;      95;     175;       3
13094;A028726;GM0294;2020;     566;     267;     296;     112;     184;       3
13095;A028726;GM0873;2012;     426;     245;     118;      51;      67;      63
13096;A028726;GM0873;2013;     424;     242;     154;      44;     110;      28
13097;A028726;GM0873;2014;     542;     280;     223;      79;     144;      39
13098;A028726;GM0873;2015;     538;     299;     218;      47;     171;      21
13099;A028726;GM0873;2016;     511;     294;     198;      33;     165;      19
13100;A028726;GM0873;2017;     568;     278;     238;      56;     182;      52
13101;A028726;GM0873;2018;     570;     260;     285;      75;     210;      25
13102;A028726;GM0873;2019;     525;     290;     222;      49;     173;      13
13103;A028726;GM0873;2020;     540;     272;     253;      57;     196;      15
13104;A028726;GM0632;2012;     699;     333;     337;     124;     213;      29
13105;A028726;GM0632;2013;     649;     310;     316;     103;     213;      23
13106;A028726;GM0632;2014;     627;     297;     286;     100;     186;      44
13107;A028726;GM0632;2015;     711;     322;     320;     130;     190;      69
13108;A028726;GM0632;2016;     624;     301;     251;      96;     155;      72
13109;A028726;GM0632;2017;     656;     303;     263;      89;     174;      90
13110;A028726;GM0632;2018;     638;     270;     293;      90;     203;      75
13111;A028726;GM0632;2019;     619;     280;     332;      85;     247;       7
13112;A028726;GM0632;2020;     648;     276;     370;     119;     251;       2
13113;A028726;GM1690;2012;     388;     263;     101;      45;      56;      24
13114;A028726;GM1690;2013;     385;     252;     111;      48;      63;      22
13115;A028726;GM1690;2014;     602;     264;     125;      57;      68;     213
13116;A028726;GM1690;2015;     496;     233;     153;      68;      85;     110
13117;A028726;GM1690;2016;     470;     229;     103;      27;      76;     138
13118;A028726;GM1690;2017;     434;     255;     106;      32;      74;      73
13119;A028726;GM1690;2018;     423;     249;     107;      37;      70;      67
13120;A028726;GM1690;2019;     411;     240;     161;      65;      96;      10
13121;A028726;GM1690;2020;     382;     233;     141;      50;      91;       8
13122;A028726;GM0880;2012;     227;     122;      92;      55;      37;      13
13123;A028726;GM0880;2013;     188;     115;      65;      21;      44;       8
13124;A028726;GM0880;2014;     194;      93;      83;      30;      53;      18
13125;A028726;GM0880;2015;     208;      93;     106;      58;      48;       9
13126;A028726;GM0880;2016;     211;      81;     118;      74;      44;      12
13127;A028726;GM0880;2017;     214;      90;     115;      69;      46;       9
13128;A028726;GM0880;2018;     174;      93;      71;      22;      49;      10
13129;A028726;GM0880;2019;     168;      91;      72;      25;      47;       5
13130;A028726;GM0880;2020;     238;     103;     133;      78;      55;       2
13131;A028726;GM0351;2012;     180;     101;      69;      21;      48;      10
13132;A028726;GM0351;2013;     157;      89;      59;      11;      48;       9
13133;A028726;GM0351;2014;     135;      71;      58;      18;      40;       6
13134;A028726;GM0351;2015;     144;      66;      63;      17;      46;      15
13135;A028726;GM0351;2016;     168;      85;      54;      18;      36;      29
13136;A028726;GM0351;2017;     157;      68;      80;      16;      64;       9
13137;A028726;GM0351;2018;     135;      55;      72;      13;      59;       8
13138;A028726;GM0351;2019;     158;      82;      74;      14;      60;       2
13139;A028726;GM0351;2020;     135;      71;      63;      10;      53;       1
13140;A028726;GM0874;2012;     208;     110;      90;      55;      35;       8
13141;A028726;GM0874;2013;     215;     118;      90;      51;      39;       7
13142;A028726;GM0874;2014;     202;     105;      91;      54;      37;       6
13143;A028726;GM0874;2015;     276;     153;     112;      55;      57;      11
13144;A028726;GM0874;2016;     237;     156;      69;      26;      43;      12
13145;A028726;GM0874;2017;     235;     120;      69;      28;      41;      46
13146;A028726;GM0874;2018;     219;     116;      92;      41;      51;      11
13147;A028726;GM0874;2019;;;;;;
13148;A028726;GM0874;2020;;;;;;
13149;A028726;GM0479;2012;    2705;    1152;    1471;     983;     488;      82
13150;A028726;GM0479;2013;    2741;    1163;    1489;     932;     557;      89
13151;A028726;GM0479;2014;    2469;     983;    1398;     865;     533;      88
13152;A028726;GM0479;2015;    2085;     921;    1118;     650;     468;      46
13153;A028726;GM0479;2016;    1873;     887;     910;     529;     381;      76
13154;A028726;GM0479;2017;    1738;     795;     879;     511;     368;      64
13155;A028726;GM0479;2018;    1834;     759;    1002;     604;     398;      73
13156;A028726;GM0479;2019;    1955;     806;    1126;     660;     466;      23
13157;A028726;GM0479;2020;    2096;     859;    1208;     688;     520;      29
13158;A028726;GM0297;2012;     445;     232;     151;      66;      85;      62
13159;A028726;GM0297;2013;     500;     251;     213;     127;      86;      36
13160;A028726;GM0297;2014;     471;     251;     193;      81;     112;      27
13161;A028726;GM0297;2015;     439;     259;     154;      43;     111;      26
13162;A028726;GM0297;2016;     464;     267;     162;      51;     111;      35
13163;A028726;GM0297;2017;     430;     234;     159;      32;     127;      37
13164;A028726;GM0297;2018;     452;     207;     203;      68;     135;      42
13165;A028726;GM0297;2019;     447;     250;     194;      82;     112;       3
13166;A028726;GM0297;2020;     448;     258;     189;      67;     122;       1
13167;A028726;GM0473;2012;    1352;     474;     823;      52;     771;      55
13168;A028726;GM0473;2013;    1398;     467;     855;      59;     796;      76
13169;A028726;GM0473;2014;    1376;     494;     820;      55;     765;      62
13170;A028726;GM0473;2015;    1452;     497;     813;      51;     762;     142
13171;A028726;GM0473;2016;    1430;     515;     772;      48;     724;     143
13172;A028726;GM0473;2017;    1353;     489;     781;      36;     745;      83
13173;A028726;GM0473;2018;    1344;     456;     784;      37;     747;     104
13174;A028726;GM0473;2019;    1378;     491;     700;      80;     620;     187
13175;A028726;GM0473;2020;    1465;     559;     671;      63;     608;     235
13176;A028726;GM0707;2012;     339;     192;     121;      29;      92;      26
13177;A028726;GM0707;2013;     286;     158;     106;      33;      73;      22
13178;A028726;GM0707;2014;     280;     156;     101;      43;      58;      23
13179;A028726;GM0707;2015;     250;     152;      74;      27;      47;      24
13180;A028726;GM0707;2016;     263;     151;      85;      39;      46;      27
13181;A028726;GM0707;2017;     233;     138;      75;      29;      46;      20
13182;A028726;GM0707;2018;     231;     130;      79;      23;      56;      22
13183;A028726;GM0707;2019;;;;;;
13184;A028726;GM0707;2020;;;;;;
13185;A028726;GM0478;2012;      96;      63;      29;      10;      19;       4
13186;A028726;GM0478;2013;      90;      63;      23;       7;      16;       4
13187;A028726;GM0478;2014;      91;      62;      26;       9;      17;       3
13188;A028726;GM0478;2015;      88;      68;      15;       2;      13;       5
13189;A028726;GM0478;2016;;;;;;
13190;A028726;GM0478;2017;;;;;;
13191;A028726;GM0478;2018;;;;;;
13192;A028726;GM0478;2019;;;;;;
13193;A028726;GM0478;2020;;;;;;
13194;A028726;GM0050;2012;     272;     157;      97;      28;      69;      18
13195;A028726;GM0050;2013;     261;     138;     103;      25;      78;      20
13196;A028726;GM0050;2014;     244;     134;      89;      27;      62;      21
13197;A028726;GM0050;2015;     224;     131;      75;      26;      49;      18
13198;A028726;GM0050;2016;     209;     122;      68;      24;      44;      19
13199;A028726;GM0050;2017;     188;     103;      68;      25;      43;      17
13200;A028726;GM0050;2018;     191;      96;      79;      29;      50;      16
13201;A028726;GM0050;2019;     186;     128;      56;      19;      37;       2
13202;A028726;GM0050;2020;     226;     150;      74;      25;      49;       2
13203;A028726;GM0355;2012;    1293;     472;     656;     229;     427;     165
13204;A028726;GM0355;2013;    1463;     474;     698;     263;     435;     291
13205;A028726;GM0355;2014;    1311;     402;     766;     264;     502;     143
13206;A028726;GM0355;2015;    1534;     396;     895;     405;     490;     243
13207;A028726;GM0355;2016;    1401;     402;     739;     176;     563;     260
13208;A028726;GM0355;2017;    1428;     396;     781;     187;     594;     251
13209;A028726;GM0355;2018;    1492;     365;     736;     199;     537;     391
13210;A028726;GM0355;2019;    1486;     444;    1009;     120;     889;      33
13211;A028726;GM0355;2020;    1462;     460;     944;     149;     795;      58
13212;A028726;GM0299;2012;     445;     225;     207;      95;     112;      13
13213;A028726;GM0299;2013;     489;     214;     256;     136;     120;      19
13214;A028726;GM0299;2014;     408;     217;     179;      82;      97;      12
13215;A028726;GM0299;2015;     380;     189;     170;      78;      92;      21
13216;A028726;GM0299;2016;     443;     210;     194;      83;     111;      39
13217;A028726;GM0299;2017;     425;     191;     207;      83;     124;      27
13218;A028726;GM0299;2018;     585;     259;     311;     132;     179;      15
13219;A028726;GM0299;2019;     537;     266;     255;     123;     132;      16
13220;A028726;GM0299;2020;     532;     257;     266;     114;     152;       9
13221;A028726;GM0476;2012;     332;     163;      68;      10;      58;     101
13222;A028726;GM0476;2013;;;;;;
13223;A028726;GM0476;2014;;;;;;
13224;A028726;GM0476;2015;;;;;;
13225;A028726;GM0476;2016;;;;;;
13226;A028726;GM0476;2017;;;;;;
13227;A028726;GM0476;2018;;;;;;
13228;A028726;GM0476;2019;;;;;;
13229;A028726;GM0476;2020;;;;;;
13230;A028726;GM0637;2012;    1369;     631;     717;     350;     367;      21
13231;A028726;GM0637;2013;    1585;     670;     906;     530;     376;       9
13232;A028726;GM0637;2014;    1585;     751;     722;     400;     322;     112
13233;A028726;GM0637;2015;    1431;     605;     671;     336;     335;     155
13234;A028726;GM0637;2016;    1473;     541;     682;     411;     271;     250
13235;A028726;GM0637;2017;    1595;     481;     874;     567;     307;     240
13236;A028726;GM0637;2018;    1517;     426;     814;     498;     316;     277
13237;A028726;GM0637;2019;    1603;     437;    1160;     807;     353;       6
13238;A028726;GM0637;2020;    1757;     482;    1261;     951;     310;      14
13239;A028726;GM0638;2012;     164;      62;      45;       8;      37;      57
13240;A028726;GM0638;2013;     176;      71;      95;       6;      89;      10
13241;A028726;GM0638;2014;     196;      84;      89;       9;      80;      23
13242;A028726;GM0638;2015;     157;      57;      76;       2;      74;      24
13243;A028726;GM0638;2016;     145;      47;      65;       6;      59;      33
13244;A028726;GM0638;2017;     173;      50;     105;       6;      99;      18
13245;A028726;GM0638;2018;     138;      50;      78;       3;      75;      10
13246;A028726;GM0638;2019;     123;      60;      63;       6;      57;       0
13247;A028726;GM0638;2020;     115;      71;      44;       1;      43;       0
13248;A028726;GM0056;2012;     289;     130;     141;      87;      54;      18
13249;A028726;GM0056;2013;     278;     139;     121;      77;      44;      18
13250;A028726;GM0056;2014;     298;     122;     160;     112;      48;      16
13251;A028726;GM0056;2015;     306;     149;     142;      97;      45;      15
13252;A028726;GM0056;2016;     306;     127;     164;     120;      44;      15
13253;A028726;GM0056;2017;     299;     126;     162;     102;      60;      11
13254;A028726;GM0056;2018;     281;     119;     151;      93;      58;      11
13255;A028726;GM0056;2019;;;;;;
13256;A028726;GM0056;2020;;;;;;
13257;A028726;GM1892;2012;     536;     297;     219;      80;     139;      20
13258;A028726;GM1892;2013;     558;     316;     214;      83;     131;      28
13259;A028726;GM1892;2014;     495;     244;     206;      71;     135;      45
13260;A028726;GM1892;2015;     504;     251;     193;      65;     128;      60
13261;A028726;GM1892;2016;     483;     247;     171;      67;     104;      65
13262;A028726;GM1892;2017;     512;     228;     211;     109;     102;      73
13263;A028726;GM1892;2018;     528;     263;     205;      82;     123;      60
13264;A028726;GM1892;2019;     514;     269;     229;      72;     157;      16
13265;A028726;GM1892;2020;     529;     272;     244;      81;     163;      13
13266;A028726;GM0879;2012;     612;     378;     209;      29;     180;      25
13267;A028726;GM0879;2013;     654;     381;     254;      30;     224;      19
13268;A028726;GM0879;2014;     663;     397;     249;      21;     228;      17
13269;A028726;GM0879;2015;     706;     391;     297;      80;     217;      18
13270;A028726;GM0879;2016;     619;     364;     229;      44;     185;      26
13271;A028726;GM0879;2017;     625;     360;     237;      18;     219;      28
13272;A028726;GM0879;2018;     640;     321;     271;      28;     243;      48
13273;A028726;GM0879;2019;     619;     337;     273;      48;     225;       9
13274;A028726;GM0879;2020;     616;     347;     257;      49;     208;      12
13275;A028726;GM0301;2012;     866;     331;     441;     219;     222;      94
13276;A028726;GM0301;2013;     826;     315;     402;     161;     241;     109
13277;A028726;GM0301;2014;     840;     278;     391;     157;     234;     171
13278;A028726;GM0301;2015;    1044;     313;     551;     338;     213;     180
13279;A028726;GM0301;2016;     817;     301;     377;     157;     220;     139
13280;A028726;GM0301;2017;     848;     325;     383;     175;     208;     140
13281;A028726;GM0301;2018;     834;     249;     444;     188;     256;     141
13282;A028726;GM0301;2019;     771;     280;     482;     156;     326;       9
13283;A028726;GM0301;2020;     780;     284;     491;     170;     321;       5
13284;A028726;GM1896;2012;     441;     185;     165;      45;     120;      91
13285;A028726;GM1896;2013;     392;     174;     177;      52;     125;      41
13286;A028726;GM1896;2014;     427;     181;     187;      63;     124;      59
13287;A028726;GM1896;2015;     425;     190;     166;      43;     123;      69
13288;A028726;GM1896;2016;     392;     181;     162;      44;     118;      49
13289;A028726;GM1896;2017;     405;     175;     176;      54;     122;      54
13290;A028726;GM1896;2018;     403;     149;     213;      77;     136;      41
13291;A028726;GM1896;2019;     437;     212;     216;      98;     118;       9
13292;A028726;GM1896;2020;     407;     213;     184;      55;     129;      10
13293;A028726;GM0642;2012;     724;     311;     400;     241;     159;      13
13294;A028726;GM0642;2013;     696;     273;     416;     271;     145;       7
13295;A028726;GM0642;2014;     860;     295;     447;     326;     121;     118
13296;A028726;GM0642;2015;     809;     309;     389;     258;     131;     111
13297;A028726;GM0642;2016;     845;     358;     394;     243;     151;      93
13298;A028726;GM0642;2017;     926;     336;     514;     350;     164;      76
13299;A028726;GM0642;2018;     787;     305;     400;     253;     147;      82
13300;A028726;GM0642;2019;     737;     310;     420;     231;     189;       7
13301;A028726;GM0642;2020;     674;     257;     410;     221;     189;       7
13302;A028726;GM0193;2012;    2016;     714;    1125;     458;     667;     177
13303;A028726;GM0193;2013;    1997;     670;    1187;     559;     628;     140
13304;A028726;GM0193;2014;    1875;     627;    1092;     515;     577;     156
13305;A028726;GM0193;2015;    1711;     633;     937;     456;     481;     141
13306;A028726;GM0193;2016;    1582;     573;     889;     407;     482;     120
13307;A028726;GM0193;2017;    1641;     533;    1007;     481;     526;     101
13308;A028726;GM0193;2018;    1511;     492;     937;     436;     501;      82
13309;A028726;GM0193;2019;    1605;     532;    1060;     508;     552;      13
13310;A028726;GM0193;2020;    1582;     519;    1026;     437;     589;      37
